"ID","depression_area_m2","depression_volume_m3","upland_area_m2","total_catchment_m2","sub_basin"
1,8900,5360,6500,15400,"Sub-basin 1"
2,79500,5109,104600,184100,"Sub-basin 1"
3,80500,14220,91400,171900,"Sub-basin 1"
4,34200,8393,40500,74700,"Sub-basin 1"
5,3600,970,5200,8800,"Sub-basin 1"
6,23900,7056,22500,46400,"Sub-basin 1"
7,500,37,1800,2300,"Sub-basin 1"
8,1900,348,4700,6600,"Sub-basin 1"
9,5200,1648,9700,14900,"Sub-basin 1"
10,800,135,1700,2500,"Sub-basin 1"
11,500,12,2000,2500,"Sub-basin 1"
12,300,12,2200,2500,"Sub-basin 1"
13,900,221,1800,2700,"Sub-basin 1"
14,100,1,1200,1300,"Sub-basin 1"
15,800,142,1100,1900,"Sub-basin 1"
16,1700,478,3800,5500,"Sub-basin 1"
17,12000,6325,11600,23600,"Sub-basin 1"
18,900,61,2200,3100,"Sub-basin 1"
19,23500,3901,48400,71900,"Sub-basin 1"
20,500,7,4500,5000,"Sub-basin 1"
21,200,6,1200,1400,"Sub-basin 1"
22,200,2,300,500,"Sub-basin 1"
23,1700,558,4300,6000,"Sub-basin 1"
24,2400,219,5600,8000,"Sub-basin 1"
25,100,1,500,600,"Sub-basin 1"
26,100,1,400,500,"Sub-basin 1"
27,600,11,2800,3400,"Sub-basin 1"
28,8300,569,9300,17600,"Sub-basin 1"
29,100,1,700,800,"Sub-basin 1"
30,13600,2661,14100,27700,"Sub-basin 1"
31,200,7,700,900,"Sub-basin 1"
32,3000,1426,6400,9400,"Sub-basin 1"
33,200,12,1200,1400,"Sub-basin 1"
34,300,35,1400,1700,"Sub-basin 1"
35,2000,321,5000,7000,"Sub-basin 1"
36,100,1,500,600,"Sub-basin 1"
37,64800,24415,67300,132100,"Sub-basin 1"
38,100,2,1100,1200,"Sub-basin 1"
39,800,117,2000,2800,"Sub-basin 1"
40,2300,433,3700,6000,"Sub-basin 1"
41,5200,173,14100,19300,"Sub-basin 1"
42,100,3,900,1000,"Sub-basin 1"
43,600,56,2000,2600,"Sub-basin 1"
44,4800,2108,5300,10100,"Sub-basin 1"
45,400,26,1000,1400,"Sub-basin 1"
46,400,20,5400,5800,"Sub-basin 1"
47,500,24,3200,3700,"Sub-basin 1"
48,100,1,900,1000,"Sub-basin 1"
49,200,2,1500,1700,"Sub-basin 1"
50,5200,1313,9500,14700,"Sub-basin 1"
51,10100,3321,17900,28000,"Sub-basin 1"
52,3800,761,5300,9100,"Sub-basin 1"
53,100,3,600,700,"Sub-basin 1"
54,32300,5075,51600,83900,"Sub-basin 1"
55,500,22,3000,3500,"Sub-basin 1"
56,200,18,1000,1200,"Sub-basin 1"
57,700,21,2900,3600,"Sub-basin 1"
58,700,54,2400,3100,"Sub-basin 1"
59,2900,514,7800,10700,"Sub-basin 1"
60,1300,26,5800,7100,"Sub-basin 1"
61,8400,2189,15300,23700,"Sub-basin 1"
62,3400,613,10700,14100,"Sub-basin 1"
63,1100,157,3600,4700,"Sub-basin 1"
64,300,10,3400,3700,"Sub-basin 1"
65,3200,566,7500,10700,"Sub-basin 1"
66,3200,763,9100,12300,"Sub-basin 1"
67,500,39,1300,1800,"Sub-basin 1"
68,9100,2433,12800,21900,"Sub-basin 1"
69,1200,73,4200,5400,"Sub-basin 1"
70,20700,932,44000,64700,"Sub-basin 1"
71,100,2,1400,1500,"Sub-basin 1"
72,100,1,1400,1500,"Sub-basin 1"
73,1200,139,6000,7200,"Sub-basin 1"
74,100,4,200,300,"Sub-basin 1"
75,1100,196,1400,2500,"Sub-basin 1"
76,200,10,200,400,"Sub-basin 1"
77,4200,739,7400,11600,"Sub-basin 1"
78,200,4,300,500,"Sub-basin 1"
79,700,82,2400,3100,"Sub-basin 1"
80,103600,18027,101700,205300,"Sub-basin 1"
81,100,1,100,200,"Sub-basin 1"
82,7900,749,12300,20200,"Sub-basin 1"
83,100,1,0,100,"Sub-basin 1"
84,900,172,3000,3900,"Sub-basin 1"
85,400,56,2200,2600,"Sub-basin 1"
86,100,2,300,400,"Sub-basin 1"
87,200,2,400,600,"Sub-basin 1"
88,400,28,1200,1600,"Sub-basin 1"
89,200,15,1600,1800,"Sub-basin 1"
90,600,99,2600,3200,"Sub-basin 1"
91,900,157,4300,5200,"Sub-basin 1"
92,100,2,0,100,"Sub-basin 1"
93,500,13,0,500,"Sub-basin 1"
94,2200,520,3200,5400,"Sub-basin 1"
95,79300,27457.84,67400,146700,"Sub-basin 1"
96,1300,197,3900,5200,"Sub-basin 1"
97,77100,7269,118800,195900,"Sub-basin 1"
98,100,1,400,500,"Sub-basin 1"
99,100,2,700,800,"Sub-basin 1"
100,1800,122,7200,9000,"Sub-basin 1"
101,700,29,4800,5500,"Sub-basin 1"
102,500,15,1300,1800,"Sub-basin 1"
103,400,23,3400,3800,"Sub-basin 1"
104,100,5,900,1000,"Sub-basin 1"
105,4200,1438,7200,11400,"Sub-basin 1"
106,4100,634,10200,14300,"Sub-basin 1"
107,900,127.03,2000,2900,"Sub-basin 1"
108,600,47,1400,2000,"Sub-basin 1"
109,800,126,3500,4300,"Sub-basin 1"
110,3700,137,13000,16700,"Sub-basin 1"
111,16500,6426,17500,34000,"Sub-basin 1"
112,600,68,3500,4100,"Sub-basin 1"
113,22400,1631,30400,52800,"Sub-basin 1"
114,100,1,700,800,"Sub-basin 1"
115,23800,5584,24700,48500,"Sub-basin 1"
116,100,7,1200,1300,"Sub-basin 1"
117,2300,423,9500,11800,"Sub-basin 1"
118,1200,144,1500,2700,"Sub-basin 1"
119,400,7,2800,3200,"Sub-basin 1"
120,100,2,1000,1100,"Sub-basin 1"
121,10000,1871,15100,25100,"Sub-basin 1"
122,600,24,3700,4300,"Sub-basin 1"
123,200,12,1500,1700,"Sub-basin 1"
124,1000,209,4600,5600,"Sub-basin 1"
125,900,21,5700,6600,"Sub-basin 1"
126,100,1,500,600,"Sub-basin 1"
127,100,3,600,700,"Sub-basin 1"
128,100,1,600,700,"Sub-basin 1"
129,100,3,800,900,"Sub-basin 1"
130,900,105,2800,3700,"Sub-basin 1"
131,100,2,600,700,"Sub-basin 1"
132,300,4,1500,1800,"Sub-basin 1"
133,200,3,2100,2300,"Sub-basin 1"
134,1800,63,4200,6000,"Sub-basin 1"
135,700,79,3600,4300,"Sub-basin 1"
136,7900,804,17000,24900,"Sub-basin 1"
137,500,84,3500,4000,"Sub-basin 1"
138,300,7,2700,3000,"Sub-basin 1"
139,100,1,1500,1600,"Sub-basin 1"
140,200,14,3200,3400,"Sub-basin 1"
141,6300,3188,8900,15200,"Sub-basin 1"
142,100,2,800,900,"Sub-basin 1"
143,82100,3949,106100,188200,"Sub-basin 1"
144,1000,70,4500,5500,"Sub-basin 1"
145,500,74,2000,2500,"Sub-basin 1"
146,10000,2402,12800,22800,"Sub-basin 1"
147,100,4,800,900,"Sub-basin 1"
148,200,3,1300,1500,"Sub-basin 1"
149,800,24,3600,4400,"Sub-basin 1"
150,100,3,300,400,"Sub-basin 1"
151,1400,400,9500,10900,"Sub-basin 1"
152,400,31,1600,2000,"Sub-basin 1"
153,1200,47,5300,6500,"Sub-basin 1"
154,300,9,1000,1300,"Sub-basin 1"
155,200,4,1100,1300,"Sub-basin 1"
156,100,1,600,700,"Sub-basin 1"
157,4500,1888,7600,12100,"Sub-basin 1"
158,1300,27,6600,7900,"Sub-basin 1"
159,100,3,700,800,"Sub-basin 1"
160,100,2,900,1000,"Sub-basin 1"
161,400,19,1600,2000,"Sub-basin 1"
162,2600,437,5900,8500,"Sub-basin 1"
163,16700,7090,25900,42600,"Sub-basin 1"
164,100,1,1000,1100,"Sub-basin 1"
165,9600,626,16800,26400,"Sub-basin 1"
166,13000,5983,15300,28300,"Sub-basin 1"
167,2000,280,7000,9000,"Sub-basin 1"
168,300,32,2500,2800,"Sub-basin 1"
169,400,24,2300,2700,"Sub-basin 1"
170,100,2,600,700,"Sub-basin 1"
171,400,56,1600,2000,"Sub-basin 1"
172,100,1,100,200,"Sub-basin 1"
173,100,5,600,700,"Sub-basin 1"
174,100,5,1000,1100,"Sub-basin 1"
175,200,32,2300,2500,"Sub-basin 1"
176,400,7,1500,1900,"Sub-basin 1"
177,100,1,800,900,"Sub-basin 1"
178,100,1,500,600,"Sub-basin 1"
179,1400,466,2800,4200,"Sub-basin 1"
180,700,22,5100,5800,"Sub-basin 1"
181,1100,61,4300,5400,"Sub-basin 1"
182,300,5,1900,2200,"Sub-basin 1"
183,500,34,3300,3800,"Sub-basin 1"
184,2300,305,8700,11000,"Sub-basin 1"
185,100,1,1300,1400,"Sub-basin 1"
186,100,1,700,800,"Sub-basin 1"
187,100,1,1500,1600,"Sub-basin 1"
188,1400,227,4700,6100,"Sub-basin 1"
189,100,1,400,500,"Sub-basin 1"
190,800,79,2800,3600,"Sub-basin 1"
191,8300,4016,10300,18600,"Sub-basin 1"
192,100,2,200,300,"Sub-basin 1"
193,4300,156,15700,20000,"Sub-basin 1"
194,400,82,2300,2700,"Sub-basin 1"
195,2700,421,6100,8800,"Sub-basin 1"
196,100,4,1100,1200,"Sub-basin 1"
197,3500,798,9600,13100,"Sub-basin 1"
198,2000,121,9500,11500,"Sub-basin 1"
199,200,9,600,800,"Sub-basin 1"
200,25700,5991,50100,75800,"Sub-basin 1"
201,2100,648,4400,6500,"Sub-basin 1"
202,13800,3005,21700,35500,"Sub-basin 1"
203,2300,108,7600,9900,"Sub-basin 1"
204,500,105,2600,3100,"Sub-basin 1"
205,400,7,3600,4000,"Sub-basin 1"
206,100,1,500,600,"Sub-basin 1"
207,500,16,1500,2000,"Sub-basin 1"
208,400,21,3100,3500,"Sub-basin 1"
209,4100,1982,8300,12400,"Sub-basin 1"
210,9300,3177,11100,20400,"Sub-basin 1"
211,400,35,2300,2700,"Sub-basin 1"
212,300,6,2400,2700,"Sub-basin 1"
213,1100,164,4600,5700,"Sub-basin 1"
214,200,5,700,900,"Sub-basin 1"
215,2200,64,6900,9100,"Sub-basin 1"
216,800,55,1100,1900,"Sub-basin 1"
217,8000,673,22000,30000,"Sub-basin 1"
218,40300,12423,45800,86100,"Sub-basin 1"
219,100,6,300,400,"Sub-basin 1"
220,900,61,6000,6900,"Sub-basin 1"
221,100,2,900,1000,"Sub-basin 1"
222,600,168,1900,2500,"Sub-basin 1"
223,100,6,2300,2400,"Sub-basin 1"
224,100,2,500,600,"Sub-basin 1"
225,100,11,800,900,"Sub-basin 1"
226,1200,144,6700,7900,"Sub-basin 1"
227,2200,471,4400,6600,"Sub-basin 1"
228,5100,896,8400,13500,"Sub-basin 1"
229,8800,1262,16700,25500,"Sub-basin 1"
230,400,51,2300,2700,"Sub-basin 1"
231,100,1,800,900,"Sub-basin 1"
232,100,5,1200,1300,"Sub-basin 1"
233,8900,1992,20700,29600,"Sub-basin 1"
234,100,1,200,300,"Sub-basin 1"
235,100,1,600,700,"Sub-basin 1"
236,800,76,3500,4300,"Sub-basin 1"
237,12100,939,25100,37200,"Sub-basin 1"
238,10800,2896,17600,28400,"Sub-basin 1"
239,600,84,3100,3700,"Sub-basin 1"
240,100,4,1100,1200,"Sub-basin 1"
241,100,3,1100,1200,"Sub-basin 1"
242,100,1,200,300,"Sub-basin 1"
243,34600,1490.33,62800,97400,"Sub-basin 1"
244,400,13,2700,3100,"Sub-basin 1"
245,1200,263,1900,3100,"Sub-basin 1"
246,100,1,0,100,"Sub-basin 1"
247,1200,128,3100,4300,"Sub-basin 1"
248,4300,1280,8300,12600,"Sub-basin 1"
249,600,15,1900,2500,"Sub-basin 1"
250,1600,344,3000,4600,"Sub-basin 1"
251,1800,467,4300,6100,"Sub-basin 1"
252,100,3,600,700,"Sub-basin 1"
253,1100,150,2500,3600,"Sub-basin 1"
254,1400,491,3200,4600,"Sub-basin 1"
255,100,2,800,900,"Sub-basin 1"
256,1000,39,2600,3600,"Sub-basin 1"
257,2400,572,5000,7400,"Sub-basin 1"
258,200,18,2600,2800,"Sub-basin 1"
259,29000,7155,35800,64800,"Sub-basin 1"
260,700,57,3000,3700,"Sub-basin 1"
261,1500,395,2800,4300,"Sub-basin 1"
262,100,3,700,800,"Sub-basin 1"
263,500,31,900,1400,"Sub-basin 1"
264,100,7,700,800,"Sub-basin 1"
265,700,46,2600,3300,"Sub-basin 1"
266,30400,5264,53000,83400,"Sub-basin 1"
267,1300,213,4200,5500,"Sub-basin 1"
268,100,2,700,800,"Sub-basin 1"
269,300,3,100,400,"Sub-basin 1"
270,400,82,2700,3100,"Sub-basin 1"
271,100,1,1300,1400,"Sub-basin 1"
272,200,4,1900,2100,"Sub-basin 1"
273,1600,236,8700,10300,"Sub-basin 1"
274,8800,1993,14700,23500,"Sub-basin 1"
275,700,36,3400,4100,"Sub-basin 1"
276,4900,861,9500,14400,"Sub-basin 1"
277,700,22,2600,3300,"Sub-basin 1"
278,100,4,1000,1100,"Sub-basin 1"
279,4100,1450,5700,9800,"Sub-basin 1"
280,200,2,1600,1800,"Sub-basin 1"
281,100,2,1000,1100,"Sub-basin 1"
282,2200,78,6300,8500,"Sub-basin 1"
283,200,3,1300,1500,"Sub-basin 1"
284,14000,3490,15500,29500,"Sub-basin 1"
285,23400,5341,49100,72500,"Sub-basin 1"
286,9900,241,16800,26700,"Sub-basin 1"
287,1800,424,5500,7300,"Sub-basin 1"
288,500,24,3000,3500,"Sub-basin 1"
289,200,6,1900,2100,"Sub-basin 1"
290,100,1,600,700,"Sub-basin 1"
291,200,10,2200,2400,"Sub-basin 1"
292,7000,2745,11800,18800,"Sub-basin 1"
293,500,43,1900,2400,"Sub-basin 1"
294,800,112,3400,4200,"Sub-basin 1"
295,1300,308,3700,5000,"Sub-basin 1"
296,500,23,2400,2900,"Sub-basin 1"
297,19600,2658,29500,49100,"Sub-basin 1"
298,100,8,400,500,"Sub-basin 1"
299,1300,358,4900,6200,"Sub-basin 1"
300,1200,196,3800,5000,"Sub-basin 1"
301,100,5,800,900,"Sub-basin 1"
302,200,11,1300,1500,"Sub-basin 1"
303,500,67,2900,3400,"Sub-basin 1"
304,600,65,3100,3700,"Sub-basin 1"
305,21100,4453,26900,48000,"Sub-basin 1"
306,800,66,2200,3000,"Sub-basin 1"
307,200,6,1400,1600,"Sub-basin 1"
308,800,84,2400,3200,"Sub-basin 1"
309,400,51,1300,1700,"Sub-basin 1"
310,600,93,3000,3600,"Sub-basin 1"
311,100,1,800,900,"Sub-basin 1"
312,300,5,3600,3900,"Sub-basin 1"
313,600,27,3600,4200,"Sub-basin 1"
314,1000,166,4300,5300,"Sub-basin 1"
315,100,3,700,800,"Sub-basin 1"
316,100,4,1100,1200,"Sub-basin 1"
317,2100,480,5700,7800,"Sub-basin 1"
318,500,23,800,1300,"Sub-basin 1"
319,1200,46,5300,6500,"Sub-basin 1"
320,1400,54,2700,4100,"Sub-basin 1"
321,100,1,400,500,"Sub-basin 1"
322,100,3,800,900,"Sub-basin 1"
323,100,1,1300,1400,"Sub-basin 1"
324,14900,3906,18200,33100,"Sub-basin 1"
325,5600,624,8500,14100,"Sub-basin 1"
326,900,139,3500,4400,"Sub-basin 1"
327,2400,507,7800,10200,"Sub-basin 1"
328,300,12,1800,2100,"Sub-basin 1"
329,100,1,1000,1100,"Sub-basin 1"
330,3800,1142,7800,11600,"Sub-basin 1"
331,500,33,2900,3400,"Sub-basin 1"
332,800,18,4400,5200,"Sub-basin 1"
333,8800,1058,21600,30400,"Sub-basin 1"
334,400,28,1000,1400,"Sub-basin 1"
335,6000,2722,11600,17600,"Sub-basin 1"
336,200,11,1400,1600,"Sub-basin 1"
337,400,17,4400,4800,"Sub-basin 1"
338,400,91,1300,1700,"Sub-basin 1"
339,400,46,3000,3400,"Sub-basin 1"
340,25300,1812,84400,109700,"Sub-basin 1"
341,1700,61,4200,5900,"Sub-basin 1"
342,100,4,1200,1300,"Sub-basin 1"
343,1300,148,2700,4000,"Sub-basin 1"
344,200,5,1700,1900,"Sub-basin 1"
345,100,3,1700,1800,"Sub-basin 1"
346,2900,750,8200,11100,"Sub-basin 1"
347,5000,177,14900,19900,"Sub-basin 1"
348,10600,3241.16,15800,26400,"Sub-basin 1"
349,1600,492,5100,6700,"Sub-basin 1"
350,2900,966,9200,12100,"Sub-basin 1"
351,500,13,1800,2300,"Sub-basin 1"
352,9800,2753,10400,20200,"Sub-basin 1"
353,4700,1043,11300,16000,"Sub-basin 1"
354,4500,518,11800,16300,"Sub-basin 1"
355,19000,3557,25000,44000,"Sub-basin 1"
356,1500,207,6600,8100,"Sub-basin 1"
357,100,1,1000,1100,"Sub-basin 1"
358,700,11,3500,4200,"Sub-basin 1"
359,200,5,600,800,"Sub-basin 1"
360,400,34,500,900,"Sub-basin 1"
361,18300,1576.33,26600,44900,"Sub-basin 1"
362,200,8,200,400,"Sub-basin 1"
363,700,10,1900,2600,"Sub-basin 1"
364,2700,297,6400,9100,"Sub-basin 1"
365,1000,141,3600,4600,"Sub-basin 1"
366,7100,1822,15000,22100,"Sub-basin 1"
367,2100,121,4100,6200,"Sub-basin 1"
368,2600,440,5400,8000,"Sub-basin 1"
369,200,8,1600,1800,"Sub-basin 1"
370,100,1,500,600,"Sub-basin 1"
371,31300,9826,30500,61800,"Sub-basin 1"
372,100,1,900,1000,"Sub-basin 1"
373,6600,1343,17100,23700,"Sub-basin 1"
374,200,11,1400,1600,"Sub-basin 1"
375,400,31,1000,1400,"Sub-basin 1"
376,16700,4742.34,38700,55400,"Sub-basin 1"
377,2600,912,5100,7700,"Sub-basin 1"
378,13900,2357,26200,40100,"Sub-basin 1"
379,400,51,2000,2400,"Sub-basin 1"
380,23600,1210.33,30500,54100,"Sub-basin 1"
381,100,1,300,400,"Sub-basin 1"
382,500,12,1800,2300,"Sub-basin 1"
383,100,2,1000,1100,"Sub-basin 1"
384,500,6,4500,5000,"Sub-basin 1"
385,800,100,3500,4300,"Sub-basin 1"
386,600,17,5600,6200,"Sub-basin 1"
387,1300,483,2100,3400,"Sub-basin 1"
388,4800,1528,9400,14200,"Sub-basin 1"
389,300,20,2100,2400,"Sub-basin 1"
390,300,17,1300,1600,"Sub-basin 1"
391,500,41,2900,3400,"Sub-basin 1"
392,100,2,200,300,"Sub-basin 1"
393,400,8,2300,2700,"Sub-basin 1"
394,600,83,3100,3700,"Sub-basin 1"
395,100,1,700,800,"Sub-basin 1"
396,100,1,400,500,"Sub-basin 1"
397,100,10,1200,1300,"Sub-basin 1"
398,100,1,100,200,"Sub-basin 1"
399,100,3,800,900,"Sub-basin 1"
400,200,4,400,600,"Sub-basin 1"
401,400,82,2500,2900,"Sub-basin 1"
402,1300,406,4700,6000,"Sub-basin 1"
403,1400,159,3400,4800,"Sub-basin 1"
404,600,162,2400,3000,"Sub-basin 1"
405,500,13,2600,3100,"Sub-basin 1"
406,100,2,500,600,"Sub-basin 1"
407,4300,125,21500,25800,"Sub-basin 1"
408,600,85,3200,3800,"Sub-basin 1"
409,6200,1161,9800,16000,"Sub-basin 1"
410,1500,407,5900,7400,"Sub-basin 1"
411,100,3,100,200,"Sub-basin 1"
412,200,9.66,1600,1800,"Sub-basin 1"
413,8600,1863,14700,23300,"Sub-basin 1"
414,200,3,1000,1200,"Sub-basin 1"
415,300,18,1200,1500,"Sub-basin 1"
416,500,27,2800,3300,"Sub-basin 1"
417,100,3,800,900,"Sub-basin 1"
418,400,43,1900,2300,"Sub-basin 1"
419,400,19,1900,2300,"Sub-basin 1"
420,3000,929,8100,11100,"Sub-basin 1"
421,31700,9678,32600,64300,"Sub-basin 1"
422,3600,844,8800,12400,"Sub-basin 1"
423,2900,68,9700,12600,"Sub-basin 1"
424,100,2,800,900,"Sub-basin 1"
425,300,8,2600,2900,"Sub-basin 1"
426,13400,3856,20800,34200,"Sub-basin 1"
427,5800,172,33000,38800,"Sub-basin 1"
428,500,13,1000,1500,"Sub-basin 1"
429,1100,31,3000,4100,"Sub-basin 1"
430,600,47,3300,3900,"Sub-basin 1"
431,84400,22686,88000,172400,"Sub-basin 1"
432,100,1,800,900,"Sub-basin 1"
433,1000,171,4700,5700,"Sub-basin 1"
434,100,4,800,900,"Sub-basin 1"
435,1100,364,3700,4800,"Sub-basin 1"
436,3500,885,12200,15700,"Sub-basin 1"
437,700,113,1900,2600,"Sub-basin 1"
438,200,3,1600,1800,"Sub-basin 1"
439,800,123,2500,3300,"Sub-basin 1"
440,200,19,1800,2000,"Sub-basin 1"
441,100,9,700,800,"Sub-basin 1"
442,200,4,1000,1200,"Sub-basin 1"
443,500,31,1000,1500,"Sub-basin 1"
444,800,36,2900,3700,"Sub-basin 1"
445,100,1,1300,1400,"Sub-basin 1"
446,200,16,1700,1900,"Sub-basin 1"
447,30000,8741,29000,59000,"Sub-basin 1"
448,600,38,3500,4100,"Sub-basin 1"
449,600,85,1900,2500,"Sub-basin 1"
450,1000,21,5200,6200,"Sub-basin 1"
451,1500,155,3800,5300,"Sub-basin 1"
452,1500,119,9000,10500,"Sub-basin 1"
453,100,2,600,700,"Sub-basin 1"
454,1400,423,3500,4900,"Sub-basin 1"
455,200,7,1600,1800,"Sub-basin 1"
456,25800,1454,42100,67900,"Sub-basin 1"
457,500,75,3200,3700,"Sub-basin 1"
458,3400,918,8000,11400,"Sub-basin 1"
459,3400,565,8400,11800,"Sub-basin 1"
460,100,3,1100,1200,"Sub-basin 1"
461,1600,161,10400,12000,"Sub-basin 1"
462,10900,2640,17600,28500,"Sub-basin 1"
463,600,181,1600,2200,"Sub-basin 1"
464,3600,672,13300,16900,"Sub-basin 1"
465,100,4,1200,1300,"Sub-basin 1"
466,300,12,1900,2200,"Sub-basin 1"
467,100,1,600,700,"Sub-basin 1"
468,100,3,500,600,"Sub-basin 1"
469,200,7,2700,2900,"Sub-basin 1"
470,400,71,1400,1800,"Sub-basin 1"
471,200,4,1300,1500,"Sub-basin 1"
472,400,30,1200,1600,"Sub-basin 1"
473,68500,27551.16,87000,155500,"Sub-basin 1"
474,1500,224,4700,6200,"Sub-basin 1"
475,5500,524,11000,16500,"Sub-basin 1"
476,7300,738,14700,22000,"Sub-basin 1"
477,600,87,2100,2700,"Sub-basin 1"
478,500,23,3900,4400,"Sub-basin 1"
479,300,5,4000,4300,"Sub-basin 1"
480,800,141,1700,2500,"Sub-basin 1"
481,100,1,700,800,"Sub-basin 1"
482,100,3,700,800,"Sub-basin 1"
483,1000,197,3900,4900,"Sub-basin 1"
484,1300,72,9800,11100,"Sub-basin 1"
485,400,11,3500,3900,"Sub-basin 1"
486,400,17,5900,6300,"Sub-basin 1"
487,1100,103,5500,6600,"Sub-basin 1"
488,900,130,3900,4800,"Sub-basin 1"
489,6100,193,19500,25600,"Sub-basin 1"
490,1000,221,5000,6000,"Sub-basin 1"
491,100,2,1400,1500,"Sub-basin 1"
492,1800,275,9300,11100,"Sub-basin 1"
493,200,9,1000,1200,"Sub-basin 1"
494,100,1,100,200,"Sub-basin 1"
495,100,4,800,900,"Sub-basin 1"
496,168600,56807.5,171800,340400,"Sub-basin 1"
497,600,116,3400,4000,"Sub-basin 1"
498,2200,364,3700,5900,"Sub-basin 1"
499,10100,1538,23500,33600,"Sub-basin 1"
500,300,4,700,1000,"Sub-basin 1"
501,19400,497,39000,58400,"Sub-basin 1"
502,1000,89,3100,4100,"Sub-basin 1"
503,600,61,2800,3400,"Sub-basin 1"
504,100,2,600,700,"Sub-basin 1"
505,300,15,2200,2500,"Sub-basin 1"
506,400,31,2800,3200,"Sub-basin 1"
507,200,11,1700,1900,"Sub-basin 1"
508,6600,1321,17000,23600,"Sub-basin 1"
509,500,38,2000,2500,"Sub-basin 1"
510,100,1,1000,1100,"Sub-basin 1"
511,18700,1612,29100,47800,"Sub-basin 1"
512,100,3,800,900,"Sub-basin 1"
513,3300,214,11000,14300,"Sub-basin 1"
514,100,2,1000,1100,"Sub-basin 1"
515,1600,263,4600,6200,"Sub-basin 1"
516,300,10,1900,2200,"Sub-basin 1"
517,1200,233,3800,5000,"Sub-basin 1"
518,9600,1293,37800,47400,"Sub-basin 1"
519,1700,328,4500,6200,"Sub-basin 1"
520,100,1,2700,2800,"Sub-basin 1"
521,1700,368,6000,7700,"Sub-basin 1"
522,100,2,1000,1100,"Sub-basin 1"
523,200,3,1500,1700,"Sub-basin 1"
524,100,5,800,900,"Sub-basin 1"
525,600,52,4300,4900,"Sub-basin 1"
526,700,206,1600,2300,"Sub-basin 1"
527,5800,2494,6700,12500,"Sub-basin 1"
528,8600,967,15500,24100,"Sub-basin 1"
529,1800,196,6400,8200,"Sub-basin 1"
530,61700,4784,83900,145600,"Sub-basin 1"
531,400,14,3200,3600,"Sub-basin 1"
532,800,54,1500,2300,"Sub-basin 1"
533,100,4,600,700,"Sub-basin 1"
534,100,2,600,700,"Sub-basin 1"
535,4400,238,18100,22500,"Sub-basin 1"
536,5600,301,13100,18700,"Sub-basin 1"
537,100,2,400,500,"Sub-basin 1"
538,800,36,4000,4800,"Sub-basin 1"
539,1200,225,6700,7900,"Sub-basin 1"
540,400,12,3600,4000,"Sub-basin 1"
541,600,18,1700,2300,"Sub-basin 1"
542,100,1,2800,2900,"Sub-basin 1"
543,200,6,2200,2400,"Sub-basin 1"
544,400,14,2000,2400,"Sub-basin 1"
545,2700,596,9900,12600,"Sub-basin 1"
546,6500,1936,11300,17800,"Sub-basin 1"
547,24700,7941,39900,64600,"Sub-basin 1"
548,100,1,1900,2000,"Sub-basin 1"
549,100,3,1200,1300,"Sub-basin 1"
550,700,46,2000,2700,"Sub-basin 1"
551,800,85,1400,2200,"Sub-basin 1"
552,5300,1520,13200,18500,"Sub-basin 1"
553,1100,132,1200,2300,"Sub-basin 1"
554,800,129,5800,6600,"Sub-basin 1"
555,100,2,1300,1400,"Sub-basin 1"
556,2900,419,9500,12400,"Sub-basin 1"
557,3600,368,12200,15800,"Sub-basin 1"
558,500,18,3700,4200,"Sub-basin 1"
559,300,4,1200,1500,"Sub-basin 1"
560,23200,9286,23900,47100,"Sub-basin 1"
561,1700,207,7100,8800,"Sub-basin 1"
562,400,91,600,1000,"Sub-basin 1"
563,1000,81,7000,8000,"Sub-basin 1"
564,200,4,2900,3100,"Sub-basin 1"
565,2400,379,8300,10700,"Sub-basin 1"
566,2700,247,10700,13400,"Sub-basin 1"
567,300,6,4100,4400,"Sub-basin 1"
568,100,4,1900,2000,"Sub-basin 1"
569,900,157,2400,3300,"Sub-basin 1"
570,400,13,1200,1600,"Sub-basin 1"
571,1100,110,5000,6100,"Sub-basin 1"
572,800,72,4200,5000,"Sub-basin 1"
573,400,18,4500,4900,"Sub-basin 1"
574,8600,928,33800,42400,"Sub-basin 1"
575,1000,208.17,2700,3700,"Sub-basin 1"
576,2000,46,12000,14000,"Sub-basin 1"
577,1300,199,7300,8600,"Sub-basin 1"
578,1100,270,3100,4200,"Sub-basin 1"
579,100,2,1200,1300,"Sub-basin 1"
580,100,2,2000,2100,"Sub-basin 1"
581,100,3,600,700,"Sub-basin 1"
582,5000,1105,15100,20100,"Sub-basin 1"
583,100,7,1000,1100,"Sub-basin 1"
584,100,2,1300,1400,"Sub-basin 1"
585,300,3,1900,2200,"Sub-basin 1"
586,600,94,2400,3000,"Sub-basin 1"
587,1600,102,9200,10800,"Sub-basin 1"
588,200,4,900,1100,"Sub-basin 1"
589,500,17,3800,4300,"Sub-basin 1"
590,100,1,1200,1300,"Sub-basin 1"
591,1000,121,5300,6300,"Sub-basin 1"
592,100,3,1500,1600,"Sub-basin 1"
593,200,6,1200,1400,"Sub-basin 1"
594,3000,752,5700,8700,"Sub-basin 1"
595,1200,80,3900,5100,"Sub-basin 1"
596,500,11,3400,3900,"Sub-basin 1"
597,100,1,1400,1500,"Sub-basin 1"
598,100,1,1200,1300,"Sub-basin 1"
599,600,204,3000,3600,"Sub-basin 1"
600,800,74,3500,4300,"Sub-basin 1"
601,900,167,4500,5400,"Sub-basin 1"
602,6400,1211,13400,19800,"Sub-basin 1"
603,1000,241,6700,7700,"Sub-basin 1"
604,100,4,1400,1500,"Sub-basin 1"
605,100,4,400,500,"Sub-basin 1"
606,22200,1392,43700,65900,"Sub-basin 1"
607,4100,145,10600,14700,"Sub-basin 1"
608,48400,2680,70500,118900,"Sub-basin 1"
609,100,1,800,900,"Sub-basin 1"
610,3500,196,12300,15800,"Sub-basin 1"
611,200,17,1800,2000,"Sub-basin 1"
612,1300,280,4800,6100,"Sub-basin 1"
613,400,10,3300,3700,"Sub-basin 1"
614,400,23,600,1000,"Sub-basin 1"
615,1600,243,3400,5000,"Sub-basin 1"
616,1900,290,7600,9500,"Sub-basin 1"
617,700,83,1800,2500,"Sub-basin 1"
618,2200,302,6300,8500,"Sub-basin 1"
619,33900,5990.67,45400,79300,"Sub-basin 1"
620,3000,854,9700,12700,"Sub-basin 1"
621,1200,277,4600,5800,"Sub-basin 1"
622,100,4,1600,1700,"Sub-basin 1"
623,100,7,1100,1200,"Sub-basin 1"
624,100,3,1400,1500,"Sub-basin 1"
625,100,1,1200,1300,"Sub-basin 1"
626,200,2,2100,2300,"Sub-basin 1"
627,1500,323,7300,8800,"Sub-basin 1"
628,600,98,2600,3200,"Sub-basin 1"
629,225200,82410,222200,447400,"Sub-basin 1"
630,400,35,3400,3800,"Sub-basin 1"
631,900,61,5400,6300,"Sub-basin 1"
632,400,37,1300,1700,"Sub-basin 1"
633,600,137,2600,3200,"Sub-basin 1"
634,4700,1193,9400,14100,"Sub-basin 1"
635,1700,277,6200,7900,"Sub-basin 1"
636,100,1,1600,1700,"Sub-basin 1"
637,2500,52,12000,14500,"Sub-basin 1"
638,100,1,1000,1100,"Sub-basin 1"
639,200,5,2400,2600,"Sub-basin 1"
640,500,10,2600,3100,"Sub-basin 1"
641,200,5,1200,1400,"Sub-basin 1"
642,200,3,2600,2800,"Sub-basin 1"
643,200,3,1700,1900,"Sub-basin 1"
644,700,16,4300,5000,"Sub-basin 1"
645,100,1,800,900,"Sub-basin 1"
646,500,12,4500,5000,"Sub-basin 1"
647,900,26,6100,7000,"Sub-basin 1"
648,3500,1221,7300,10800,"Sub-basin 1"
649,100,1,400,500,"Sub-basin 1"
650,100,1,1700,1800,"Sub-basin 1"
651,100,1,2000,2100,"Sub-basin 1"
652,200,6,2600,2800,"Sub-basin 1"
653,100,1,1500,1600,"Sub-basin 1"
654,6200,1220,13500,19700,"Sub-basin 1"
655,100,2,1200,1300,"Sub-basin 1"
656,300,5,2200,2500,"Sub-basin 1"
657,900,26,4800,5700,"Sub-basin 1"
658,300,19,2000,2300,"Sub-basin 1"
659,800,38,5400,6200,"Sub-basin 1"
660,5500,1626,14700,20200,"Sub-basin 1"
661,200,2,900,1100,"Sub-basin 1"
662,1200,194,7600,8800,"Sub-basin 1"
663,400,6,4500,4900,"Sub-basin 1"
664,700,47,4400,5100,"Sub-basin 1"
665,100,2,1400,1500,"Sub-basin 1"
666,100,1,900,1000,"Sub-basin 1"
667,800,88,4900,5700,"Sub-basin 1"
668,100,1,800,900,"Sub-basin 1"
669,100,3,1100,1200,"Sub-basin 1"
670,700,63,4000,4700,"Sub-basin 1"
671,125200,49397.84,103600,228800,"Sub-basin 1"
672,1179600,477639.0524,816100,1995700,"Sub-basin 1"
673,100,3,1100,1200,"Sub-basin 1"
674,100,2,1000,1100,"Sub-basin 1"
675,100,3,700,800,"Sub-basin 1"
676,100,4,1200,1300,"Sub-basin 1"
677,100,1,1100,1200,"Sub-basin 1"
678,4000,68,18200,22200,"Sub-basin 1"
679,500,13,3400,3900,"Sub-basin 1"
680,1600,381,7000,8600,"Sub-basin 1"
681,500,30,1900,2400,"Sub-basin 1"
682,100,1,100,200,"Sub-basin 1"
683,100,1,1300,1400,"Sub-basin 1"
684,100,2,3300,3400,"Sub-basin 1"
685,400,27,1700,2100,"Sub-basin 1"
686,2000,165,7100,9100,"Sub-basin 1"
687,200,4,2200,2400,"Sub-basin 1"
688,100,1,200,300,"Sub-basin 1"
689,100,3,1600,1700,"Sub-basin 1"
690,100,1,1200,1300,"Sub-basin 1"
691,100,3,1600,1700,"Sub-basin 1"
692,500,46,3400,3900,"Sub-basin 1"
693,100,3,600,700,"Sub-basin 1"
694,300,5,1200,1500,"Sub-basin 1"
695,2300,443,5700,8000,"Sub-basin 1"
696,1200,312,3800,5000,"Sub-basin 1"
697,300,6,1200,1500,"Sub-basin 1"
698,131700,10782.4847,194000,325700,"Sub-basin 1"
699,200,3,900,1100,"Sub-basin 1"
700,1100,239,4400,5500,"Sub-basin 1"
701,400,4,2000,2400,"Sub-basin 1"
702,2600,727,10500,13100,"Sub-basin 1"
703,300,12,1500,1800,"Sub-basin 1"
704,2800,154,9400,12200,"Sub-basin 1"
705,100,1,1200,1300,"Sub-basin 1"
706,200,2,2000,2200,"Sub-basin 1"
707,700,74,2100,2800,"Sub-basin 1"
708,400,63,1100,1500,"Sub-basin 1"
709,900,118,3300,4200,"Sub-basin 1"
710,4500,1005,10100,14600,"Sub-basin 1"
711,3000,425,9600,12600,"Sub-basin 1"
712,100,6,1000,1100,"Sub-basin 1"
713,300,23,1600,1900,"Sub-basin 1"
714,10000,1465,12900,22900,"Sub-basin 1"
715,100,1,400,500,"Sub-basin 1"
716,500,36,4600,5100,"Sub-basin 1"
717,700,94,2000,2700,"Sub-basin 1"
718,100,2,500,600,"Sub-basin 1"
719,13300,2854,39000,52300,"Sub-basin 1"
720,400,23,1800,2200,"Sub-basin 1"
721,600,100,4000,4600,"Sub-basin 1"
722,400,35,1800,2200,"Sub-basin 1"
723,10300,2012,15300,25600,"Sub-basin 1"
724,100,3,1800,1900,"Sub-basin 1"
725,29100,7724,43500,72600,"Sub-basin 1"
726,600,14,6700,7300,"Sub-basin 1"
727,200,3,1700,1900,"Sub-basin 1"
728,200,5,1800,2000,"Sub-basin 1"
729,300,26,700,1000,"Sub-basin 1"
730,800,195,2000,2800,"Sub-basin 1"
731,100,1,1300,1400,"Sub-basin 1"
732,200,5,2400,2600,"Sub-basin 1"
733,1400,154,6100,7500,"Sub-basin 1"
734,800,231,2900,3700,"Sub-basin 1"
735,400,14,2100,2500,"Sub-basin 1"
736,200,3,2000,2200,"Sub-basin 1"
737,200,10,2200,2400,"Sub-basin 1"
738,100,5,1300,1400,"Sub-basin 1"
739,1800,629,4300,6100,"Sub-basin 1"
740,100,3,1000,1100,"Sub-basin 1"
741,100,1,700,800,"Sub-basin 1"
742,31100,4488,44700,75800,"Sub-basin 1"
743,400,88,2400,2800,"Sub-basin 1"
744,1800,40,13300,15100,"Sub-basin 1"
745,2000,599,4800,6800,"Sub-basin 1"
746,200,3,1700,1900,"Sub-basin 1"
747,9000,2416,18300,27300,"Sub-basin 1"
748,1000,25,6900,7900,"Sub-basin 1"
749,200,23,3500,3700,"Sub-basin 1"
750,400,6,1000,1400,"Sub-basin 1"
751,1300,237,3800,5100,"Sub-basin 1"
752,1400,173,4000,5400,"Sub-basin 1"
753,100,3,1900,2000,"Sub-basin 1"
754,700,109,3500,4200,"Sub-basin 1"
755,100,2,300,400,"Sub-basin 1"
756,14500,2471,32100,46600,"Sub-basin 1"
757,400,67,3900,4300,"Sub-basin 1"
758,134200,39795.5,102500,236700,"Sub-basin 1"
759,7100,980,18500,25600,"Sub-basin 1"
760,400,37,2000,2400,"Sub-basin 1"
761,900,50,5300,6200,"Sub-basin 1"
762,800,56,3600,4400,"Sub-basin 1"
763,500,43,3900,4400,"Sub-basin 1"
764,600,16,2000,2600,"Sub-basin 1"
765,800,36,6400,7200,"Sub-basin 1"
766,100,2,1900,2000,"Sub-basin 1"
767,200,2,2600,2800,"Sub-basin 1"
768,500,18,2700,3200,"Sub-basin 1"
769,100,1,900,1000,"Sub-basin 1"
770,600,26,3300,3900,"Sub-basin 1"
771,4900,214,10600,15500,"Sub-basin 1"
772,1700,71,6500,8200,"Sub-basin 1"
773,3600,869,7200,10800,"Sub-basin 1"
774,2000,56,8600,10600,"Sub-basin 1"
775,3300,437,13000,16300,"Sub-basin 1"
776,2200,333,11300,13500,"Sub-basin 1"
777,2400,578,5200,7600,"Sub-basin 1"
778,300,6,800,1100,"Sub-basin 1"
779,600,91,1800,2400,"Sub-basin 1"
780,4000,374,11700,15700,"Sub-basin 1"
781,600,66,3600,4200,"Sub-basin 1"
782,100,1,1300,1400,"Sub-basin 1"
783,900,272,3300,4200,"Sub-basin 1"
784,800,35,1800,2600,"Sub-basin 1"
785,8500,2097,16000,24500,"Sub-basin 1"
786,200,5,1700,1900,"Sub-basin 1"
787,100,2,1200,1300,"Sub-basin 1"
788,1800,434,8100,9900,"Sub-basin 1"
789,100,7,700,800,"Sub-basin 1"
790,800,57,3400,4200,"Sub-basin 1"
791,10900,1815,28700,39600,"Sub-basin 1"
792,100,3,600,700,"Sub-basin 1"
793,200,2,700,900,"Sub-basin 1"
794,1100,143,5900,7000,"Sub-basin 1"
795,100,1,300,400,"Sub-basin 1"
796,300,7,1000,1300,"Sub-basin 1"
797,100,3,1200,1300,"Sub-basin 1"
798,3400,966,13500,16900,"Sub-basin 1"
799,8700,1734,14300,23000,"Sub-basin 1"
800,1400,331,3300,4700,"Sub-basin 1"
801,300,7,1700,2000,"Sub-basin 1"
802,1600,110,7600,9200,"Sub-basin 1"
803,1400,355,3500,4900,"Sub-basin 1"
804,800,93,4300,5100,"Sub-basin 1"
805,200,26,1000,1200,"Sub-basin 1"
806,900,70,8500,9400,"Sub-basin 1"
807,3500,1284,7200,10700,"Sub-basin 1"
808,100,1,1300,1400,"Sub-basin 1"
809,1100,86,7700,8800,"Sub-basin 1"
810,200,10,1300,1500,"Sub-basin 1"
811,14200,2534,36100,50300,"Sub-basin 1"
812,500,34,1600,2100,"Sub-basin 1"
813,100,1,900,1000,"Sub-basin 1"
814,900,201,4000,4900,"Sub-basin 1"
815,200,6,600,800,"Sub-basin 1"
816,3400,657,9300,12700,"Sub-basin 1"
817,3400,333,24200,27600,"Sub-basin 1"
818,600,52,5800,6400,"Sub-basin 1"
819,600,80,2600,3200,"Sub-basin 1"
820,500,30,2500,3000,"Sub-basin 1"
821,100,1,300,400,"Sub-basin 1"
822,1900,252,12900,14800,"Sub-basin 1"
823,100,2,1600,1700,"Sub-basin 1"
824,8800,1889,14100,22900,"Sub-basin 1"
825,900,134,3400,4300,"Sub-basin 1"
826,2900,833,13100,16000,"Sub-basin 1"
827,200,7,3600,3800,"Sub-basin 1"
828,500,32,2700,3200,"Sub-basin 1"
829,100,2,800,900,"Sub-basin 1"
830,100,1,2200,2300,"Sub-basin 1"
831,4900,1251.83,13500,18400,"Sub-basin 1"
832,2200,265,7600,9800,"Sub-basin 1"
833,24000,2375,50700,74700,"Sub-basin 1"
834,400,68,2000,2400,"Sub-basin 1"
835,1200,193,4100,5300,"Sub-basin 1"
836,5500,1502.5,6100,11600,"Sub-basin 1"
837,100,1,800,900,"Sub-basin 1"
838,30000,10542,55900,85900,"Sub-basin 1"
839,1500,157,6500,8000,"Sub-basin 1"
840,2600,1009,6000,8600,"Sub-basin 1"
841,21600,12163.0624,19800,41400,"Sub-basin 1"
842,300,11,1000,1300,"Sub-basin 1"
843,100,1,800,900,"Sub-basin 1"
844,200,2,2500,2700,"Sub-basin 1"
845,100,2,1400,1500,"Sub-basin 1"
846,100,1,1900,2000,"Sub-basin 1"
847,16700,3562,30500,47200,"Sub-basin 1"
848,9700,1732,21000,30700,"Sub-basin 1"
849,200,10,1200,1400,"Sub-basin 1"
850,500,69,2000,2500,"Sub-basin 1"
851,300,14,1700,2000,"Sub-basin 1"
852,200,15,800,1000,"Sub-basin 1"
853,5400,1541,11400,16800,"Sub-basin 1"
854,2500,846,4200,6700,"Sub-basin 1"
855,7100,1823,10900,18000,"Sub-basin 1"
856,100,2,2300,2400,"Sub-basin 1"
857,3600,528,7200,10800,"Sub-basin 1"
858,200,2,1500,1700,"Sub-basin 1"
859,4600,300,18200,22800,"Sub-basin 1"
860,200,4,3100,3300,"Sub-basin 1"
861,100,5,1700,1800,"Sub-basin 1"
862,200,2,3800,4000,"Sub-basin 1"
863,2000,545,5200,7200,"Sub-basin 1"
864,13600,1360,28200,41800,"Sub-basin 1"
865,600,66.66,2800,3400,"Sub-basin 1"
866,600,53,4500,5100,"Sub-basin 1"
867,2300,815,7500,9800,"Sub-basin 1"
868,100,15,1200,1300,"Sub-basin 1"
869,400,39,1200,1600,"Sub-basin 1"
870,100,3,700,800,"Sub-basin 1"
871,100,6,1100,1200,"Sub-basin 1"
872,2200,522,5900,8100,"Sub-basin 1"
873,900,64,5000,5900,"Sub-basin 1"
874,200,2,2000,2200,"Sub-basin 1"
875,74400,33166,68100,142500,"Sub-basin 1"
876,100,1,900,1000,"Sub-basin 1"
877,4500,1144,12900,17400,"Sub-basin 1"
878,800,100,3800,4600,"Sub-basin 1"
879,7400,1952,12200,19600,"Sub-basin 1"
880,700,77,4400,5100,"Sub-basin 1"
881,600,44,2800,3400,"Sub-basin 1"
882,1600,88,3900,5500,"Sub-basin 1"
883,500,29,3100,3600,"Sub-basin 1"
884,2400,599,4000,6400,"Sub-basin 1"
885,700,132,1800,2500,"Sub-basin 1"
886,400,24,1500,1900,"Sub-basin 1"
887,2200,234,12400,14600,"Sub-basin 1"
888,100,1,700,800,"Sub-basin 1"
889,1500,190.0975,4300,5800,"Sub-basin 1"
890,11600,4985,11700,23300,"Sub-basin 1"
891,1100,181,8300,9400,"Sub-basin 1"
892,400,27,1200,1600,"Sub-basin 1"
893,800,168,2800,3600,"Sub-basin 1"
894,200,7,1700,1900,"Sub-basin 1"
895,3500,255,16400,19900,"Sub-basin 1"
896,1100,136,5300,6400,"Sub-basin 1"
897,6200,1705,3400,9600,"Sub-basin 1"
898,2200,470,4900,7100,"Sub-basin 1"
899,300,5,2100,2400,"Sub-basin 1"
900,2000,383,10000,12000,"Sub-basin 1"
901,800,165,2400,3200,"Sub-basin 1"
902,5500,654,18800,24300,"Sub-basin 1"
903,100,1,1300,1400,"Sub-basin 1"
904,100,3,900,1000,"Sub-basin 1"
905,1100,226,7600,8700,"Sub-basin 1"
906,31900,15576,42800,74700,"Sub-basin 1"
907,100,2,1600,1700,"Sub-basin 1"
908,600,218,2800,3400,"Sub-basin 1"
909,3100,951,10600,13700,"Sub-basin 1"
910,100,1,1100,1200,"Sub-basin 1"
911,800,134,3100,3900,"Sub-basin 1"
912,1200,197,6600,7800,"Sub-basin 1"
913,2700,310,10700,13400,"Sub-basin 1"
914,100,4,1200,1300,"Sub-basin 1"
915,100,2,300,400,"Sub-basin 1"
916,1300,60,3700,5000,"Sub-basin 1"
917,100,1,600,700,"Sub-basin 1"
918,500,26,4300,4800,"Sub-basin 1"
919,2700,872,4700,7400,"Sub-basin 1"
920,900,140,5800,6700,"Sub-basin 1"
921,100,1,800,900,"Sub-basin 1"
922,600,33,2600,3200,"Sub-basin 1"
923,300,9,2800,3100,"Sub-basin 1"
924,1100,51,7100,8200,"Sub-basin 1"
925,5000,974,14200,19200,"Sub-basin 1"
926,500,20,3300,3800,"Sub-basin 1"
927,1700,231,7300,9000,"Sub-basin 1"
928,100,1,800,900,"Sub-basin 1"
929,41800,14146,61100,102900,"Sub-basin 1"
930,100,1,400,500,"Sub-basin 1"
931,9400,3132,18000,27400,"Sub-basin 1"
932,100,1,900,1000,"Sub-basin 1"
933,1000,70,4600,5600,"Sub-basin 1"
934,62300,4111,160200,222500,"Sub-basin 1"
935,900,96,3200,4100,"Sub-basin 1"
936,700,48,7400,8100,"Sub-basin 1"
937,400,26,4700,5100,"Sub-basin 1"
938,1200,212,7700,8900,"Sub-basin 1"
939,700,81.035,3700,4400,"Sub-basin 1"
940,500,48,3500,4000,"Sub-basin 1"
941,200,4,1900,2100,"Sub-basin 1"
942,200,11,1800,2000,"Sub-basin 1"
943,300,15,4000,4300,"Sub-basin 1"
944,100,3,1000,1100,"Sub-basin 1"
945,800,31,7400,8200,"Sub-basin 1"
946,400,36,1000,1400,"Sub-basin 1"
947,118900,22418.17,136800,255700,"Sub-basin 1"
948,100,3,600,700,"Sub-basin 1"
949,100,2,500,600,"Sub-basin 1"
950,3100,206,10700,13800,"Sub-basin 1"
951,1200,227,5200,6400,"Sub-basin 1"
952,3700,1444,5900,9600,"Sub-basin 1"
953,200,7,1100,1300,"Sub-basin 1"
954,400,8,4300,4700,"Sub-basin 1"
955,200,6,2300,2500,"Sub-basin 1"
956,300,11,2700,3000,"Sub-basin 1"
957,300,10,1700,2000,"Sub-basin 1"
958,800,29,6100,6900,"Sub-basin 1"
959,600,72,3800,4400,"Sub-basin 1"
960,100,2,1100,1200,"Sub-basin 1"
961,800,98,3600,4400,"Sub-basin 1"
962,200,10,3100,3300,"Sub-basin 1"
963,3600,498,15200,18800,"Sub-basin 1"
964,100,2,600,700,"Sub-basin 1"
965,1600,465,6500,8100,"Sub-basin 1"
966,100,9,1000,1100,"Sub-basin 1"
967,400,35,5100,5500,"Sub-basin 1"
968,100,3,2600,2700,"Sub-basin 1"
969,200,25,2300,2500,"Sub-basin 1"
970,500,19,4100,4600,"Sub-basin 1"
971,100,3,1200,1300,"Sub-basin 1"
972,100,1,1300,1400,"Sub-basin 1"
973,200,22,4000,4200,"Sub-basin 1"
974,11300,3568,16400,27700,"Sub-basin 1"
975,1900,314,10300,12200,"Sub-basin 1"
976,1000,247,6000,7000,"Sub-basin 1"
977,500,21,4800,5300,"Sub-basin 1"
978,500,22,3100,3600,"Sub-basin 1"
979,200,7,1600,1800,"Sub-basin 1"
980,1000,181,5500,6500,"Sub-basin 1"
981,700,61.055,11800,12500,"Sub-basin 1"
982,700,61,6500,7200,"Sub-basin 1"
983,700,91,2700,3400,"Sub-basin 1"
984,200,3,3000,3200,"Sub-basin 1"
985,300,23,2900,3200,"Sub-basin 1"
986,600,184,3500,4100,"Sub-basin 1"
987,200,6,2700,2900,"Sub-basin 1"
988,100,2,1300,1400,"Sub-basin 1"
989,12000,1295,41900,53900,"Sub-basin 1"
990,400,10,1500,1900,"Sub-basin 1"
991,300,40,3400,3700,"Sub-basin 1"
992,100,2,2100,2200,"Sub-basin 1"
993,1100,240,3900,5000,"Sub-basin 1"
994,100,3,1500,1600,"Sub-basin 1"
995,800,40,3900,4700,"Sub-basin 1"
996,1300,283,6900,8200,"Sub-basin 1"
997,200,14,1300,1500,"Sub-basin 1"
998,100,1,1600,1700,"Sub-basin 1"
999,6000,1331,19100,25100,"Sub-basin 1"
1000,700,88,2200,2900,"Sub-basin 1"
1001,200,2,2500,2700,"Sub-basin 1"
1002,2600,398,15600,18200,"Sub-basin 1"
1003,100,4,1400,1500,"Sub-basin 1"
1004,100,1.0024,700,800,"Sub-basin 1"
1005,1800,103,11000,12800,"Sub-basin 1"
1006,7200,2575,11500,18700,"Sub-basin 1"
1007,700,63,1900,2600,"Sub-basin 1"
1008,10700,2121,15700,26400,"Sub-basin 1"
1009,100,2,1600,1700,"Sub-basin 1"
1010,700,44.0319,10400,11100,"Sub-basin 1"
1011,400,16,1500,1900,"Sub-basin 1"
1012,100,2,1300,1400,"Sub-basin 1"
1013,4800,396,8700,13500,"Sub-basin 1"
1014,100,5,600,700,"Sub-basin 1"
1015,500,38,3600,4100,"Sub-basin 1"
1016,100,4,700,800,"Sub-basin 1"
1017,4100,368,9500,13600,"Sub-basin 1"
1018,6900,950,30700,37600,"Sub-basin 1"
1019,200,6,1300,1500,"Sub-basin 1"
1020,12900,901,37500,50400,"Sub-basin 1"
1021,300,16,2500,2800,"Sub-basin 1"
1022,1100,96,5300,6400,"Sub-basin 1"
1023,6200,196,13500,19700,"Sub-basin 1"
1024,100,1,1400,1500,"Sub-basin 1"
1025,100,1,800,900,"Sub-basin 1"
1026,1000,108,6700,7700,"Sub-basin 1"
1027,200,10.0048,2000,2200,"Sub-basin 1"
1028,4700,335.4641,44700,49400,"Sub-basin 1"
1029,400,7.0094,2300,2700,"Sub-basin 1"
1030,300,20,1900,2200,"Sub-basin 1"
1031,1500,200,10900,12400,"Sub-basin 1"
1032,300,13.0043,3700,4000,"Sub-basin 1"
1033,11300,1651.4705,28300,39600,"Sub-basin 1"
1034,600,58,4100,4700,"Sub-basin 1"
1035,400,16,4000,4400,"Sub-basin 1"
1036,14400,831,23700,38100,"Sub-basin 1"
1037,1000,352,4100,5100,"Sub-basin 1"
1038,900,50.073,7300,8200,"Sub-basin 1"
1039,400,53,1300,1700,"Sub-basin 1"
1040,100,1,0,100,"Sub-basin 1"
1041,500,53,3100,3600,"Sub-basin 1"
1042,7300,2397,16000,23300,"Sub-basin 1"
1043,400,22,2400,2800,"Sub-basin 1"
1044,600,67,6600,7200,"Sub-basin 1"
1045,1900,118.1219,13100,15000,"Sub-basin 1"
1046,1500,326,5700,7200,"Sub-basin 1"
1047,100,2,900,1000,"Sub-basin 1"
1048,30300,3992,76000,106300,"Sub-basin 1"
1049,300,12,2400,2700,"Sub-basin 1"
1050,200,8,2600,2800,"Sub-basin 1"
1051,400,86,3400,3800,"Sub-basin 1"
1052,100,2,1600,1700,"Sub-basin 1"
1053,100,1,1100,1200,"Sub-basin 1"
1054,1000,159,5000,6000,"Sub-basin 1"
1055,700,67,2800,3500,"Sub-basin 1"
1056,100,2,1200,1300,"Sub-basin 1"
1057,46800,4402.0014,122600,169400,"Sub-basin 1"
1058,100,5,1300,1400,"Sub-basin 1"
1059,1200,93,5700,6900,"Sub-basin 1"
1060,5800,1243,13200,19000,"Sub-basin 1"
1061,600,73,2500,3100,"Sub-basin 1"
1062,500,18,3700,4200,"Sub-basin 1"
1063,100,1,1000,1100,"Sub-basin 1"
1064,9200,1897,16200,25400,"Sub-basin 1"
1065,800,89,4100,4900,"Sub-basin 1"
1066,2200,137.0995,19900,22100,"Sub-basin 1"
1067,100,2,1000,1100,"Sub-basin 1"
1068,400,9,2700,3100,"Sub-basin 1"
1069,200,6,1100,1300,"Sub-basin 1"
1070,600,14,8500,9100,"Sub-basin 1"
1071,1600,248,4200,5800,"Sub-basin 1"
1072,3500,291,18400,21900,"Sub-basin 1"
1073,100,1,1300,1400,"Sub-basin 1"
1074,300,10.0076,5400,5700,"Sub-basin 1"
1075,1000,104,6200,7200,"Sub-basin 1"
1076,1100,107,5500,6600,"Sub-basin 1"
1077,600,23,600,1200,"Sub-basin 1"
1078,700,120,2300,3000,"Sub-basin 1"
1079,7000,1316,12600,19600,"Sub-basin 1"
1080,300,5.0024,1400,1700,"Sub-basin 1"
1081,4900,2172,7500,12400,"Sub-basin 1"
1082,400,50,1300,1700,"Sub-basin 1"
1083,500,36.0164,6900,7400,"Sub-basin 1"
1084,1300,417,5800,7100,"Sub-basin 1"
1085,900,54,6500,7400,"Sub-basin 1"
1086,600,87,4100,4700,"Sub-basin 1"
1087,400,23,2900,3300,"Sub-basin 1"
1088,700,38,1400,2100,"Sub-basin 1"
1089,3200,1238,8800,12000,"Sub-basin 1"
1090,200,3,1300,1500,"Sub-basin 1"
1091,2700,546,9600,12300,"Sub-basin 1"
1092,2200,992,6800,9000,"Sub-basin 1"
1093,2600,480,5500,8100,"Sub-basin 1"
1094,400,9,4200,4600,"Sub-basin 1"
1095,100,3,1200,1300,"Sub-basin 1"
1096,100,1.0003,1100,1200,"Sub-basin 1"
1097,100,1,300,400,"Sub-basin 1"
1098,76100,6583.4925,92500,168600,"Sub-basin 1"
1099,100,1,1500,1600,"Sub-basin 1"
1100,1300,86,4300,5600,"Sub-basin 1"
1101,200,7,1100,1300,"Sub-basin 1"
1102,1000,39.0616,11100,12100,"Sub-basin 1"
1103,1600,361,4300,5900,"Sub-basin 1"
1104,1500,392,4100,5600,"Sub-basin 1"
1105,2800,224,5500,8300,"Sub-basin 1"
1106,1200,234,4200,5400,"Sub-basin 1"
1107,500,99,5000,5500,"Sub-basin 1"
1108,2100,147,10400,12500,"Sub-basin 1"
1109,700,102,8600,9300,"Sub-basin 1"
1110,600,32,4000,4600,"Sub-basin 1"
1111,500,26,4600,5100,"Sub-basin 1"
1112,600,35,3500,4100,"Sub-basin 1"
1113,300,14,2600,2900,"Sub-basin 1"
1114,100,10,1300,1400,"Sub-basin 1"
1115,1400,58,8800,10200,"Sub-basin 1"
1116,3700,826,19600,23300,"Sub-basin 1"
1117,1600,175,14900,16500,"Sub-basin 1"
1118,400,20,2700,3100,"Sub-basin 1"
1119,100,6,1800,1900,"Sub-basin 1"
1120,4200,150,15700,19900,"Sub-basin 1"
1121,200,33,1200,1400,"Sub-basin 1"
1122,1000,35,3600,4600,"Sub-basin 1"
1123,100,6,1700,1800,"Sub-basin 1"
1124,2700,885,11100,13800,"Sub-basin 1"
1125,18400,995,48700,67100,"Sub-basin 1"
1126,200,10,0,200,"Sub-basin 1"
1127,100,7,900,1000,"Sub-basin 1"
1128,5700,619,9300,15000,"Sub-basin 1"
1129,1700,176,5300,7000,"Sub-basin 1"
1130,100,4,1100,1200,"Sub-basin 1"
1131,6800,2046,14800,21600,"Sub-basin 1"
1132,2300,221,9500,11800,"Sub-basin 1"
1133,200,12,2100,2300,"Sub-basin 1"
1134,400,47,3100,3500,"Sub-basin 1"
1135,100,1,1500,1600,"Sub-basin 1"
1136,100,4.0031,900,1000,"Sub-basin 1"
1137,1300,44.0769,12900,14200,"Sub-basin 1"
1138,800,50,7400,8200,"Sub-basin 1"
1139,1800,126,13700,15500,"Sub-basin 1"
1140,400,15,5700,6100,"Sub-basin 1"
1141,200,4,1300,1500,"Sub-basin 1"
1142,5200,862,16900,22100,"Sub-basin 1"
1143,1800,126,10500,12300,"Sub-basin 1"
1144,1300,211,3500,4800,"Sub-basin 1"
1145,800,112,5800,6600,"Sub-basin 1"
1146,100,2,800,900,"Sub-basin 1"
1147,200,10,1400,1600,"Sub-basin 1"
1148,100,10,1100,1200,"Sub-basin 1"
1149,17000,1794,33400,50400,"Sub-basin 1"
1150,6600,4816.7792,11200,17800,"Sub-basin 1"
1151,100,3,1200,1300,"Sub-basin 1"
1152,1300,341,8800,10100,"Sub-basin 1"
1153,4100,359,18300,22400,"Sub-basin 1"
1154,100,1.0072,1500,1600,"Sub-basin 1"
1155,500,105,3600,4100,"Sub-basin 1"
1156,300,11,400,700,"Sub-basin 1"
1157,900,117,2800,3700,"Sub-basin 1"
1158,100,6,1700,1800,"Sub-basin 1"
1159,2300,195.0575,15300,17600,"Sub-basin 1"
1160,2200,481,6500,8700,"Sub-basin 1"
1161,500,45,6200,6700,"Sub-basin 1"
1162,600,78,2100,2700,"Sub-basin 1"
1163,200,3,1800,2000,"Sub-basin 1"
1164,500,15,3200,3700,"Sub-basin 1"
1165,100,1.0072,1000,1100,"Sub-basin 1"
1166,300,32,1200,1500,"Sub-basin 1"
1167,1800,264,4700,6500,"Sub-basin 1"
1168,1200,240,4900,6100,"Sub-basin 1"
1169,800,128,2500,3300,"Sub-basin 1"
1170,500,47,5100,5600,"Sub-basin 1"
1171,200,8,1000,1200,"Sub-basin 1"
1172,400,4,3800,4200,"Sub-basin 1"
1173,300,21.0115,3500,3800,"Sub-basin 1"
1174,700,53,5000,5700,"Sub-basin 1"
1175,800,129,4700,5500,"Sub-basin 1"
1176,2200,183,8100,10300,"Sub-basin 1"
1177,1400,123,6500,7900,"Sub-basin 1"
1178,10100,649,32500,42600,"Sub-basin 1"
1179,1400,60,5600,7000,"Sub-basin 1"
1180,400,15,4300,4700,"Sub-basin 1"
1181,1900,112,8400,10300,"Sub-basin 1"
1182,2600,371.2409,28200,30800,"Sub-basin 1"
1183,400,33,4500,4900,"Sub-basin 1"
1184,5500,1349,8100,13600,"Sub-basin 1"
1185,100,2,2100,2200,"Sub-basin 1"
1186,100,2,1200,1300,"Sub-basin 1"
1187,100,1,2100,2200,"Sub-basin 1"
1188,200,6,600,800,"Sub-basin 1"
1189,1000,142,6400,7400,"Sub-basin 1"
1190,200,2,700,900,"Sub-basin 1"
1191,100,2,1000,1100,"Sub-basin 1"
1192,600,40,3700,4300,"Sub-basin 1"
1193,100,1,900,1000,"Sub-basin 1"
1194,2300,238,10600,12900,"Sub-basin 1"
1195,700,71,5900,6600,"Sub-basin 1"
1196,700,20,4500,5200,"Sub-basin 1"
1197,1000,100,8600,9600,"Sub-basin 1"
1198,69800,6203.2049,168800,238600,"Sub-basin 1"
1199,400,32,4100,4500,"Sub-basin 1"
1200,100,1,3100,3200,"Sub-basin 1"
1201,300,15,3500,3800,"Sub-basin 1"
1202,100,7,1000,1100,"Sub-basin 1"
1203,200,13,700,900,"Sub-basin 1"
1204,800,54,5200,6000,"Sub-basin 1"
1205,300,11,3300,3600,"Sub-basin 1"
1206,100,1,900,1000,"Sub-basin 1"
1207,200,6,1500,1700,"Sub-basin 1"
1208,200,18,1700,1900,"Sub-basin 1"
1209,1600,224,2800,4400,"Sub-basin 1"
1210,2000,78,15100,17100,"Sub-basin 1"
1211,16800,1118.17,72800,89600,"Sub-basin 1"
1212,200,3,1100,1300,"Sub-basin 1"
1213,100,5,600,700,"Sub-basin 1"
1214,100,1,900,1000,"Sub-basin 1"
1215,600,186,8200,8800,"Sub-basin 1"
1216,1100,193,4800,5900,"Sub-basin 1"
1217,400,22,2400,2800,"Sub-basin 1"
1218,400,70,900,1300,"Sub-basin 1"
1219,100,3,1300,1400,"Sub-basin 1"
1220,300,7,3100,3400,"Sub-basin 1"
1221,100,2,300,400,"Sub-basin 1"
1222,6900,3836,10000,16900,"Sub-basin 1"
1223,600,38,4200,4800,"Sub-basin 1"
1224,200,4,1300,1500,"Sub-basin 1"
1225,1100,95,4100,5200,"Sub-basin 1"
1226,100,1,900,1000,"Sub-basin 1"
1227,1400,62,9600,11000,"Sub-basin 1"
1228,600,28,2900,3500,"Sub-basin 1"
1229,100,2,900,1000,"Sub-basin 1"
1230,5700,2712,11600,17300,"Sub-basin 1"
1231,5800,644,15200,21000,"Sub-basin 1"
1232,1300,242,2500,3800,"Sub-basin 1"
1233,200,5,2500,2700,"Sub-basin 1"
1234,100,1,1100,1200,"Sub-basin 1"
1235,200,8.0079,1800,2000,"Sub-basin 1"
1236,20800,4333.7824,64600,85400,"Sub-basin 1"
1237,700,66,3600,4300,"Sub-basin 1"
1238,100,2,100,200,"Sub-basin 1"
1239,1500,275,7100,8600,"Sub-basin 1"
1240,11200,726,17000,28200,"Sub-basin 1"
1241,500,9,3100,3600,"Sub-basin 1"
1242,100,1,400,500,"Sub-basin 1"
1243,500,96,2700,3200,"Sub-basin 1"
1244,7200,1068,12500,19700,"Sub-basin 1"
1245,3600,658,8100,11700,"Sub-basin 1"
1246,100,4,1000,1100,"Sub-basin 1"
1247,3500,194,18000,21500,"Sub-basin 1"
1248,100,3,1100,1200,"Sub-basin 1"
1249,2900,191,15700,18600,"Sub-basin 1"
1250,100,1,200,300,"Sub-basin 1"
1251,300,9,1400,1700,"Sub-basin 1"
1252,100,1,400,500,"Sub-basin 1"
1253,100,4,1800,1900,"Sub-basin 1"
1254,100,5,1600,1700,"Sub-basin 1"
1255,700,43,1600,2300,"Sub-basin 1"
1256,600,65,2900,3500,"Sub-basin 1"
1257,1800,180,3600,5400,"Sub-basin 1"
1258,100,1,800,900,"Sub-basin 1"
1259,600,19,4200,4800,"Sub-basin 1"
1260,700,37,2600,3300,"Sub-basin 1"
1261,800,42,3800,4600,"Sub-basin 1"
1262,500,35,3300,3800,"Sub-basin 1"
1263,1100,54,6700,7800,"Sub-basin 1"
1264,30400,3400.9143,49100,79500,"Sub-basin 1"
1265,100,1,1600,1700,"Sub-basin 1"
1266,300,7,1900,2200,"Sub-basin 1"
1267,600,110,1300,1900,"Sub-basin 1"
1268,100,1,2200,2300,"Sub-basin 1"
1269,100,4,800,900,"Sub-basin 1"
1270,200,11,2700,2900,"Sub-basin 1"
1271,900,51,7300,8200,"Sub-basin 1"
1272,400,38,1400,1800,"Sub-basin 1"
1273,5400,1330,13700,19100,"Sub-basin 1"
1274,100,4,2000,2100,"Sub-basin 1"
1275,1000,48,11900,12900,"Sub-basin 1"
1276,100,3,1400,1500,"Sub-basin 1"
1277,100,1,1400,1500,"Sub-basin 1"
1278,500,14,5300,5800,"Sub-basin 1"
1279,100,4,800,900,"Sub-basin 1"
1280,25200,1353,49800,75000,"Sub-basin 1"
1281,2700,343,15200,17900,"Sub-basin 1"
1282,600,31,4300,4900,"Sub-basin 1"
1283,2000,185,7800,9800,"Sub-basin 1"
1284,100,3,700,800,"Sub-basin 1"
1285,200,4,3300,3500,"Sub-basin 1"
1286,100,1,1800,1900,"Sub-basin 1"
1287,100,1,400,500,"Sub-basin 1"
1288,19900,2817.17,31700,51600,"Sub-basin 1"
1289,100,1,1100,1200,"Sub-basin 1"
1290,800,24,10800,11600,"Sub-basin 1"
1291,2600,116.66,21900,24500,"Sub-basin 1"
1292,300,19,2600,2900,"Sub-basin 1"
1293,1000,114.067,2500,3500,"Sub-basin 1"
1294,6700,151,12000,18700,"Sub-basin 1"
1295,600,86,2800,3400,"Sub-basin 1"
1296,400,17.17,4000,4400,"Sub-basin 1"
1297,100,2,700,800,"Sub-basin 1"
1298,400,62,2500,2900,"Sub-basin 1"
1299,300,6,4800,5100,"Sub-basin 1"
1300,500,45,3400,3900,"Sub-basin 1"
1301,200,9,1400,1600,"Sub-basin 1"
1302,900,32,9400,10300,"Sub-basin 1"
1303,100,1.0002,500,600,"Sub-basin 1"
1304,1100,174,4300,5400,"Sub-basin 1"
1305,300,22,1700,2000,"Sub-basin 1"
1306,39000,10433,41300,80300,"Sub-basin 1"
1307,700,83,5700,6400,"Sub-basin 1"
1308,100,2,1100,1200,"Sub-basin 1"
1309,500,14,4900,5400,"Sub-basin 1"
1310,200,4,2200,2400,"Sub-basin 1"
1311,4600,1770,10100,14700,"Sub-basin 1"
1312,100,2,1600,1700,"Sub-basin 1"
1313,100,1,200,300,"Sub-basin 1"
1314,100,1,900,1000,"Sub-basin 1"
1315,100,2,600,700,"Sub-basin 1"
1316,400,28,1600,2000,"Sub-basin 1"
1317,800,64,2600,3400,"Sub-basin 1"
1318,11500,2287,12900,24400,"Sub-basin 1"
1319,600,26,2400,3000,"Sub-basin 1"
1320,100,4,2400,2500,"Sub-basin 1"
1321,200,6,4300,4500,"Sub-basin 1"
1322,100,8.0003,1100,1200,"Sub-basin 1"
1323,100,5,1600,1700,"Sub-basin 1"
1324,200,10,2200,2400,"Sub-basin 1"
1325,2900,120,17900,20800,"Sub-basin 1"
1326,400,44,3700,4100,"Sub-basin 1"
1327,400,10,4400,4800,"Sub-basin 1"
1328,1800,116,11600,13400,"Sub-basin 1"
1329,700,69,2300,3000,"Sub-basin 1"
1330,2300,503,5400,7700,"Sub-basin 1"
1331,900,18,4700,5600,"Sub-basin 1"
1332,300,10,1800,2100,"Sub-basin 1"
1333,300,6,1800,2100,"Sub-basin 1"
1334,400,21,1900,2300,"Sub-basin 1"
1335,1500,107,9600,11100,"Sub-basin 1"
1336,1400,82,7100,8500,"Sub-basin 1"
1337,1000,68,7700,8700,"Sub-basin 1"
1338,100,1,1400,1500,"Sub-basin 1"
1339,1100,281,5200,6300,"Sub-basin 1"
1340,100,4,1000,1100,"Sub-basin 1"
1341,1700,368,5500,7200,"Sub-basin 1"
1342,1800,68,12600,14400,"Sub-basin 1"
1343,100,1,1400,1500,"Sub-basin 1"
1344,100,9,1000,1100,"Sub-basin 1"
1345,6200,162,16700,22900,"Sub-basin 1"
1346,200,5,900,1100,"Sub-basin 1"
1347,100,3,700,800,"Sub-basin 1"
1348,11600,1133,22000,33600,"Sub-basin 1"
1349,1700,327,4600,6300,"Sub-basin 1"
1350,100,3,1400,1500,"Sub-basin 1"
1351,200,7,2900,3100,"Sub-basin 1"
1352,100,1,1500,1600,"Sub-basin 1"
1353,2100,202,11700,13800,"Sub-basin 1"
1354,100,1,400,500,"Sub-basin 1"
1355,100,3,1300,1400,"Sub-basin 1"
1356,500,9,3300,3800,"Sub-basin 1"
1357,100,3.0009,1600,1700,"Sub-basin 1"
1358,200,20,1300,1500,"Sub-basin 1"
1359,300,6,900,1200,"Sub-basin 1"
1360,100,5,1600,1700,"Sub-basin 1"
1361,100,1,1900,2000,"Sub-basin 1"
1362,31200,6927.5873,34000,65200,"Sub-basin 1"
1363,55100,14664.0134,39800,94900,"Sub-basin 1"
1364,9600,2394,15000,24600,"Sub-basin 1"
1365,1100,252,1900,3000,"Sub-basin 1"
1366,4900,182.208,26100,31000,"Sub-basin 1"
1367,900,29.0448,8400,9300,"Sub-basin 1"
1368,2700,134,17700,20400,"Sub-basin 1"
1369,7500,699,29100,36600,"Sub-basin 1"
1370,1500,56,20300,21800,"Sub-basin 1"
1371,500,30,5700,6200,"Sub-basin 1"
1372,900,42,5200,6100,"Sub-basin 1"
1373,200,5,3100,3300,"Sub-basin 1"
1374,400,45,1800,2200,"Sub-basin 1"
1375,5200,250,9200,14400,"Sub-basin 1"
1376,600,102,1600,2200,"Sub-basin 1"
1377,100,1,700,800,"Sub-basin 1"
1378,1700,70,14000,15700,"Sub-basin 1"
1379,600,42,3400,4000,"Sub-basin 1"
1380,6300,719,10400,16700,"Sub-basin 1"
1381,2200,123.0936,11800,14000,"Sub-basin 1"
1382,1100,55,7700,8800,"Sub-basin 1"
1383,100,2,1100,1200,"Sub-basin 1"
1384,100,1,800,900,"Sub-basin 1"
1385,700,16,5700,6400,"Sub-basin 1"
1386,100,1,1600,1700,"Sub-basin 1"
1387,1300,116,9700,11000,"Sub-basin 1"
1388,19400,1735.3519,61100,80500,"Sub-basin 1"
1389,8900,2037,13900,22800,"Sub-basin 1"
1390,2500,144,18900,21400,"Sub-basin 1"
1391,100,2,2300,2400,"Sub-basin 1"
1392,100,8,700,800,"Sub-basin 1"
1393,14500,4015,24700,39200,"Sub-basin 1"
1394,300,11,1800,2100,"Sub-basin 1"
1395,200,8.002,1600,1800,"Sub-basin 1"
1396,8500,4387,6700,15200,"Sub-basin 1"
1397,100,1.0042,1200,1300,"Sub-basin 1"
1398,1200,105,5400,6600,"Sub-basin 1"
1399,700,47,2800,3500,"Sub-basin 1"
1400,400,16,3700,4100,"Sub-basin 1"
1401,200,30,1200,1400,"Sub-basin 1"
1402,500,34,2400,2900,"Sub-basin 1"
1403,800,15,3300,4100,"Sub-basin 1"
1404,2100,247,9900,12000,"Sub-basin 1"
1405,300,7.0138,3200,3500,"Sub-basin 1"
1406,500,47,2000,2500,"Sub-basin 1"
1407,1800,142.2124,14700,16500,"Sub-basin 1"
1408,700,145,2000,2700,"Sub-basin 1"
1409,1600,141,8400,10000,"Sub-basin 1"
1410,100,1,900,1000,"Sub-basin 1"
1411,200,7,3300,3500,"Sub-basin 1"
1412,900,218,2700,3600,"Sub-basin 1"
1413,9300,1484.4864,13400,22700,"Sub-basin 1"
1414,100,1,300,400,"Sub-basin 1"
1415,2000,82.069,9900,11900,"Sub-basin 1"
1416,1500,260,3900,5400,"Sub-basin 1"
1417,400,21,3800,4200,"Sub-basin 1"
1418,100,1,1400,1500,"Sub-basin 1"
1419,300,8,1300,1600,"Sub-basin 1"
1420,6800,795,16700,23500,"Sub-basin 1"
1421,1800,159.0917,9100,10900,"Sub-basin 1"
1422,1500,274,5400,6900,"Sub-basin 1"
1423,300,6,3800,4100,"Sub-basin 1"
1424,100,3,1200,1300,"Sub-basin 1"
1425,600,34,2100,2700,"Sub-basin 1"
1426,100,2,2000,2100,"Sub-basin 1"
1427,200,3,2200,2400,"Sub-basin 1"
1428,100,1,1000,1100,"Sub-basin 1"
1429,300,6,3800,4100,"Sub-basin 1"
1430,200,12,2300,2500,"Sub-basin 1"
1431,13500,2317,24200,37700,"Sub-basin 1"
1432,15700,1086,33600,49300,"Sub-basin 1"
1433,900,17,5500,6400,"Sub-basin 1"
1434,400,15,3600,4000,"Sub-basin 1"
1435,200,6,2200,2400,"Sub-basin 1"
1436,400,32,1700,2100,"Sub-basin 1"
1437,4000,338,9400,13400,"Sub-basin 1"
1438,5200,345,26500,31700,"Sub-basin 1"
1439,100,2,1300,1400,"Sub-basin 1"
1440,400,47.0099,1700,2100,"Sub-basin 1"
1441,100,1,700,800,"Sub-basin 1"
1442,300,18,1800,2100,"Sub-basin 1"
1443,600,31,3500,4100,"Sub-basin 1"
1444,1500,91,3500,5000,"Sub-basin 1"
1445,2100,172,10800,12900,"Sub-basin 1"
1446,1700,188,3400,5100,"Sub-basin 1"
1447,1200,137,5800,7000,"Sub-basin 1"
1448,100,2,2100,2200,"Sub-basin 1"
1449,400,27.0096,2000,2400,"Sub-basin 1"
1450,600,43,2100,2700,"Sub-basin 1"
1451,400,33,1200,1600,"Sub-basin 1"
1452,100,1,1600,1700,"Sub-basin 1"
1453,100,1,1200,1300,"Sub-basin 1"
1454,200,6,1200,1400,"Sub-basin 1"
1455,1400,78,4900,6300,"Sub-basin 1"
1456,500,23,2000,2500,"Sub-basin 1"
1457,400,18,2700,3100,"Sub-basin 1"
1458,100,6,900,1000,"Sub-basin 1"
1459,100,2,200,300,"Sub-basin 1"
1460,5000,284.34,10600,15600,"Sub-basin 1"
1461,100,3,1000,1100,"Sub-basin 1"
1462,400,18.0131,2900,3300,"Sub-basin 1"
1463,500,75,3400,3900,"Sub-basin 1"
1464,5000,1757,10600,15600,"Sub-basin 1"
1465,3200,171,17000,20200,"Sub-basin 1"
1466,2000,543,3900,5900,"Sub-basin 1"
1467,2600,313,9200,11800,"Sub-basin 1"
1468,300,18,4500,4800,"Sub-basin 1"
1469,3300,247,13300,16600,"Sub-basin 1"
1470,100,6,2100,2200,"Sub-basin 1"
1471,500,8,4300,4800,"Sub-basin 1"
1472,16200,4670,18100,34300,"Sub-basin 1"
1473,400,8,3600,4000,"Sub-basin 1"
1474,200,11,1000,1200,"Sub-basin 1"
1475,300,16.0176,4900,5200,"Sub-basin 1"
1476,100,3,1100,1200,"Sub-basin 1"
1477,500,12,7500,8000,"Sub-basin 1"
1478,1100,23,5000,6100,"Sub-basin 1"
1479,200,6,3100,3300,"Sub-basin 1"
1480,200,15,2900,3100,"Sub-basin 1"
1481,1400,281,2700,4100,"Sub-basin 1"
1482,2600,391,5400,8000,"Sub-basin 1"
1483,300,15,1800,2100,"Sub-basin 1"
1484,100,1,200,300,"Sub-basin 1"
1485,300,5,2600,2900,"Sub-basin 1"
1486,400,18,2000,2400,"Sub-basin 1"
1487,200,4.0002,1800,2000,"Sub-basin 1"
1488,100,2.0039,800,900,"Sub-basin 1"
1489,5000,461.7333,13700,18700,"Sub-basin 1"
1490,2300,653,5600,7900,"Sub-basin 1"
1491,300,5,2400,2700,"Sub-basin 1"
1492,900,34,6500,7400,"Sub-basin 1"
1493,100,4,1400,1500,"Sub-basin 1"
1494,300,3,2200,2500,"Sub-basin 1"
1495,100,1,1100,1200,"Sub-basin 1"
1496,5400,706,28300,33700,"Sub-basin 1"
1497,3000,160,11300,14300,"Sub-basin 1"
1498,900,25,4700,5600,"Sub-basin 1"
1499,100,6,100,200,"Sub-basin 1"
1500,300,6,300,600,"Sub-basin 1"
1501,28600,1850,22300,50900,"Sub-basin 1"
1502,100,1,200,300,"Sub-basin 1"
1503,300,18,1900,2200,"Sub-basin 1"
1504,800,62,5700,6500,"Sub-basin 1"
1505,800,122,2800,3600,"Sub-basin 1"
1506,500,23,4000,4500,"Sub-basin 1"
1507,1700,398,4400,6100,"Sub-basin 1"
1508,400,15,4900,5300,"Sub-basin 1"
1509,200,6,1300,1500,"Sub-basin 1"
1510,800,32.0584,2400,3200,"Sub-basin 1"
1511,1000,78,4900,5900,"Sub-basin 1"
1512,1500,50.0554,3600,5100,"Sub-basin 1"
1513,100,7,2000,2100,"Sub-basin 1"
1514,400,17,1000,1400,"Sub-basin 1"
1515,3200,193,9900,13100,"Sub-basin 1"
1516,300,6,4600,4900,"Sub-basin 1"
1517,1300,92,5600,6900,"Sub-basin 1"
1518,300,10,3600,3900,"Sub-basin 1"
1519,100,4,1700,1800,"Sub-basin 1"
1520,200,6,1100,1300,"Sub-basin 1"
1521,100,1,400,500,"Sub-basin 1"
1522,100,4,600,700,"Sub-basin 1"
1523,2000,346,7600,9600,"Sub-basin 1"
1524,200,15,1700,1900,"Sub-basin 1"
1525,100,1,500,600,"Sub-basin 1"
1526,200,6,1000,1200,"Sub-basin 1"
1527,300,11,900,1200,"Sub-basin 1"
1528,200,12.0074,1100,1300,"Sub-basin 1"
1529,200,4,4200,4400,"Sub-basin 1"
1530,900,99,2100,3000,"Sub-basin 1"
1531,300,5,2200,2500,"Sub-basin 1"
1532,200,3,2100,2300,"Sub-basin 1"
1533,1300,34,7100,8400,"Sub-basin 1"
1534,200,6,1100,1300,"Sub-basin 1"
1535,200,6,800,1000,"Sub-basin 1"
1536,100,1,400,500,"Sub-basin 1"
1537,200,4,2200,2400,"Sub-basin 1"
1538,2500,125,10200,12700,"Sub-basin 1"
1539,100,2,1600,1700,"Sub-basin 1"
1540,4200,696,12500,16700,"Sub-basin 1"
1541,100,5.0028,400,500,"Sub-basin 1"
1542,400,55.0274,2800,3200,"Sub-basin 1"
1543,100,1.0039,200,300,"Sub-basin 1"
1544,4400,629,9300,13700,"Sub-basin 1"
1545,1300,63,10800,12100,"Sub-basin 1"
1546,100,2,1400,1500,"Sub-basin 1"
1547,600,17,4700,5300,"Sub-basin 1"
1548,300,19,1700,2000,"Sub-basin 1"
1549,100,1,1700,1800,"Sub-basin 1"
1550,100,4,700,800,"Sub-basin 1"
1551,1300,72,4900,6200,"Sub-basin 1"
1552,300,31,2900,3200,"Sub-basin 1"
1553,500,35,3300,3800,"Sub-basin 1"
1554,900,62,5000,5900,"Sub-basin 1"
1555,2400,136,8800,11200,"Sub-basin 1"
1556,2100,309,7800,9900,"Sub-basin 1"
1557,400,8,900,1300,"Sub-basin 1"
1558,200,5,1800,2000,"Sub-basin 1"
1559,100,1,2000,2100,"Sub-basin 1"
1560,1100,213,4400,5500,"Sub-basin 1"
1561,1400,166,7000,8400,"Sub-basin 1"
1562,1400,63,8100,9500,"Sub-basin 1"
1563,200,4,4000,4200,"Sub-basin 1"
1564,6900,247,16400,23300,"Sub-basin 1"
1565,300,16,2500,2800,"Sub-basin 1"
1566,33500,1883,67100,100600,"Sub-basin 1"
1567,100,3,1400,1500,"Sub-basin 1"
1568,100,1,200,300,"Sub-basin 1"
1569,200,8,800,1000,"Sub-basin 1"
1570,100,5,800,900,"Sub-basin 1"
1571,500,45,2200,2700,"Sub-basin 1"
1572,300,13,1200,1500,"Sub-basin 1"
1573,3600,365,11700,15300,"Sub-basin 1"
1574,4300,916,6800,11100,"Sub-basin 1"
1575,2300,559,10400,12700,"Sub-basin 1"
1576,100,4,1500,1600,"Sub-basin 1"
1577,500,42,1900,2400,"Sub-basin 1"
1578,15600,5081,30000,45600,"Sub-basin 1"
1579,11100,2196,15400,26500,"Sub-basin 1"
1580,700,15,2900,3600,"Sub-basin 1"
1581,400,8,4000,4400,"Sub-basin 1"
1582,33100,9330.67,52000,85100,"Sub-basin 1"
1583,200,10,0,200,"Sub-basin 1"
1584,600,71,1900,2500,"Sub-basin 1"
1585,200,6,2100,2300,"Sub-basin 1"
1586,100,1,2000,2100,"Sub-basin 1"
1587,300,3,3500,3800,"Sub-basin 1"
1588,100,3,700,800,"Sub-basin 1"
1589,4800,783,8100,12900,"Sub-basin 1"
1590,3900,135,15100,19000,"Sub-basin 1"
1591,200,7,1100,1300,"Sub-basin 1"
1592,200,9,700,900,"Sub-basin 1"
1593,100,5,700,800,"Sub-basin 1"
1594,1000,116,6200,7200,"Sub-basin 1"
1595,800,52,5600,6400,"Sub-basin 1"
1596,400,23,3300,3700,"Sub-basin 1"
1597,100,1,1400,1500,"Sub-basin 1"
1598,200,24,2000,2200,"Sub-basin 1"
1599,100,1,1000,1100,"Sub-basin 1"
1600,200,8,1700,1900,"Sub-basin 1"
1601,100,1,1200,1300,"Sub-basin 1"
1602,200,7,0,200,"Sub-basin 1"
1603,200,4,1000,1200,"Sub-basin 1"
1604,300,8,2400,2700,"Sub-basin 1"
1605,2900,179,6600,9500,"Sub-basin 1"
1606,800,60,2000,2800,"Sub-basin 1"
1607,100,1,300,400,"Sub-basin 1"
1608,38800,5062,62400,101200,"Sub-basin 1"
1609,100,16,700,800,"Sub-basin 1"
1610,100,1,800,900,"Sub-basin 1"
1611,500,20,3300,3800,"Sub-basin 1"
1612,100,3,400,500,"Sub-basin 1"
1613,11100,1382,16400,27500,"Sub-basin 1"
1614,100,3,300,400,"Sub-basin 1"
1615,1300,81,12100,13400,"Sub-basin 1"
1616,200,5,1800,2000,"Sub-basin 1"
1617,100,1,700,800,"Sub-basin 1"
1618,800,25,2000,2800,"Sub-basin 1"
1619,600,16,2400,3000,"Sub-basin 1"
1620,100,1,600,700,"Sub-basin 1"
1621,400,8,1300,1700,"Sub-basin 1"
1622,300,3,2300,2600,"Sub-basin 1"
1623,400,7,4200,4600,"Sub-basin 1"
1624,300,31,3600,3900,"Sub-basin 1"
1625,900,86,7300,8200,"Sub-basin 1"
1626,300,9,1300,1600,"Sub-basin 1"
1627,1900,127,6400,8300,"Sub-basin 1"
1628,100,2,200,300,"Sub-basin 1"
1629,5500,523,15400,20900,"Sub-basin 1"
1630,200,4,3600,3800,"Sub-basin 1"
1631,300,7,1800,2100,"Sub-basin 1"
1632,200,22,3800,4000,"Sub-basin 1"
1633,300,10,2600,2900,"Sub-basin 1"
1634,200,6,1900,2100,"Sub-basin 1"
1635,6400,1232,26500,32900,"Sub-basin 1"
1636,1200,97,5900,7100,"Sub-basin 1"
1637,100,6,2300,2400,"Sub-basin 1"
1638,200,9,1900,2100,"Sub-basin 1"
1639,100,1,1000,1100,"Sub-basin 1"
1640,500,5,4100,4600,"Sub-basin 1"
1641,100,4,2700,2800,"Sub-basin 1"
1642,200,20,1900,2100,"Sub-basin 1"
1643,300,18,2900,3200,"Sub-basin 1"
1644,100,2,400,500,"Sub-basin 1"
1645,200,3,1800,2000,"Sub-basin 1"
1646,300,13,3500,3800,"Sub-basin 1"
1647,100,1,1100,1200,"Sub-basin 1"
1648,2500,185,11200,13700,"Sub-basin 1"
1649,1000,37,9100,10100,"Sub-basin 1"
1650,300,7,1000,1300,"Sub-basin 1"
1651,200,5,1700,1900,"Sub-basin 1"
1652,76100,10731,123600,199700,"Sub-basin 1"
1653,200,4,2600,2800,"Sub-basin 1"
1654,400,15,1700,2100,"Sub-basin 1"
1655,10200,851,36900,47100,"Sub-basin 1"
1656,2300,60,8900,11200,"Sub-basin 1"
1657,100,1,500,600,"Sub-basin 1"
1658,1400,84,6800,8200,"Sub-basin 1"
1659,100,2,900,1000,"Sub-basin 1"
1660,900,34,7100,8000,"Sub-basin 1"
1661,400,8,3800,4200,"Sub-basin 1"
1662,100,1,1300,1400,"Sub-basin 1"
1663,100,1,1000,1100,"Sub-basin 1"
1664,3400,107,13400,16800,"Sub-basin 1"
1665,1300,49,9100,10400,"Sub-basin 1"
1666,400,23,1200,1600,"Sub-basin 1"
1667,100,2,700,800,"Sub-basin 1"
1668,200,2,1700,1900,"Sub-basin 1"
1669,200,7,1000,1200,"Sub-basin 1"
1670,100,1,800,900,"Sub-basin 1"
1671,500,40,1700,2200,"Sub-basin 1"
1672,100,2,800,900,"Sub-basin 1"
1673,16400,2011,23800,40200,"Sub-basin 1"
1674,200,5,1400,1600,"Sub-basin 1"
1675,3400,167,15200,18600,"Sub-basin 1"
1676,200,3,1500,1700,"Sub-basin 1"
1677,400,9,6700,7100,"Sub-basin 1"
1678,700,41,2800,3500,"Sub-basin 1"
1679,200,5,900,1100,"Sub-basin 1"
1680,100,3,700,800,"Sub-basin 1"
1681,800,103,4400,5200,"Sub-basin 1"
1682,100,1,1000,1100,"Sub-basin 1"
1683,300,6,1400,1700,"Sub-basin 1"
1684,2600,277,5900,8500,"Sub-basin 1"
1685,4800,283,26400,31200,"Sub-basin 1"
1686,900,167,3300,4200,"Sub-basin 1"
1687,5800,316,18400,24200,"Sub-basin 1"
1688,100,3,900,1000,"Sub-basin 1"
1689,1000,142,2400,3400,"Sub-basin 1"
1690,2200,199,6400,8600,"Sub-basin 1"
1691,800,33,1800,2600,"Sub-basin 1"
1692,600,45,3300,3900,"Sub-basin 1"
1693,3300,505,15500,18800,"Sub-basin 1"
1694,1500,119,9400,10900,"Sub-basin 1"
1695,100,1,1500,1600,"Sub-basin 1"
1696,48800,2817,167900,216700,"Sub-basin 1"
1697,300,6,2400,2700,"Sub-basin 1"
1698,200,6,900,1100,"Sub-basin 1"
1699,500,25,4600,5100,"Sub-basin 1"
1700,300,13,1700,2000,"Sub-basin 1"
1701,100,1,1100,1200,"Sub-basin 1"
1702,100,2,1100,1200,"Sub-basin 1"
1703,1100,73,10100,11200,"Sub-basin 1"
1704,500,21.0155,4300,4800,"Sub-basin 1"
1705,200,3,3600,3800,"Sub-basin 1"
1706,10800,4723,24500,35300,"Sub-basin 1"
1707,100,6,1900,2000,"Sub-basin 1"
1708,200,16,2800,3000,"Sub-basin 1"
1709,300,6,3100,3400,"Sub-basin 1"
1710,100,1,2200,2300,"Sub-basin 1"
1711,100,3,1200,1300,"Sub-basin 1"
1712,3300,853,6300,9600,"Sub-basin 1"
1713,2700,191,7000,9700,"Sub-basin 1"
1714,100,2,1900,2000,"Sub-basin 1"
1715,100,3,1900,2000,"Sub-basin 1"
1716,100,1,1800,1900,"Sub-basin 1"
1717,5900,597,22400,28300,"Sub-basin 1"
1718,200,5,1500,1700,"Sub-basin 1"
1719,600,24,4100,4700,"Sub-basin 1"
1720,100,12,1400,1500,"Sub-basin 1"
1721,200,21,2400,2600,"Sub-basin 1"
1722,8200,1090,26000,34200,"Sub-basin 1"
1723,700,39,3600,4300,"Sub-basin 1"
1724,32000,1530,45700,77700,"Sub-basin 1"
1725,100,4,1700,1800,"Sub-basin 1"
1726,7400,906.3948,20700,28100,"Sub-basin 1"
1727,200,2,1100,1300,"Sub-basin 1"
1728,1200,67,13800,15000,"Sub-basin 1"
1729,4600,667,7000,11600,"Sub-basin 1"
1730,300,4,2000,2300,"Sub-basin 1"
1731,100,3,700,800,"Sub-basin 1"
1732,100,1,300,400,"Sub-basin 1"
1733,400,17,600,1000,"Sub-basin 1"
1734,1000,51,4800,5800,"Sub-basin 1"
1735,2600,193,10600,13200,"Sub-basin 1"
1736,46100,11606,53400,99500,"Sub-basin 1"
1737,100,4,800,900,"Sub-basin 1"
1738,2800,380,8600,11400,"Sub-basin 1"
1739,6800,692,20700,27500,"Sub-basin 1"
1740,1700,63,8800,10500,"Sub-basin 1"
1741,100,1,2000,2100,"Sub-basin 1"
1742,700,34,6400,7100,"Sub-basin 1"
1743,200,13,1800,2000,"Sub-basin 1"
1744,100,4,2500,2600,"Sub-basin 1"
1745,200,9,1100,1300,"Sub-basin 1"
1746,3400,262,12200,15600,"Sub-basin 1"
1747,500,20,2700,3200,"Sub-basin 1"
1748,6800,526,15700,22500,"Sub-basin 1"
1749,100,1,3200,3300,"Sub-basin 1"
1750,10900,977,27800,38700,"Sub-basin 1"
1751,16200,6039,23400,39600,"Sub-basin 1"
1752,1000,27,2900,3900,"Sub-basin 1"
1753,100,4,600,700,"Sub-basin 1"
1754,5700,298,6500,12200,"Sub-basin 1"
1755,1400,75,7400,8800,"Sub-basin 1"
1756,300,11,3800,4100,"Sub-basin 1"
1757,500,26,1700,2200,"Sub-basin 1"
1758,200,4,1100,1300,"Sub-basin 1"
1759,100,1,2500,2600,"Sub-basin 1"
1760,100,2,1000,1100,"Sub-basin 1"
1761,100,2,600,700,"Sub-basin 1"
1762,200,4,2900,3100,"Sub-basin 1"
1763,22600,3117,17900,40500,"Sub-basin 1"
1764,200,5,3300,3500,"Sub-basin 1"
1765,2400,359,5100,7500,"Sub-basin 1"
1766,400,12,3100,3500,"Sub-basin 1"
1767,1200,87,3600,4800,"Sub-basin 1"
1768,100,1,500,600,"Sub-basin 1"
1769,9800,3238,15800,25600,"Sub-basin 1"
1770,5300,423,12900,18200,"Sub-basin 1"
1771,200,3,1000,1200,"Sub-basin 1"
1772,100,1,700,800,"Sub-basin 1"
1773,300,15,2000,2300,"Sub-basin 1"
1774,100,1,2700,2800,"Sub-basin 1"
1775,2000,58,10800,12800,"Sub-basin 1"
1776,200,3,2500,2700,"Sub-basin 1"
1777,2700,135,14800,17500,"Sub-basin 1"
1778,82000,10519.66,87600,169600,"Sub-basin 1"
1779,3300,270,10900,14200,"Sub-basin 1"
1780,1500,116,9800,11300,"Sub-basin 1"
1781,100,1,2500,2600,"Sub-basin 1"
1782,900,63,2100,3000,"Sub-basin 1"
1783,300,4,5100,5400,"Sub-basin 1"
1784,100,18,400,500,"Sub-basin 1"
1785,2700,851,6800,9500,"Sub-basin 1"
1786,4000,193,22500,26500,"Sub-basin 1"
1787,200,8,2600,2800,"Sub-basin 1"
1788,5800,1200,18700,24500,"Sub-basin 1"
1789,100,1,1500,1600,"Sub-basin 1"
1790,6200,331,16800,23000,"Sub-basin 1"
1791,900,77,4700,5600,"Sub-basin 1"
1792,200,5,1200,1400,"Sub-basin 1"
1793,400,36,4000,4400,"Sub-basin 1"
1794,200,27,1100,1300,"Sub-basin 1"
1795,100,1,2800,2900,"Sub-basin 1"
1796,6800,539,37500,44300,"Sub-basin 1"
1797,100,1,1800,1900,"Sub-basin 1"
1798,100,3,700,800,"Sub-basin 1"
1799,900,106,6200,7100,"Sub-basin 1"
1800,1500,43,5200,6700,"Sub-basin 1"
1801,600,21,4600,5200,"Sub-basin 1"
1802,100,2,1400,1500,"Sub-basin 1"
1803,1600,290,2600,4200,"Sub-basin 1"
1804,1900,254,3500,5400,"Sub-basin 1"
1805,800,52,3500,4300,"Sub-basin 1"
1806,100,1,600,700,"Sub-basin 1"
1807,900,81.0398,8400,9300,"Sub-basin 1"
1808,100,3,2400,2500,"Sub-basin 1"
1809,700,105,2100,2800,"Sub-basin 1"
1810,100,3,800,900,"Sub-basin 1"
1811,100,6,1100,1200,"Sub-basin 1"
1812,200,9,1700,1900,"Sub-basin 1"
1813,200,3,1100,1300,"Sub-basin 1"
1814,1800,91,24600,26400,"Sub-basin 1"
1815,100,2,800,900,"Sub-basin 1"
1816,41600,20220,30400,72000,"Sub-basin 1"
1817,8200,356,27700,35900,"Sub-basin 1"
1818,300,13,800,1100,"Sub-basin 1"
1819,800,23,5400,6200,"Sub-basin 1"
1820,200,3,2400,2600,"Sub-basin 1"
1821,5900,290,18200,24100,"Sub-basin 1"
1822,2400,169,8100,10500,"Sub-basin 1"
1823,2900,477,12100,15000,"Sub-basin 1"
1824,30000,1443,58300,88300,"Sub-basin 1"
1825,300,24,1900,2200,"Sub-basin 1"
1826,100,1,2200,2300,"Sub-basin 1"
1827,2700,211,8200,10900,"Sub-basin 1"
1828,100,1,800,900,"Sub-basin 1"
1829,600,39,3500,4100,"Sub-basin 1"
1830,200,4,4600,4800,"Sub-basin 1"
1831,100,4,1300,1400,"Sub-basin 1"
1832,1300,30,10000,11300,"Sub-basin 1"
1833,500,31,2800,3300,"Sub-basin 1"
1834,700,119,3100,3800,"Sub-basin 1"
1835,300,4,5600,5900,"Sub-basin 1"
1836,400,9,4900,5300,"Sub-basin 1"
1837,1800,185,7200,9000,"Sub-basin 1"
1838,2500,89,15100,17600,"Sub-basin 1"
1839,3100,126,11900,15000,"Sub-basin 1"
1840,3000,196,5400,8400,"Sub-basin 1"
1841,1700,205,3800,5500,"Sub-basin 1"
1842,400,8.17,2900,3300,"Sub-basin 1"
1843,200,10,1800,2000,"Sub-basin 1"
1844,3500,199.3984,35800,39300,"Sub-basin 1"
1845,7900,395,14500,22400,"Sub-basin 1"
1846,200,5,3400,3600,"Sub-basin 1"
1847,1700,111,10300,12000,"Sub-basin 1"
1848,100,2,1300,1400,"Sub-basin 1"
1849,300,12,1400,1700,"Sub-basin 1"
1850,4100,733,10100,14200,"Sub-basin 1"
1851,95900,38145,114100,210000,"Sub-basin 1"
1852,1600,206,5700,7300,"Sub-basin 1"
1853,1700,159,3200,4900,"Sub-basin 1"
1854,300,16,1700,2000,"Sub-basin 1"
1855,400,12,1500,1900,"Sub-basin 1"
1856,100,1,200,300,"Sub-basin 1"
1857,100,2,1100,1200,"Sub-basin 1"
1858,3000,271,15000,18000,"Sub-basin 1"
1859,100,1,1100,1200,"Sub-basin 1"
1860,400,17,7600,8000,"Sub-basin 1"
1861,100,1,1000,1100,"Sub-basin 1"
1862,500,23,5700,6200,"Sub-basin 1"
1863,200,3,1100,1300,"Sub-basin 1"
1864,200,6,2100,2300,"Sub-basin 1"
1865,200,6,2700,2900,"Sub-basin 1"
1866,300,24,1600,1900,"Sub-basin 1"
1867,1000,49.83,10900,11900,"Sub-basin 1"
1868,100,1,1500,1600,"Sub-basin 1"
1869,2000,205,5700,7700,"Sub-basin 1"
1870,2400,499,6100,8500,"Sub-basin 1"
1871,200,8,1100,1300,"Sub-basin 1"
1872,1300,55,3300,4600,"Sub-basin 1"
1873,100,1,1100,1200,"Sub-basin 1"
1874,1100,355,4800,5900,"Sub-basin 1"
1875,200,3,2100,2300,"Sub-basin 1"
1876,5700,1086,13100,18800,"Sub-basin 1"
1877,600,63,4000,4600,"Sub-basin 1"
1878,12800,1142,35700,48500,"Sub-basin 1"
1879,4000,691,23800,27800,"Sub-basin 1"
1880,4900,519,8400,13300,"Sub-basin 1"
1881,600,18,2900,3500,"Sub-basin 1"
1882,400,20,700,1100,"Sub-basin 1"
1883,1900,61,12300,14200,"Sub-basin 1"
1884,16700,1214,41700,58400,"Sub-basin 1"
1885,400,33,2300,2700,"Sub-basin 1"
1886,100,3,800,900,"Sub-basin 1"
1887,100,4,1000,1100,"Sub-basin 1"
1888,100,1,1700,1800,"Sub-basin 1"
1889,300,5,1400,1700,"Sub-basin 1"
1890,200,4,1100,1300,"Sub-basin 1"
1891,112100,9771,132900,245000,"Sub-basin 1"
1892,8300,763,27600,35900,"Sub-basin 1"
1893,700,90,3300,4000,"Sub-basin 1"
1894,500,17,4600,5100,"Sub-basin 1"
1895,500,47,3500,4000,"Sub-basin 1"
1896,1200,28,5300,6500,"Sub-basin 1"
1897,200,10,1700,1900,"Sub-basin 1"
1898,1300,394,4900,6200,"Sub-basin 1"
1899,500,7,4100,4600,"Sub-basin 1"
1900,200,4,2500,2700,"Sub-basin 1"
1901,200,5,4600,4800,"Sub-basin 1"
1902,5000,347,24700,29700,"Sub-basin 1"
1903,4700,644,19900,24600,"Sub-basin 1"
1904,4000,180,20400,24400,"Sub-basin 1"
1905,600,44,2900,3500,"Sub-basin 1"
1906,100,5,1200,1300,"Sub-basin 1"
1907,700,55,3800,4500,"Sub-basin 1"
1908,100,41,900,1000,"Sub-basin 1"
1909,800,19,5500,6300,"Sub-basin 1"
1910,200,7,3400,3600,"Sub-basin 1"
1911,300,7,4100,4400,"Sub-basin 1"
1912,5400,194,25100,30500,"Sub-basin 1"
1913,200,6,2500,2700,"Sub-basin 1"
1914,100,3,1100,1200,"Sub-basin 1"
1915,300,5,4000,4300,"Sub-basin 1"
1916,500,28,800,1300,"Sub-basin 1"
1917,3000,218,11000,14000,"Sub-basin 1"
1918,300,9,3600,3900,"Sub-basin 1"
1919,8800,845.67,20800,29600,"Sub-basin 1"
1920,2500,357,8300,10800,"Sub-basin 1"
1921,100,3,300,400,"Sub-basin 1"
1922,200,5,700,900,"Sub-basin 1"
1923,100,5,1900,2000,"Sub-basin 1"
1924,1200,38,5900,7100,"Sub-basin 1"
1925,1200,38,11700,12900,"Sub-basin 1"
1926,100,5,2200,2300,"Sub-basin 1"
1927,100,1,2200,2300,"Sub-basin 1"
1928,3800,603,20500,24300,"Sub-basin 1"
1929,300,8,2000,2300,"Sub-basin 1"
1930,700,100,3000,3700,"Sub-basin 1"
1931,5800,2408,8400,14200,"Sub-basin 1"
1932,1500,329,5000,6500,"Sub-basin 1"
1933,900,67,1400,2300,"Sub-basin 1"
1934,4600,283,21000,25600,"Sub-basin 1"
1935,100,2,2100,2200,"Sub-basin 1"
1936,200,3,3800,4000,"Sub-basin 1"
1937,100,1,1800,1900,"Sub-basin 1"
1938,57400,2560.17,74000,131400,"Sub-basin 1"
1939,1800,83,6500,8300,"Sub-basin 1"
1940,1300,145,6200,7500,"Sub-basin 1"
1941,2700,357,5900,8600,"Sub-basin 1"
1942,2500,621,5000,7500,"Sub-basin 1"
1943,700,64,1500,2200,"Sub-basin 1"
1944,6600,345.67,20100,26700,"Sub-basin 1"
1945,100,1,500,600,"Sub-basin 1"
1946,100,2,1600,1700,"Sub-basin 1"
1947,8100,766,35200,43300,"Sub-basin 1"
1948,2000,187,10200,12200,"Sub-basin 1"
1949,100,1,500,600,"Sub-basin 1"
1950,100,2,1900,2000,"Sub-basin 1"
1951,800,104,4400,5200,"Sub-basin 1"
1952,800,40,2300,3100,"Sub-basin 1"
1953,100,1,600,700,"Sub-basin 1"
1954,800,134,2000,2800,"Sub-basin 1"
1955,700,140,3500,4200,"Sub-basin 1"
1956,3200,1004,5600,8800,"Sub-basin 1"
1957,500,16,3700,4200,"Sub-basin 1"
1958,100,2,2800,2900,"Sub-basin 1"
1959,100,3,100,200,"Sub-basin 1"
1960,100,2,900,1000,"Sub-basin 1"
1961,5200,341.0439,34400,39600,"Sub-basin 1"
1962,2200,515,8400,10600,"Sub-basin 1"
1963,100,5,1600,1700,"Sub-basin 1"
1964,100,1,700,800,"Sub-basin 1"
1965,500,21,1500,2000,"Sub-basin 1"
1966,2700,481,10100,12800,"Sub-basin 1"
1967,8700,1753.66,16500,25200,"Sub-basin 1"
1968,400,31,1100,1500,"Sub-basin 1"
1969,100,3,3000,3100,"Sub-basin 1"
1970,2200,119,6400,8600,"Sub-basin 1"
1971,100,1,1200,1300,"Sub-basin 1"
1972,700,48,4300,5000,"Sub-basin 1"
1973,2000,75,11800,13800,"Sub-basin 1"
1974,300,30,800,1100,"Sub-basin 1"
1975,1600,322,7400,9000,"Sub-basin 1"
1976,100,3,1400,1500,"Sub-basin 1"
1977,100,1,600,700,"Sub-basin 1"
1978,100,2,1300,1400,"Sub-basin 1"
1979,600,12,2500,3100,"Sub-basin 1"
1980,200,4,3000,3200,"Sub-basin 1"
1981,300,15,3100,3400,"Sub-basin 1"
1982,4900,715,22400,27300,"Sub-basin 1"
1983,10400,1887,16300,26700,"Sub-basin 1"
1984,200,5,1500,1700,"Sub-basin 1"
1985,17700,1458.4587,51600,69300,"Sub-basin 1"
1986,600,41,6300,6900,"Sub-basin 1"
1987,100,3,300,400,"Sub-basin 1"
1988,2400,219,19800,22200,"Sub-basin 1"
1989,1500,31,10600,12100,"Sub-basin 1"
1990,3500,112,12700,16200,"Sub-basin 1"
1991,5100,199.5,27900,33000,"Sub-basin 1"
1992,200,4,1600,1800,"Sub-basin 1"
1993,4800,456,23000,27800,"Sub-basin 1"
1994,500,13,2500,3000,"Sub-basin 1"
1995,400,8,2400,2800,"Sub-basin 1"
1996,900,91,4500,5400,"Sub-basin 1"
1997,100,1,800,900,"Sub-basin 1"
1998,100,2,1600,1700,"Sub-basin 1"
1999,800,63,5900,6700,"Sub-basin 1"
2000,100,0.83,900,1000,"Sub-basin 1"
2001,300,8,5500,5800,"Sub-basin 1"
2002,500,26.67,4400,4900,"Sub-basin 1"
2003,1000,139.5,4700,5700,"Sub-basin 1"
2004,1300,138,11400,12700,"Sub-basin 1"
2005,12800,442,36000,48800,"Sub-basin 1"
2006,100,1,800,900,"Sub-basin 1"
2007,400,14,5400,5800,"Sub-basin 1"
2008,100,4,1900,2000,"Sub-basin 1"
2009,600,22,3900,4500,"Sub-basin 1"
2010,55200,27252.16,54600,109800,"Sub-basin 1"
2011,900,41,9900,10800,"Sub-basin 1"
2012,700,35,10900,11600,"Sub-basin 1"
2013,300,8,1500,1800,"Sub-basin 1"
2014,600,23,3900,4500,"Sub-basin 1"
2015,200,16,2100,2300,"Sub-basin 1"
2016,1700,151,10700,12400,"Sub-basin 1"
2017,300,7,4600,4900,"Sub-basin 1"
2018,200,8,5000,5200,"Sub-basin 1"
2019,100,1,1000,1100,"Sub-basin 1"
2020,5800,357,11900,17700,"Sub-basin 1"
2021,200,14,1700,1900,"Sub-basin 1"
2022,600,29,3400,4000,"Sub-basin 1"
2023,27200,12652,24400,51600,"Sub-basin 1"
2024,1400,140,5200,6600,"Sub-basin 1"
2025,1000,71,6200,7200,"Sub-basin 1"
2026,100,1,1700,1800,"Sub-basin 1"
2027,400,16,2200,2600,"Sub-basin 1"
2028,400,22,3900,4300,"Sub-basin 1"
2029,100,4,2200,2300,"Sub-basin 1"
2030,200,2,1700,1900,"Sub-basin 1"
2031,200,9,4400,4600,"Sub-basin 1"
2032,200,11,1200,1400,"Sub-basin 1"
2033,400,23,2800,3200,"Sub-basin 1"
2034,62300,7149,239900,302200,"Sub-basin 1"
2035,1000,68,4000,5000,"Sub-basin 1"
2036,400,21,2400,2800,"Sub-basin 1"
2037,800,34,7000,7800,"Sub-basin 1"
2038,300,7,4000,4300,"Sub-basin 1"
2039,1200,28,3800,5000,"Sub-basin 1"
2040,900,51,5300,6200,"Sub-basin 1"
2041,800,189,4900,5700,"Sub-basin 1"
2042,300,9,1300,1600,"Sub-basin 1"
2043,900,142,3700,4600,"Sub-basin 1"
2044,600,19,4300,4900,"Sub-basin 1"
2045,15500,463,52400,67900,"Sub-basin 1"
2046,200,71,800,1000,"Sub-basin 1"
2047,100,2,900,1000,"Sub-basin 1"
2048,200,5,1200,1400,"Sub-basin 1"
2049,600,31,1900,2500,"Sub-basin 1"
2050,900,73,3200,4100,"Sub-basin 1"
2051,2700,58,13300,16000,"Sub-basin 1"
2052,7400,447,23700,31100,"Sub-basin 1"
2053,100,5,700,800,"Sub-basin 1"
2054,100,2,1300,1400,"Sub-basin 1"
2055,500,17,4800,5300,"Sub-basin 1"
2056,1900,50,10200,12100,"Sub-basin 1"
2057,100,2,700,800,"Sub-basin 1"
2058,200,6,900,1100,"Sub-basin 1"
2059,100,1,2700,2800,"Sub-basin 1"
2060,1200,99,9000,10200,"Sub-basin 1"
2061,4800,179,23200,28000,"Sub-basin 1"
2062,100,2,1800,1900,"Sub-basin 1"
2063,6600,318,35000,41600,"Sub-basin 1"
2064,100,1,1200,1300,"Sub-basin 1"
2065,100,6,1100,1200,"Sub-basin 1"
2066,600,21,8300,8900,"Sub-basin 1"
2067,24000,1048,69700,93700,"Sub-basin 1"
2068,1100,145,5600,6700,"Sub-basin 1"
2069,400,11,800,1200,"Sub-basin 1"
2070,300,6,1600,1900,"Sub-basin 1"
2071,400,10,2100,2500,"Sub-basin 1"
2072,200,7,2400,2600,"Sub-basin 1"
2073,300,15,3900,4200,"Sub-basin 1"
2074,100,1,2500,2600,"Sub-basin 1"
2075,600,43,4200,4800,"Sub-basin 1"
2076,400,23,2000,2400,"Sub-basin 1"
2077,200,5,1200,1400,"Sub-basin 1"
2078,400,18,3700,4100,"Sub-basin 1"
2079,2300,278,11900,14200,"Sub-basin 1"
2080,6000,772,18900,24900,"Sub-basin 1"
2081,100,3,800,900,"Sub-basin 1"
2082,1000,94,3300,4300,"Sub-basin 1"
2083,500,38,2300,2800,"Sub-basin 1"
2084,100,1,1800,1900,"Sub-basin 1"
2085,100,2,900,1000,"Sub-basin 1"
2086,2000,106,7300,9300,"Sub-basin 1"
2087,700,11,8600,9300,"Sub-basin 1"
2088,200,17,3000,3200,"Sub-basin 1"
2089,400,28,3800,4200,"Sub-basin 1"
2090,4200,119,16300,20500,"Sub-basin 1"
2091,7000,1334,16400,23400,"Sub-basin 1"
2092,500,44,2600,3100,"Sub-basin 1"
2093,300,13,2800,3100,"Sub-basin 1"
2094,100,1,1400,1500,"Sub-basin 1"
2095,200,11,2400,2600,"Sub-basin 1"
2096,6400,346,26600,33000,"Sub-basin 1"
2097,2400,146,18900,21300,"Sub-basin 1"
2098,100,1,1600,1700,"Sub-basin 1"
2099,100,2,2400,2500,"Sub-basin 1"
2100,200,6,2200,2400,"Sub-basin 1"
2101,1400,40,6200,7600,"Sub-basin 1"
2102,400,34,2000,2400,"Sub-basin 1"
2103,600,16,6100,6700,"Sub-basin 1"
2104,400,4,1000,1400,"Sub-basin 1"
2105,300,5,3100,3400,"Sub-basin 1"
2106,300,25,1600,1900,"Sub-basin 1"
2107,200,6,1500,1700,"Sub-basin 1"
2108,100,2,2200,2300,"Sub-basin 1"
2109,100,1,1800,1900,"Sub-basin 1"
2110,300,7,2500,2800,"Sub-basin 1"
2111,1300,204,6700,8000,"Sub-basin 1"
2112,200,4,1700,1900,"Sub-basin 1"
2113,1400,100,7200,8600,"Sub-basin 1"
2114,3300,485,10500,13800,"Sub-basin 1"
2115,4600,306,22500,27100,"Sub-basin 1"
2116,700,114,3200,3900,"Sub-basin 1"
2117,700,11,2800,3500,"Sub-basin 1"
2118,200,3,1900,2100,"Sub-basin 1"
2119,400,271.8344,1600,2000,"Sub-basin 1"
2120,900,69,4300,5200,"Sub-basin 1"
2121,100,1,1000,1100,"Sub-basin 1"
2122,300,4,3100,3400,"Sub-basin 1"
2123,400,19,2200,2600,"Sub-basin 1"
2124,1000,56,10900,11900,"Sub-basin 1"
2125,200,2,2600,2800,"Sub-basin 1"
2126,6000,635,5000,11000,"Sub-basin 1"
2127,1200,99,11500,12700,"Sub-basin 1"
2128,12400,1160.8729,47700,60100,"Sub-basin 1"
2129,100,1,2700,2800,"Sub-basin 1"
2130,200,2.0049,2600,2800,"Sub-basin 1"
2131,200,20,3000,3200,"Sub-basin 1"
2132,300,23,2600,2900,"Sub-basin 1"
2133,200,6,5200,5400,"Sub-basin 1"
2134,100,2,1500,1600,"Sub-basin 1"
2135,500,10,8400,8900,"Sub-basin 1"
2136,1100,42,8400,9500,"Sub-basin 1"
2137,1800,42,4400,6200,"Sub-basin 1"
2138,1100,87,3800,4900,"Sub-basin 1"
2139,1000,27,6900,7900,"Sub-basin 1"
2140,100,5,900,1000,"Sub-basin 1"
2141,100,1,600,700,"Sub-basin 1"
2142,200,7,3400,3600,"Sub-basin 1"
2143,1600,237,7100,8700,"Sub-basin 1"
2144,200,4,1400,1600,"Sub-basin 1"
2145,200,2,2400,2600,"Sub-basin 1"
2146,600,18,2100,2700,"Sub-basin 1"
2147,100,1,1200,1300,"Sub-basin 1"
2148,200,8,500,700,"Sub-basin 1"
2149,3100,490,12200,15300,"Sub-basin 1"
2150,400,59,1800,2200,"Sub-basin 1"
2151,100,1,2000,2100,"Sub-basin 1"
2152,300,10,1500,1800,"Sub-basin 1"
2153,100,1,1700,1800,"Sub-basin 1"
2154,100,1.0035,900,1000,"Sub-basin 1"
2155,700,25,6700,7400,"Sub-basin 1"
2156,300,9,1600,1900,"Sub-basin 1"
2157,100,1,3400,3500,"Sub-basin 1"
2158,100,1,1300,1400,"Sub-basin 1"
2159,200,2,2800,3000,"Sub-basin 1"
2160,100,1,1800,1900,"Sub-basin 1"
2161,1500,289,5500,7000,"Sub-basin 1"
2162,15400,2553,23600,39000,"Sub-basin 1"
2163,3400,485,13800,17200,"Sub-basin 1"
2164,600,36,5100,5700,"Sub-basin 1"
2165,17500,2289,23900,41400,"Sub-basin 1"
2166,1000,41.0284,7200,8200,"Sub-basin 1"
2167,100,2,400,500,"Sub-basin 1"
2168,1000,39,5500,6500,"Sub-basin 1"
2169,1000,87,10300,11300,"Sub-basin 1"
2170,200,9,4000,4200,"Sub-basin 1"
2171,900,108,3900,4800,"Sub-basin 1"
2172,1000,59,8800,9800,"Sub-basin 1"
2173,1000,105,6900,7900,"Sub-basin 1"
2174,200,9,900,1100,"Sub-basin 1"
2175,100,5,800,900,"Sub-basin 1"
2176,300,10,2700,3000,"Sub-basin 1"
2177,400,22,1900,2300,"Sub-basin 1"
2178,400,16,3900,4300,"Sub-basin 1"
2179,1700,218,6900,8600,"Sub-basin 1"
2180,100,1,1200,1300,"Sub-basin 1"
2181,4000,121,12900,16900,"Sub-basin 1"
2182,400,9,9800,10200,"Sub-basin 1"
2183,300,11,3100,3400,"Sub-basin 1"
2184,1100,57,6000,7100,"Sub-basin 1"
2185,600,46,3800,4400,"Sub-basin 1"
2186,200,3,3000,3200,"Sub-basin 1"
2187,100,2,1500,1600,"Sub-basin 1"
2188,100,2,1200,1300,"Sub-basin 1"
2189,400,7,7900,8300,"Sub-basin 1"
2190,100,4,1400,1500,"Sub-basin 1"
2191,100,3.0035,1100,1200,"Sub-basin 1"
2192,100,3.004,1200,1300,"Sub-basin 1"
2193,1300,55,9600,10900,"Sub-basin 1"
2194,200,4,2100,2300,"Sub-basin 1"
2195,300,8,2000,2300,"Sub-basin 1"
2196,14900,2252,38500,53400,"Sub-basin 1"
2197,300,4,2100,2400,"Sub-basin 1"
2198,3300,366,16400,19700,"Sub-basin 1"
2199,600,58,3900,4500,"Sub-basin 1"
2200,4000,484,7600,11600,"Sub-basin 1"
2201,3500,277,25300,28800,"Sub-basin 1"
2202,200,3.0113,3400,3600,"Sub-basin 1"
2203,300,9.0115,3200,3500,"Sub-basin 1"
2204,2000,74,23000,25000,"Sub-basin 1"
2205,100,1,1400,1500,"Sub-basin 1"
2206,400,15,3800,4200,"Sub-basin 1"
2207,300,21,3600,3900,"Sub-basin 1"
2208,1000,34,3700,4700,"Sub-basin 1"
2209,2600,192,10300,12900,"Sub-basin 1"
2210,100,4,1200,1300,"Sub-basin 1"
2211,200,8.0113,3300,3500,"Sub-basin 1"
2212,400,13.0487,3900,4300,"Sub-basin 1"
2213,100,1,1100,1200,"Sub-basin 1"
2214,500,24.0139,5100,5600,"Sub-basin 1"
2215,3000,691,9400,12400,"Sub-basin 1"
2216,200,11,2200,2400,"Sub-basin 1"
2217,1300,89,10000,11300,"Sub-basin 1"
2218,100,1,1100,1200,"Sub-basin 1"
2219,3700,849,8000,11700,"Sub-basin 1"
2220,200,10,1000,1200,"Sub-basin 1"
2221,100,1,800,900,"Sub-basin 1"
2222,100,1,500,600,"Sub-basin 1"
2223,100,4,2400,2500,"Sub-basin 1"
2224,300,7,2300,2600,"Sub-basin 1"
2225,300,7,2200,2500,"Sub-basin 1"
2226,100,3,1200,1300,"Sub-basin 1"
2227,200,4,2900,3100,"Sub-basin 1"
2228,500,20,5600,6100,"Sub-basin 1"
2229,100,1,500,600,"Sub-basin 1"
2230,400,15,6700,7100,"Sub-basin 1"
2231,100,2,2100,2200,"Sub-basin 1"
2232,2100,56,7700,9800,"Sub-basin 1"
2233,100,3.0015,900,1000,"Sub-basin 1"
2234,8200,1015,27300,35500,"Sub-basin 1"
2235,200,2,2000,2200,"Sub-basin 1"
2236,700,102,5100,5800,"Sub-basin 1"
2237,1600,205,9000,10600,"Sub-basin 1"
2238,5000,441,19300,24300,"Sub-basin 1"
2239,100,1,2200,2300,"Sub-basin 1"
2240,1900,78,12600,14500,"Sub-basin 1"
2241,100,1,1400,1500,"Sub-basin 1"
2242,100,1,1600,1700,"Sub-basin 1"
2243,400,16,4800,5200,"Sub-basin 1"
2244,2300,55,8300,10600,"Sub-basin 1"
2245,100,2,500,600,"Sub-basin 1"
2246,2400,162,8700,11100,"Sub-basin 1"
2247,2300,131,23800,26100,"Sub-basin 1"
2248,1800,61.0982,12900,14700,"Sub-basin 1"
2249,300,6.0193,7000,7300,"Sub-basin 1"
2250,100,5,700,800,"Sub-basin 1"
2251,1300,72,10000,11300,"Sub-basin 1"
2252,900,49,16500,17400,"Sub-basin 1"
2253,300,13,3100,3400,"Sub-basin 1"
2254,1200,74,8300,9500,"Sub-basin 1"
2255,100,4,1400,1500,"Sub-basin 1"
2256,1100,204,7300,8400,"Sub-basin 1"
2257,8900,308,25100,34000,"Sub-basin 1"
2258,900,139,4200,5100,"Sub-basin 1"
2259,600,26,7300,7900,"Sub-basin 1"
2260,200,4,1600,1800,"Sub-basin 1"
2261,200,12,2800,3000,"Sub-basin 1"
2262,12500,805,17100,29600,"Sub-basin 1"
2263,100,1,1700,1800,"Sub-basin 1"
2264,300,22,2400,2700,"Sub-basin 1"
2265,100,1,600,700,"Sub-basin 1"
2266,100,1,1700,1800,"Sub-basin 1"
2267,3100,297,20000,23100,"Sub-basin 1"
2268,4800,298,15500,20300,"Sub-basin 1"
2269,1200,29,12900,14100,"Sub-basin 1"
2270,9500,914,38800,48300,"Sub-basin 1"
2271,1600,73,8800,10400,"Sub-basin 1"
2272,800,75,3600,4400,"Sub-basin 1"
2273,100,3,300,400,"Sub-basin 1"
2274,200,4.011,2800,3000,"Sub-basin 1"
2275,2100,108,16700,18800,"Sub-basin 1"
2276,100,1.0025,1600,1700,"Sub-basin 1"
2277,100,1,3800,3900,"Sub-basin 1"
2278,900,32,7100,8000,"Sub-basin 1"
2279,200,5,2400,2600,"Sub-basin 1"
2280,400,9,9100,9500,"Sub-basin 1"
2281,12200,709,80900,93100,"Sub-basin 1"
2282,400,14,4600,5000,"Sub-basin 1"
2283,100,2,1100,1200,"Sub-basin 1"
2284,200,3,2100,2300,"Sub-basin 1"
2285,500,14,5200,5700,"Sub-basin 1"
2286,200,4.0108,6400,6600,"Sub-basin 1"
2287,3400,234,15000,18400,"Sub-basin 1"
2288,200,3,2100,2300,"Sub-basin 1"
2289,2100,516,6100,8200,"Sub-basin 1"
2290,700,35,4400,5100,"Sub-basin 1"
2291,500,10,5100,5600,"Sub-basin 1"
2292,300,9,700,1000,"Sub-basin 1"
2293,1900,323,6900,8800,"Sub-basin 1"
2294,3100,494,14100,17200,"Sub-basin 1"
2295,1600,83,6200,7800,"Sub-basin 1"
2296,100,1,1000,1100,"Sub-basin 1"
2297,3000,113,6700,9700,"Sub-basin 1"
2298,4600,172,9400,14000,"Sub-basin 1"
2299,200,7,1300,1500,"Sub-basin 1"
2300,600,67,5900,6500,"Sub-basin 1"
2301,100,1.0047,1900,2000,"Sub-basin 1"
2302,100,1.0021,1300,1400,"Sub-basin 1"
2303,100,3,1400,1500,"Sub-basin 1"
2304,700,103,1900,2600,"Sub-basin 1"
2305,300,10,4300,4600,"Sub-basin 1"
2306,100,1,300,400,"Sub-basin 1"
2307,300,5.0164,3900,4200,"Sub-basin 1"
2308,900,23,7800,8700,"Sub-basin 1"
2309,26300,1476,70700,97000,"Sub-basin 1"
2310,100,1,1800,1900,"Sub-basin 1"
2311,200,3,2300,2500,"Sub-basin 1"
2312,2200,105,20400,22600,"Sub-basin 1"
2313,100,1,1200,1300,"Sub-basin 1"
2314,600,79,4700,5300,"Sub-basin 1"
2315,100,2,1500,1600,"Sub-basin 1"
2316,100,2,1400,1500,"Sub-basin 1"
2317,100,2,1000,1100,"Sub-basin 1"
2318,1500,96,6000,7500,"Sub-basin 1"
2319,23900,7273,40300,64200,"Sub-basin 1"
2320,2200,91,5900,8100,"Sub-basin 1"
2321,1700,67,7100,8800,"Sub-basin 1"
2322,100,3,1200,1300,"Sub-basin 1"
2323,114700,15785,109000,223700,"Sub-basin 1"
2324,800,51,4100,4900,"Sub-basin 1"
2325,100,1,2200,2300,"Sub-basin 1"
2326,300,9,2100,2400,"Sub-basin 1"
2327,200,11,2300,2500,"Sub-basin 1"
2328,700,10,5800,6500,"Sub-basin 1"
2329,6000,180,27200,33200,"Sub-basin 1"
2330,300,12,3100,3400,"Sub-basin 1"
2331,400,36,3600,4000,"Sub-basin 1"
2332,100,1,1500,1600,"Sub-basin 1"
2333,100,1.0032,2500,2600,"Sub-basin 1"
2334,5400,318,36300,41700,"Sub-basin 1"
2335,700,46,5700,6400,"Sub-basin 1"
2336,400,17,1600,2000,"Sub-basin 1"
2337,24200,2187,90000,114200,"Sub-basin 1"
2338,1800,59,15800,17600,"Sub-basin 1"
2339,200,6,3100,3300,"Sub-basin 1"
2340,200,3,2400,2600,"Sub-basin 1"
2341,47800,14470,66700,114500,"Sub-basin 1"
2342,100,2,1400,1500,"Sub-basin 1"
2343,28000,886,77300,105300,"Sub-basin 1"
2344,200,6,1600,1800,"Sub-basin 1"
2345,13800,1828,15000,28800,"Sub-basin 1"
2346,700,54,3700,4400,"Sub-basin 1"
2347,200,8,4600,4800,"Sub-basin 1"
2348,100,1,1500,1600,"Sub-basin 1"
2349,300,14,2500,2800,"Sub-basin 1"
2350,100,1,2200,2300,"Sub-basin 1"
2351,100,6,600,700,"Sub-basin 1"
2352,400,9,3100,3500,"Sub-basin 1"
2353,100,1.0046,2500,2600,"Sub-basin 1"
2354,1300,106,9000,10300,"Sub-basin 1"
2355,200,11,3100,3300,"Sub-basin 1"
2356,3000,1232,9100,12100,"Sub-basin 1"
2357,8100,332,27700,35800,"Sub-basin 1"
2358,21000,4666,26400,47400,"Sub-basin 1"
2359,100,2,1500,1600,"Sub-basin 1"
2360,1900,136,4800,6700,"Sub-basin 1"
2361,100,7,800,900,"Sub-basin 1"
2362,1000,42,9100,10100,"Sub-basin 1"
2363,3100,1149,9000,12100,"Sub-basin 1"
2364,3000,145,11100,14100,"Sub-basin 1"
2365,1100,53,6800,7900,"Sub-basin 1"
2366,200,2,3600,3800,"Sub-basin 1"
2367,2600,105,9700,12300,"Sub-basin 1"
2368,3800,708,14600,18400,"Sub-basin 1"
2369,100,2,1400,1500,"Sub-basin 1"
2370,200,5,2100,2300,"Sub-basin 1"
2371,2900,224,10200,13100,"Sub-basin 1"
2372,800,46,3500,4300,"Sub-basin 1"
2373,100,3,1000,1100,"Sub-basin 1"
2374,100,3,2000,2100,"Sub-basin 1"
2375,100,1,1900,2000,"Sub-basin 1"
2376,500,14,3300,3800,"Sub-basin 1"
2377,500,19,8500,9000,"Sub-basin 1"
2378,2200,148,10000,12200,"Sub-basin 1"
2379,200,5,1100,1300,"Sub-basin 1"
2380,100,4,900,1000,"Sub-basin 1"
2381,3900,359,15100,19000,"Sub-basin 1"
2382,100,2,2200,2300,"Sub-basin 1"
2383,500,26,6500,7000,"Sub-basin 1"
2384,100,1,900,1000,"Sub-basin 1"
2385,2600,311,11200,13800,"Sub-basin 1"
2386,100,3,2400,2500,"Sub-basin 1"
2387,100,3,1200,1300,"Sub-basin 1"
2388,100,4,400,500,"Sub-basin 1"
2389,54200,13635.33,51600,105800,"Sub-basin 1"
2390,200,4,1700,1900,"Sub-basin 1"
2391,500,22,5500,6000,"Sub-basin 1"
2392,600,17,3200,3800,"Sub-basin 1"
2393,100,2,1300,1400,"Sub-basin 1"
2394,700,20,7700,8400,"Sub-basin 1"
2395,1400,326,4600,6000,"Sub-basin 1"
2396,100,1,2800,2900,"Sub-basin 1"
2397,100,1,1100,1200,"Sub-basin 1"
2398,100,2,500,600,"Sub-basin 1"
2399,1500,301,5200,6700,"Sub-basin 1"
2400,1100,44,5300,6400,"Sub-basin 1"
2401,4200,129,12700,16900,"Sub-basin 1"
2402,100,1,3500,3600,"Sub-basin 1"
2403,100,1.0044,2400,2500,"Sub-basin 1"
2404,3100,164,16100,19200,"Sub-basin 1"
2405,900,77,5200,6100,"Sub-basin 1"
2406,800,46,5200,6000,"Sub-basin 1"
2407,300,4,900,1200,"Sub-basin 1"
2408,100,2,2000,2100,"Sub-basin 1"
2409,200,8,2400,2600,"Sub-basin 1"
2410,1100,45,9800,10900,"Sub-basin 1"
2411,500,10,4100,4600,"Sub-basin 1"
2412,100,3,900,1000,"Sub-basin 1"
2413,200,3,1300,1500,"Sub-basin 1"
2414,100,1,1200,1300,"Sub-basin 1"
2415,100,1,1300,1400,"Sub-basin 1"
2416,6000,1269,8900,14900,"Sub-basin 1"
2417,9700,454,40100,49800,"Sub-basin 1"
2418,100,2,300,400,"Sub-basin 1"
2419,400,24,6100,6500,"Sub-basin 1"
2420,300,5,6300,6600,"Sub-basin 1"
2421,200,9,1300,1500,"Sub-basin 1"
2422,100,1,600,700,"Sub-basin 1"
2423,3800,124,16100,19900,"Sub-basin 1"
2424,4600,265,8200,12800,"Sub-basin 1"
2425,100,1.0184,2300,2400,"Sub-basin 1"
2426,100,1.0034,2300,2400,"Sub-basin 1"
2427,600,32,4600,5200,"Sub-basin 1"
2428,1200,80,8600,9800,"Sub-basin 1"
2429,800,107,6500,7300,"Sub-basin 1"
2430,3600,361,6200,9800,"Sub-basin 1"
2431,1000,33.1038,12200,13200,"Sub-basin 1"
2432,100,2.0041,3200,3300,"Sub-basin 1"
2433,500,28,2500,3000,"Sub-basin 1"
2434,100,2,1000,1100,"Sub-basin 1"
2435,100,1,1900,2000,"Sub-basin 1"
2436,100,2,1600,1700,"Sub-basin 1"
2437,500,57,5600,6100,"Sub-basin 1"
2438,700,34,2800,3500,"Sub-basin 1"
2439,1200,107,3300,4500,"Sub-basin 1"
2440,900,46,6200,7100,"Sub-basin 1"
2441,1400,165,5900,7300,"Sub-basin 1"
2442,1800,209,6500,8300,"Sub-basin 1"
2443,2000,205,9600,11600,"Sub-basin 1"
2444,700,54,3800,4500,"Sub-basin 1"
2445,200,2,1800,2000,"Sub-basin 1"
2446,100,2,2800,2900,"Sub-basin 1"
2447,100,2,600,700,"Sub-basin 1"
2448,100,1,3400,3500,"Sub-basin 1"
2449,100,5,1100,1200,"Sub-basin 1"
2450,600,21,6100,6700,"Sub-basin 1"
2451,100,2,1500,1600,"Sub-basin 1"
2452,200,7,2100,2300,"Sub-basin 1"
2453,7700,623,44100,51800,"Sub-basin 1"
2454,200,4,1200,1400,"Sub-basin 1"
2455,500,8,3400,3900,"Sub-basin 1"
2456,300,11,2200,2500,"Sub-basin 1"
2457,800,53,8200,9000,"Sub-basin 1"
2458,600,36,7500,8100,"Sub-basin 1"
2459,400,15,2800,3200,"Sub-basin 1"
2460,15000,1339,34800,49800,"Sub-basin 1"
2461,400,4,5700,6100,"Sub-basin 1"
2462,100,2,1500,1600,"Sub-basin 1"
2463,700,14,3400,4100,"Sub-basin 1"
2464,200,5,3100,3300,"Sub-basin 1"
2465,400,16,4600,5000,"Sub-basin 1"
2466,300,4,4300,4600,"Sub-basin 1"
2467,100,1,2200,2300,"Sub-basin 1"
2468,200,4,2200,2400,"Sub-basin 1"
2469,100,2,1000,1100,"Sub-basin 1"
2470,1100,33,14800,15900,"Sub-basin 1"
2471,200,3,3400,3600,"Sub-basin 1"
2472,200,3,1300,1500,"Sub-basin 1"
2473,100,3,1400,1500,"Sub-basin 1"
2474,400,28,4800,5200,"Sub-basin 1"
2475,100,3,1800,1900,"Sub-basin 1"
2476,1000,38,7600,8600,"Sub-basin 1"
2477,100,1,2100,2200,"Sub-basin 1"
2478,100,5,1400,1500,"Sub-basin 1"
2479,300,9,3500,3800,"Sub-basin 1"
2480,100,1,800,900,"Sub-basin 1"
2481,400,12,5600,6000,"Sub-basin 1"
2482,100,1,400,500,"Sub-basin 1"
2483,600,18,2200,2800,"Sub-basin 1"
2484,200,4.011,2800,3000,"Sub-basin 1"
2485,214600,45271.84,325700,540300,"Sub-basin 1"
2486,1100,55,15300,16400,"Sub-basin 1"
2487,1300,181,3900,5200,"Sub-basin 1"
2488,2200,160,7500,9700,"Sub-basin 1"
2489,400,13,3400,3800,"Sub-basin 1"
2490,1100,25,22000,23100,"Sub-basin 1"
2491,100,2,2300,2400,"Sub-basin 1"
2492,1400,96,11300,12700,"Sub-basin 1"
2493,200,3,4700,4900,"Sub-basin 1"
2494,200,12,2800,3000,"Sub-basin 1"
2495,100,4,900,1000,"Sub-basin 1"
2496,100,1,1300,1400,"Sub-basin 1"
2497,1100,119,2200,3300,"Sub-basin 1"
2498,2800,136,10000,12800,"Sub-basin 1"
2499,200,8,1500,1700,"Sub-basin 1"
2500,1900,135,4800,6700,"Sub-basin 1"
2501,700,71,1700,2400,"Sub-basin 1"
2502,300,25,3000,3300,"Sub-basin 1"
2503,2000,251,4600,6600,"Sub-basin 1"
2504,300,8,2800,3100,"Sub-basin 1"
2505,400,7,4600,5000,"Sub-basin 1"
2506,100,1,2200,2300,"Sub-basin 1"
2507,200,7,2800,3000,"Sub-basin 1"
2508,100,1,100,200,"Sub-basin 1"
2509,1100,77,6600,7700,"Sub-basin 1"
2510,100,2,2600,2700,"Sub-basin 1"
2511,4200,247,11300,15500,"Sub-basin 1"
2512,1700,167,5700,7400,"Sub-basin 1"
2513,2800,240,11400,14200,"Sub-basin 1"
2514,200,3,4000,4200,"Sub-basin 1"
2515,100,3,1200,1300,"Sub-basin 1"
2516,100,9,800,900,"Sub-basin 1"
2517,100,4.0044,2500,2600,"Sub-basin 1"
2518,1400,206,8200,9600,"Sub-basin 1"
2519,800,56,6500,7300,"Sub-basin 1"
2520,500,34,2100,2600,"Sub-basin 1"
2521,500,41,5400,5900,"Sub-basin 1"
2522,500,35,2900,3400,"Sub-basin 1"
2523,100,1,800,900,"Sub-basin 1"
2524,100,1,1000,1100,"Sub-basin 1"
2525,200,5,1600,1800,"Sub-basin 1"
2526,100,1,1000,1100,"Sub-basin 1"
2527,600,25,5100,5700,"Sub-basin 1"
2528,5400,700,15400,20800,"Sub-basin 1"
2529,600,29,4100,4700,"Sub-basin 1"
2530,2400,115,11400,13800,"Sub-basin 1"
2531,100,3,600,700,"Sub-basin 1"
2532,100,2.0044,1500,1600,"Sub-basin 1"
2533,200,4,3400,3600,"Sub-basin 1"
2534,400,21,3000,3400,"Sub-basin 1"
2535,2300,84,10600,12900,"Sub-basin 1"
2536,600,78,1800,2400,"Sub-basin 1"
2537,200,4,5200,5400,"Sub-basin 1"
2538,100,2,1000,1100,"Sub-basin 1"
2539,200,123,2800,3000,"Sub-basin 1"
2540,1000,27,6000,7000,"Sub-basin 1"
2541,100,1,2100,2200,"Sub-basin 1"
2542,48300,19567,39700,88000,"Sub-basin 1"
2543,200,4,6100,6300,"Sub-basin 1"
2544,1300,88,14200,15500,"Sub-basin 1"
2545,2400,83,10700,13100,"Sub-basin 1"
2546,500,15,3300,3800,"Sub-basin 1"
2547,2600,75,8800,11400,"Sub-basin 1"
2548,600,14,3100,3700,"Sub-basin 1"
2549,2100,132,10600,12700,"Sub-basin 1"
2550,5700,409,28300,34000,"Sub-basin 1"
2551,600,67,2800,3400,"Sub-basin 1"
2552,11500,1410,22500,34000,"Sub-basin 1"
2553,100,1,300,400,"Sub-basin 1"
2554,700,23,5500,6200,"Sub-basin 1"
2555,300,9.0201,6100,6400,"Sub-basin 1"
2556,2900,353,7500,10400,"Sub-basin 1"
2557,3300,367,13900,17200,"Sub-basin 1"
2558,900,35,6300,7200,"Sub-basin 1"
2559,500,46,3100,3600,"Sub-basin 1"
2560,100,4,3300,3400,"Sub-basin 1"
2561,100,5,1200,1300,"Sub-basin 1"
2562,600,40.67,2400,3000,"Sub-basin 1"
2563,100,1,2200,2300,"Sub-basin 1"
2564,100,3,1200,1300,"Sub-basin 1"
2565,100,1,2900,3000,"Sub-basin 1"
2566,500,19,5100,5600,"Sub-basin 1"
2567,21600,3639,37100,58700,"Sub-basin 1"
2568,3900,107,9100,13000,"Sub-basin 1"
2569,600,13,4300,4900,"Sub-basin 1"
2570,100,1,1900,2000,"Sub-basin 1"
2571,700,37,4500,5200,"Sub-basin 1"
2572,400,8,2300,2700,"Sub-basin 1"
2573,100,2,2700,2800,"Sub-basin 1"
2574,200,5,900,1100,"Sub-basin 1"
2575,900,41,4400,5300,"Sub-basin 1"
2576,2100,187,4900,7000,"Sub-basin 1"
2577,300,3,800,1100,"Sub-basin 1"
2578,12300,525,41500,53800,"Sub-basin 1"
2579,700,76,2500,3200,"Sub-basin 1"
2580,400,5,1800,2200,"Sub-basin 1"
2581,3000,119,8600,11600,"Sub-basin 1"
2582,100,5,1300,1400,"Sub-basin 1"
2583,1900,53,33200,35100,"Sub-basin 1"
2584,5500,170,15100,20600,"Sub-basin 1"
2585,100,1,700,800,"Sub-basin 1"
2586,100,1,700,800,"Sub-basin 1"
2587,100,1,1800,1900,"Sub-basin 1"
2588,1300,51,16900,18200,"Sub-basin 1"
2589,100,2,1800,1900,"Sub-basin 1"
2590,100,1,1300,1400,"Sub-basin 1"
2591,200,9,5500,5700,"Sub-basin 1"
2592,1300,36,6100,7400,"Sub-basin 1"
2593,100,2,700,800,"Sub-basin 1"
2594,100,1,1200,1300,"Sub-basin 1"
2595,5900,612,9700,15600,"Sub-basin 1"
2596,700,95,4700,5400,"Sub-basin 1"
2597,100,2.0044,2100,2200,"Sub-basin 1"
2598,200,12,2800,3000,"Sub-basin 1"
2599,3100,181,37900,41000,"Sub-basin 1"
2600,100,3,1000,1100,"Sub-basin 1"
2601,100,7,1100,1200,"Sub-basin 1"
2602,54600,3196,88600,143200,"Sub-basin 1"
2603,3700,440,9200,12900,"Sub-basin 1"
2604,1500,177,9500,11000,"Sub-basin 1"
2605,4600,189,26500,31100,"Sub-basin 1"
2606,100,2,1300,1400,"Sub-basin 1"
2607,100,2,1700,1800,"Sub-basin 1"
2608,100,4,2500,2600,"Sub-basin 1"
2609,600,12,1600,2200,"Sub-basin 1"
2610,1700,46,6800,8500,"Sub-basin 1"
2611,100,2,900,1000,"Sub-basin 1"
2612,400,22.0817,5700,6100,"Sub-basin 1"
2613,100,1,700,800,"Sub-basin 1"
2614,200,3,3400,3600,"Sub-basin 1"
2615,3600,248,32200,35800,"Sub-basin 1"
2616,2700,81,8800,11500,"Sub-basin 1"
2617,2900,374,12200,15100,"Sub-basin 1"
2618,33900,1492,141600,175500,"Sub-basin 1"
2619,100,1,1900,2000,"Sub-basin 1"
2620,300,9,3300,3600,"Sub-basin 1"
2621,100,1,1800,1900,"Sub-basin 1"
2622,500,13,5300,5800,"Sub-basin 1"
2623,400,13,4700,5100,"Sub-basin 1"
2624,100,1,700,800,"Sub-basin 1"
2625,100,1,800,900,"Sub-basin 1"
2626,2800,237,8500,11300,"Sub-basin 1"
2627,200,5,3400,3600,"Sub-basin 1"
2628,200,5,1300,1500,"Sub-basin 1"
2629,6200,612,17700,23900,"Sub-basin 1"
2630,500,18,4300,4800,"Sub-basin 1"
2631,900,49,3200,4100,"Sub-basin 1"
2632,1300,31,4800,6100,"Sub-basin 1"
2633,1500,103,3900,5400,"Sub-basin 1"
2634,100,2,2000,2100,"Sub-basin 1"
2635,100,7,900,1000,"Sub-basin 1"
2636,100,3,1700,1800,"Sub-basin 1"
2637,400,23,3400,3800,"Sub-basin 1"
2638,200,3,4300,4500,"Sub-basin 1"
2639,100,1,1700,1800,"Sub-basin 1"
2640,200,7,1600,1800,"Sub-basin 1"
2641,400,26.0308,7600,8000,"Sub-basin 1"
2642,3000,182.2501,27600,30600,"Sub-basin 1"
2643,100,3,1100,1200,"Sub-basin 1"
2644,100,1,900,1000,"Sub-basin 1"
2645,100,2,1000,1100,"Sub-basin 1"
2646,2300,51,13400,15700,"Sub-basin 1"
2647,100,2,900,1000,"Sub-basin 1"
2648,3500,229,9100,12600,"Sub-basin 1"
2649,400,16,5500,5900,"Sub-basin 1"
2650,100,1,1000,1100,"Sub-basin 1"
2651,3000,219,11900,14900,"Sub-basin 1"
2652,200,3,5200,5400,"Sub-basin 1"
2653,200,7,1200,1400,"Sub-basin 1"
2654,2700,289,10300,13000,"Sub-basin 1"
2655,1600,51,11200,12800,"Sub-basin 1"
2656,400,10,3000,3400,"Sub-basin 1"
2657,200,3,1000,1200,"Sub-basin 1"
2658,300,8,4700,5000,"Sub-basin 1"
2659,700,37,5800,6500,"Sub-basin 1"
2660,400,21,2000,2400,"Sub-basin 1"
2661,1600,62,6300,7900,"Sub-basin 1"
2662,100,2,3400,3500,"Sub-basin 1"
2663,200,57,2600,2800,"Sub-basin 1"
2664,100,1,600,700,"Sub-basin 1"
2665,300,4,1500,1800,"Sub-basin 1"
2666,100,6,2000,2100,"Sub-basin 1"
2667,300,5,2600,2900,"Sub-basin 1"
2668,500,21,5400,5900,"Sub-basin 1"
2669,300,10,1800,2100,"Sub-basin 1"
2670,2200,84,11000,13200,"Sub-basin 1"
2671,100,3,1100,1200,"Sub-basin 1"
2672,3300,179,17300,20600,"Sub-basin 1"
2673,100,4,1000,1100,"Sub-basin 1"
2674,7400,388,29600,37000,"Sub-basin 1"
2675,300,8,2400,2700,"Sub-basin 1"
2676,100,1,1800,1900,"Sub-basin 1"
2677,700,45,8600,9300,"Sub-basin 1"
2678,300,11,6800,7100,"Sub-basin 1"
2679,100,1,3600,3700,"Sub-basin 1"
2680,1100,397,6500,7600,"Sub-basin 1"
2681,100,1,1500,1600,"Sub-basin 1"
2682,300,6,1700,2000,"Sub-basin 1"
2683,7600,370,23200,30800,"Sub-basin 1"
2684,900,47.0693,4900,5800,"Sub-basin 1"
2685,5600,511,18200,23800,"Sub-basin 1"
2686,500,140,2000,2500,"Sub-basin 1"
2687,3500,1139,5400,8900,"Sub-basin 1"
2688,400,14,4600,5000,"Sub-basin 1"
2689,700,27,3600,4300,"Sub-basin 1"
2690,900,90,4100,5000,"Sub-basin 1"
2691,800,25,13400,14200,"Sub-basin 1"
2692,900,123,9500,10400,"Sub-basin 1"
2693,400,33,2900,3300,"Sub-basin 1"
2694,2000,180,5500,7500,"Sub-basin 1"
2695,900,45,3400,4300,"Sub-basin 1"
2696,8000,430,30600,38600,"Sub-basin 1"
2697,200,6,3300,3500,"Sub-basin 1"
2698,3500,354,11300,14800,"Sub-basin 1"
2699,1400,77,24100,25500,"Sub-basin 1"
2700,100,10,1600,1700,"Sub-basin 1"
2701,200,2,1400,1600,"Sub-basin 1"
2702,900,41,3700,4600,"Sub-basin 1"
2703,100,2,1100,1200,"Sub-basin 1"
2704,100,1,1500,1600,"Sub-basin 1"
2705,300,12,3200,3500,"Sub-basin 1"
2706,100,4,3900,4000,"Sub-basin 1"
2707,20400,1470,42000,62400,"Sub-basin 1"
2708,1000,43,4500,5500,"Sub-basin 1"
2709,600,21,9300,9900,"Sub-basin 1"
2710,700,13,6600,7300,"Sub-basin 1"
2711,5400,196,11800,17200,"Sub-basin 1"
2712,200,8,1900,2100,"Sub-basin 1"
2713,200,3,2100,2300,"Sub-basin 1"
2714,2100,77,12200,14300,"Sub-basin 1"
2715,300,7,4300,4600,"Sub-basin 1"
2716,100,3,3400,3500,"Sub-basin 1"
2717,100,1,1400,1500,"Sub-basin 1"
2718,100,1,1700,1800,"Sub-basin 1"
2719,100,1,800,900,"Sub-basin 1"
2720,4800,185,15900,20700,"Sub-basin 1"
2721,100,2,1400,1500,"Sub-basin 1"
2722,3100,189,8200,11300,"Sub-basin 1"
2723,7800,1866.67,10200,18000,"Sub-basin 1"
2724,700,71,1700,2400,"Sub-basin 1"
2725,1900,276,5400,7300,"Sub-basin 1"
2726,2800,65,12500,15300,"Sub-basin 1"
2727,100,2,1700,1800,"Sub-basin 1"
2728,1400,159,3900,5300,"Sub-basin 1"
2729,100,3,2500,2600,"Sub-basin 1"
2730,300,10,5900,6200,"Sub-basin 1"
2731,1400,571,9700,11100,"Sub-basin 1"
2732,100,1,1200,1300,"Sub-basin 1"
2733,500,11,2600,3100,"Sub-basin 1"
2734,3500,158,14300,17800,"Sub-basin 1"
2735,500,9,5300,5800,"Sub-basin 1"
2736,100,1,1800,1900,"Sub-basin 1"
2737,1100,30,8300,9400,"Sub-basin 1"
2738,5500,416,20100,25600,"Sub-basin 1"
2739,1100,75,4600,5700,"Sub-basin 1"
2740,700,14,5300,6000,"Sub-basin 1"
2741,200,9,1500,1700,"Sub-basin 1"
2742,200,4,3200,3400,"Sub-basin 1"
2743,300,9,7400,7700,"Sub-basin 1"
2744,200,6,4200,4400,"Sub-basin 1"
2745,200,7,3000,3200,"Sub-basin 1"
2746,100,1,2000,2100,"Sub-basin 1"
2747,300,6,3800,4100,"Sub-basin 1"
2748,6700,183,16300,23000,"Sub-basin 1"
2749,700,49,8800,9500,"Sub-basin 1"
2750,12200,3842,29700,41900,"Sub-basin 1"
2751,100,2,2400,2500,"Sub-basin 1"
2752,1900,163,5000,6900,"Sub-basin 1"
2753,300,20,2700,3000,"Sub-basin 1"
2754,500,26,3500,4000,"Sub-basin 1"
2755,500,20,2700,3200,"Sub-basin 1"
2756,200,23,2900,3100,"Sub-basin 1"
2757,400,15,4400,4800,"Sub-basin 1"
2758,900,48,9800,10700,"Sub-basin 1"
2759,100,2,1400,1500,"Sub-basin 1"
2760,200,3,1400,1600,"Sub-basin 1"
2761,300,10.0201,6500,6800,"Sub-basin 1"
2762,700,97,3400,4100,"Sub-basin 1"
2763,100,3,1200,1300,"Sub-basin 1"
2764,300,9,6100,6400,"Sub-basin 1"
2765,1500,127,6900,8400,"Sub-basin 1"
2766,200,3,2200,2400,"Sub-basin 1"
2767,100,1,1200,1300,"Sub-basin 1"
2768,100,4,2400,2500,"Sub-basin 1"
2769,300,6,3300,3600,"Sub-basin 1"
2770,200,14,4300,4500,"Sub-basin 1"
2771,20400,2866,32800,53200,"Sub-basin 1"
2772,200,2,900,1100,"Sub-basin 1"
2773,200,10,700,900,"Sub-basin 1"
2774,100,2,900,1000,"Sub-basin 1"
2775,100,6,1300,1400,"Sub-basin 1"
2776,300,5,2200,2500,"Sub-basin 1"
2777,2100,166,14500,16600,"Sub-basin 1"
2778,1100,43,5200,6300,"Sub-basin 1"
2779,100,0.67,1700,1800,"Sub-basin 1"
2780,100,1,1700,1800,"Sub-basin 1"
2781,100,1,2400,2500,"Sub-basin 1"
2782,400,11,4500,4900,"Sub-basin 1"
2783,100,2,1800,1900,"Sub-basin 1"
2784,200,3,4400,4600,"Sub-basin 1"
2785,100,1,1600,1700,"Sub-basin 1"
2786,100,1,1000,1100,"Sub-basin 1"
2787,500,28,7600,8100,"Sub-basin 1"
2788,5100,134,16100,21200,"Sub-basin 1"
2789,100,2.0044,1700,1800,"Sub-basin 1"
2790,900,132,2000,2900,"Sub-basin 1"
2791,300,8,4000,4300,"Sub-basin 1"
2792,100,3,1500,1600,"Sub-basin 1"
2793,1800,110,16700,18500,"Sub-basin 1"
2794,300,6,4100,4400,"Sub-basin 1"
2795,300,6,4000,4300,"Sub-basin 1"
2796,13200,994,23900,37100,"Sub-basin 1"
2797,100,4,600,700,"Sub-basin 1"
2798,100,1,200,300,"Sub-basin 1"
2799,100,3,800,900,"Sub-basin 1"
2800,200,4,2900,3100,"Sub-basin 1"
2801,500,24,2000,2500,"Sub-basin 1"
2802,1100,40,15100,16200,"Sub-basin 1"
2803,2700,448,8200,10900,"Sub-basin 1"
2804,100,1,900,1000,"Sub-basin 1"
2805,129900,6144,205000,334900,"Sub-basin 1"
2806,1100,100,6600,7700,"Sub-basin 1"
2807,100,1.0044,1800,1900,"Sub-basin 1"
2808,400,20,8300,8700,"Sub-basin 1"
2809,1300,97,10300,11600,"Sub-basin 1"
2810,1000,79,6700,7700,"Sub-basin 1"
2811,2800,85,10300,13100,"Sub-basin 1"
2812,300,6,4600,4900,"Sub-basin 1"
2813,700,21,9600,10300,"Sub-basin 1"
2814,300,4,3400,3700,"Sub-basin 1"
2815,800,102,6800,7600,"Sub-basin 1"
2816,100,4,1400,1500,"Sub-basin 1"
2817,200,4,1700,1900,"Sub-basin 1"
2818,100,5,1200,1300,"Sub-basin 1"
2819,5500,354,23100,28600,"Sub-basin 1"
2820,100,2,1800,1900,"Sub-basin 1"
2821,300,6,5600,5900,"Sub-basin 1"
2822,200,11,4300,4500,"Sub-basin 1"
2823,100,1,1900,2000,"Sub-basin 1"
2824,200,5,2100,2300,"Sub-basin 1"
2825,100,2,1300,1400,"Sub-basin 1"
2826,100,2,1100,1200,"Sub-basin 1"
2827,200,2,700,900,"Sub-basin 1"
2828,100,4,1500,1600,"Sub-basin 1"
2829,400,35,3400,3800,"Sub-basin 1"
2830,100,1,800,900,"Sub-basin 1"
2831,100,3,1500,1600,"Sub-basin 1"
2832,800,209,5400,6200,"Sub-basin 1"
2833,7300,250,28000,35300,"Sub-basin 1"
2834,300,5,4800,5100,"Sub-basin 1"
2835,200,16,1500,1700,"Sub-basin 1"
2836,100,6,1100,1200,"Sub-basin 1"
2837,100,4,300,400,"Sub-basin 1"
2838,100,1.0044,2600,2700,"Sub-basin 1"
2839,200,3,2800,3000,"Sub-basin 1"
2840,1100,83,6600,7700,"Sub-basin 1"
2841,100,4,2500,2600,"Sub-basin 1"
2842,5500,527,20200,25700,"Sub-basin 1"
2843,200,9,1100,1300,"Sub-basin 1"
2844,1000,43,4100,5100,"Sub-basin 1"
2845,500,11,4100,4600,"Sub-basin 1"
2846,700,64,6800,7500,"Sub-basin 1"
2847,100,2,1000,1100,"Sub-basin 1"
2848,200,2,1400,1600,"Sub-basin 1"
2849,100,2,2700,2800,"Sub-basin 1"
2850,4600,221.33,15300,19900,"Sub-basin 1"
2851,100,2,200,300,"Sub-basin 1"
2852,200,3,1500,1700,"Sub-basin 1"
2853,2100,107,13200,15300,"Sub-basin 1"
2854,300,4,2100,2400,"Sub-basin 1"
2855,5900,1848,25600,31500,"Sub-basin 1"
2856,100,3,2200,2300,"Sub-basin 1"
2857,100,2,2300,2400,"Sub-basin 1"
2858,500,9,6800,7300,"Sub-basin 1"
2859,300,9,1700,2000,"Sub-basin 1"
2860,1100,66,3900,5000,"Sub-basin 1"
2861,9000,440,28100,37100,"Sub-basin 1"
2862,200,5,2200,2400,"Sub-basin 1"
2863,1100,69,11000,12100,"Sub-basin 1"
2864,300,4,2200,2500,"Sub-basin 1"
2865,100,1,1100,1200,"Sub-basin 1"
2866,100,1,500,600,"Sub-basin 1"
2867,100,3,1100,1200,"Sub-basin 1"
2868,300,6,2300,2600,"Sub-basin 1"
2869,800,43,1600,2400,"Sub-basin 1"
2870,3200,344,7700,10900,"Sub-basin 1"
2871,1300,142,3100,4400,"Sub-basin 1"
2872,200,7,3000,3200,"Sub-basin 1"
2873,100,1,600,700,"Sub-basin 1"
2874,400,6,6700,7100,"Sub-basin 1"
2875,300,15,1000,1300,"Sub-basin 1"
2876,100,1,500,600,"Sub-basin 1"
2877,1200,319,6100,7300,"Sub-basin 1"
2878,1600,89,6000,7600,"Sub-basin 1"
2879,600,17,6600,7200,"Sub-basin 1"
2880,900,48,6700,7600,"Sub-basin 1"
2881,1000,41,6600,7600,"Sub-basin 1"
2882,200,7,1400,1600,"Sub-basin 1"
2883,600,56,4800,5400,"Sub-basin 1"
2884,400,12,2400,2800,"Sub-basin 1"
2885,100,5,2600,2700,"Sub-basin 1"
2886,400,18,6800,7200,"Sub-basin 1"
2887,100,1,1400,1500,"Sub-basin 1"
2888,100,1.0038,1900,2000,"Sub-basin 1"
2889,200,11,1700,1900,"Sub-basin 1"
2890,200,5,4500,4700,"Sub-basin 1"
2891,1100,94,13500,14600,"Sub-basin 1"
2892,200,10,2500,2700,"Sub-basin 1"
2893,800,30,3300,4100,"Sub-basin 1"
2894,6600,619,29400,36000,"Sub-basin 1"
2895,400,37,3000,3400,"Sub-basin 1"
2896,2600,264,9600,12200,"Sub-basin 1"
2897,8700,323,21100,29800,"Sub-basin 1"
2898,1800,916,4500,6300,"Sub-basin 1"
2899,2400,175,8000,10400,"Sub-basin 1"
2900,200,3,800,1000,"Sub-basin 1"
2901,100,1,500,600,"Sub-basin 1"
2902,700,13,4900,5600,"Sub-basin 1"
2903,400,15,2300,2700,"Sub-basin 1"
2904,1700,70,9700,11400,"Sub-basin 1"
2905,200,2,2700,2900,"Sub-basin 1"
2906,28400,6799,31700,60100,"Sub-basin 1"
2907,200,3,1800,2000,"Sub-basin 1"
2908,1900,80.172,20400,22300,"Sub-basin 1"
2909,2700,322,4200,6900,"Sub-basin 1"
2910,1100,53,5000,6100,"Sub-basin 1"
2911,100,2,1000,1100,"Sub-basin 1"
2912,100,2,400,500,"Sub-basin 1"
2913,100,1,500,600,"Sub-basin 1"
2914,11100,409,33600,44700,"Sub-basin 1"
2915,3200,214,22800,26000,"Sub-basin 1"
2916,800,46,8400,9200,"Sub-basin 1"
2917,100,5,700,800,"Sub-basin 1"
2918,800,18,5000,5800,"Sub-basin 1"
2919,100,1,200,300,"Sub-basin 1"
2920,200,8,1400,1600,"Sub-basin 1"
2921,400,13,1700,2100,"Sub-basin 1"
2922,100,2,1600,1700,"Sub-basin 1"
2923,200,4,1000,1200,"Sub-basin 1"
2924,200,4,2200,2400,"Sub-basin 1"
2925,100,4,2000,2100,"Sub-basin 1"
2926,400,22,2400,2800,"Sub-basin 1"
2927,100,3,2100,2200,"Sub-basin 1"
2928,15900,833,34500,50400,"Sub-basin 1"
2929,100,4,500,600,"Sub-basin 1"
2930,3300,145,6800,10100,"Sub-basin 1"
2931,3000,236,18500,21500,"Sub-basin 1"
2932,500,55,3300,3800,"Sub-basin 1"
2933,200,7,2200,2400,"Sub-basin 1"
2934,800,60,2600,3400,"Sub-basin 1"
2935,400,9,600,1000,"Sub-basin 1"
2936,200,4,2000,2200,"Sub-basin 1"
2937,600,14,3700,4300,"Sub-basin 1"
2938,3400,179,19100,22500,"Sub-basin 1"
2939,25200,4050,37800,63000,"Sub-basin 1"
2940,1000,22,5500,6500,"Sub-basin 1"
2941,200,2,1200,1400,"Sub-basin 1"
2942,600,21,3100,3700,"Sub-basin 1"
2943,600,48,2700,3300,"Sub-basin 1"
2944,200,9,2500,2700,"Sub-basin 1"
2945,4900,509,28000,32900,"Sub-basin 1"
2946,400,48,2900,3300,"Sub-basin 1"
2947,800,56,4300,5100,"Sub-basin 1"
2948,200,2,1500,1700,"Sub-basin 1"
2949,100,3,700,800,"Sub-basin 1"
2950,100,1,800,900,"Sub-basin 1"
2951,100,8,1600,1700,"Sub-basin 1"
2952,100,1,1100,1200,"Sub-basin 1"
2953,100,1,400,500,"Sub-basin 1"
2954,100,1,600,700,"Sub-basin 1"
2955,300,10,1600,1900,"Sub-basin 1"
2956,100,1,800,900,"Sub-basin 1"
2957,100,3,1500,1600,"Sub-basin 1"
2958,300,9,2200,2500,"Sub-basin 1"
2959,5400,271,26700,32100,"Sub-basin 1"
2960,200,2,1600,1800,"Sub-basin 1"
2961,600,16,3700,4300,"Sub-basin 1"
2962,800,16,3300,4100,"Sub-basin 1"
2963,4600,413,23000,27600,"Sub-basin 1"
2964,100,3,1100,1200,"Sub-basin 1"
2965,74200,18533.5,104600,178800,"Sub-basin 1"
2966,11400,4671,10100,21500,"Sub-basin 1"
2967,300,10,2300,2600,"Sub-basin 1"
2968,1800,113,8900,10700,"Sub-basin 1"
2969,400,14,3500,3900,"Sub-basin 1"
2970,1700,143,6300,8000,"Sub-basin 1"
2971,2700,82,9300,12000,"Sub-basin 1"
2972,200,7,1200,1400,"Sub-basin 1"
2973,100,2,300,400,"Sub-basin 1"
2974,500,20,5100,5600,"Sub-basin 1"
2975,300,14,2800,3100,"Sub-basin 1"
2976,1500,99,9600,11100,"Sub-basin 1"
2977,200,4,3500,3700,"Sub-basin 1"
2978,400,14,2100,2500,"Sub-basin 1"
2979,200,5,2200,2400,"Sub-basin 1"
2980,2300,429,7200,9500,"Sub-basin 1"
2981,4100,296,8700,12800,"Sub-basin 1"
2982,200,6,2300,2500,"Sub-basin 1"
2983,100,2,500,600,"Sub-basin 1"
2984,300,8,2800,3100,"Sub-basin 1"
2985,100,2,500,600,"Sub-basin 1"
2986,8200,326,35200,43400,"Sub-basin 1"
2987,100,1,1700,1800,"Sub-basin 1"
2988,1400,140,5500,6900,"Sub-basin 1"
2989,3000,316,16100,19100,"Sub-basin 1"
2990,100,3,600,700,"Sub-basin 1"
2991,100,1,500,600,"Sub-basin 1"
2992,300,10,5800,6100,"Sub-basin 1"
2993,200,3,2400,2600,"Sub-basin 1"
2994,100,3,1700,1800,"Sub-basin 1"
2995,400,29,1900,2300,"Sub-basin 1"
2996,600,45,3300,3900,"Sub-basin 1"
2997,900,56,9400,10300,"Sub-basin 1"
2998,1000,23,12000,13000,"Sub-basin 1"
2999,200,6,4100,4300,"Sub-basin 1"
3000,3800,141,12600,16400,"Sub-basin 1"
3001,100,3,400,500,"Sub-basin 1"
3002,300,12,3200,3500,"Sub-basin 1"
3003,200,3,1200,1400,"Sub-basin 1"
3004,300,15,3200,3500,"Sub-basin 1"
3005,200,2,2500,2700,"Sub-basin 1"
3006,2100,608,4500,6600,"Sub-basin 1"
3007,15500,588,30500,46000,"Sub-basin 1"
3008,100,3,400,500,"Sub-basin 1"
3009,100,3,1000,1100,"Sub-basin 1"
3010,1100,146,4200,5300,"Sub-basin 1"
3011,100,1,700,800,"Sub-basin 1"
3012,1000,23,4200,5200,"Sub-basin 1"
3013,11600,962,61000,72600,"Sub-basin 1"
3014,400,18,2800,3200,"Sub-basin 1"
3015,1100,14,8100,9200,"Sub-basin 1"
3016,100,1,1800,1900,"Sub-basin 1"
3017,400,10,2300,2700,"Sub-basin 1"
3018,100,4,1500,1600,"Sub-basin 1"
3019,3100,227,9300,12400,"Sub-basin 1"
3020,100,26,1000,1100,"Sub-basin 1"
3021,1900,127,9700,11600,"Sub-basin 1"
3022,300,6,2400,2700,"Sub-basin 1"
3023,100,1,400,500,"Sub-basin 1"
3024,100,1,1000,1100,"Sub-basin 1"
3025,100,1,3000,3100,"Sub-basin 1"
3026,400,18,2800,3200,"Sub-basin 1"
3027,1300,38,7600,8900,"Sub-basin 1"
3028,100,3,1500,1600,"Sub-basin 1"
3029,100,2,900,1000,"Sub-basin 1"
3030,7700,770,36200,43900,"Sub-basin 1"
3031,3500,295,9300,12800,"Sub-basin 1"
3032,100,3,1100,1200,"Sub-basin 1"
3033,9100,1204,17400,26500,"Sub-basin 1"
3034,1800,90,7500,9300,"Sub-basin 1"
3035,900,34,4600,5500,"Sub-basin 1"
3036,22100,1125,33000,55100,"Sub-basin 1"
3037,100,1,2100,2200,"Sub-basin 1"
3038,300,9,3100,3400,"Sub-basin 1"
3039,200,3,3400,3600,"Sub-basin 1"
3040,300,3,3400,3700,"Sub-basin 1"
3041,41200,3105,50500,91700,"Sub-basin 1"
3042,100,5,1200,1300,"Sub-basin 1"
3043,4600,1144,8300,12900,"Sub-basin 1"
3044,1100,231,7800,8900,"Sub-basin 1"
3045,600,35,8400,9000,"Sub-basin 1"
3046,500,16,4900,5400,"Sub-basin 1"
3047,1700,140,6300,8000,"Sub-basin 1"
3048,100,2,2400,2500,"Sub-basin 1"
3049,12700,815,24400,37100,"Sub-basin 1"
3050,300,9,3600,3900,"Sub-basin 1"
3051,100,2,1500,1600,"Sub-basin 1"
3052,500,33,3400,3900,"Sub-basin 1"
3053,200,5,900,1100,"Sub-basin 1"
3054,2400,253,13300,15700,"Sub-basin 1"
3055,600,40,2800,3400,"Sub-basin 1"
3056,2600,74,9400,12000,"Sub-basin 1"
3057,11900,1443,29900,41800,"Sub-basin 1"
3058,300,7,2400,2700,"Sub-basin 1"
3059,200,4,3400,3600,"Sub-basin 1"
3060,400,10,3500,3900,"Sub-basin 1"
3061,2300,46,12600,14900,"Sub-basin 1"
3062,100,1.83,1100,1200,"Sub-basin 1"
3063,400,19,7000,7400,"Sub-basin 1"
3064,400,35,2300,2700,"Sub-basin 1"
3065,73100,5143,91400,164500,"Sub-basin 1"
3066,500,49,2000,2500,"Sub-basin 1"
3067,700,48,2700,3400,"Sub-basin 1"
3068,5900,3618,14500,20400,"Sub-basin 1"
3069,200,2,2300,2500,"Sub-basin 1"
3070,100,4,1300,1400,"Sub-basin 1"
3071,3400,214,45100,48500,"Sub-basin 1"
3072,600,17,5700,6300,"Sub-basin 1"
3073,200,5,2300,2500,"Sub-basin 1"
3074,900,117,7300,8200,"Sub-basin 1"
3075,1900,85,12100,14000,"Sub-basin 1"
3076,100,3,900,1000,"Sub-basin 1"
3077,100,1,500,600,"Sub-basin 1"
3078,6400,137.66,12200,18600,"Sub-basin 1"
3079,4200,171,21900,26100,"Sub-basin 1"
3080,5600,359,22700,28300,"Sub-basin 1"
3081,100,2,1700,1800,"Sub-basin 1"
3082,400,8,9100,9500,"Sub-basin 1"
3083,5200,537,14700,19900,"Sub-basin 1"
3084,200,6,2400,2600,"Sub-basin 1"
3085,100,5,800,900,"Sub-basin 1"
3086,6100,616,33400,39500,"Sub-basin 1"
3087,200,5,700,900,"Sub-basin 1"
3088,700,107,2300,3000,"Sub-basin 1"
3089,100,1,1200,1300,"Sub-basin 1"
3090,1300,68,15100,16400,"Sub-basin 1"
3091,800,19,2400,3200,"Sub-basin 1"
3092,2500,117,31500,34000,"Sub-basin 1"
3093,21000,6880,18600,39600,"Sub-basin 1"
3094,300,11,1200,1500,"Sub-basin 1"
3095,100,2,1700,1800,"Sub-basin 1"
3096,800,44,4700,5500,"Sub-basin 1"
3097,100,1,800,900,"Sub-basin 1"
3098,900,22,5400,6300,"Sub-basin 1"
3099,200,4,3400,3600,"Sub-basin 1"
3100,210900,64661.67,216400,427300,"Sub-basin 1"
3101,100,1,700,800,"Sub-basin 1"
3102,8400,708,34200,42600,"Sub-basin 1"
3103,2900,213,20000,22900,"Sub-basin 1"
3104,100,3,1200,1300,"Sub-basin 1"
3105,400,13,3500,3900,"Sub-basin 1"
3106,100,2,900,1000,"Sub-basin 1"
3107,100,3,1000,1100,"Sub-basin 1"
3108,100,1,1800,1900,"Sub-basin 1"
3109,700,16,4200,4900,"Sub-basin 1"
3110,200,4,2400,2600,"Sub-basin 1"
3111,100,3,1200,1300,"Sub-basin 1"
3112,400,24,4100,4500,"Sub-basin 1"
3113,900,232,1300,2200,"Sub-basin 1"
3114,400,11,1600,2000,"Sub-basin 1"
3115,900,17,3700,4600,"Sub-basin 1"
3116,9700,469,30500,40200,"Sub-basin 1"
3117,100,2,500,600,"Sub-basin 1"
3118,500,29,4100,4600,"Sub-basin 1"
3119,100,2,3000,3100,"Sub-basin 1"
3120,8900,829,12800,21700,"Sub-basin 1"
3121,300,31,3000,3300,"Sub-basin 1"
3122,100,1,2600,2700,"Sub-basin 1"
3123,300,5,4200,4500,"Sub-basin 1"
3124,100,3,600,700,"Sub-basin 1"
3125,1300,79,11100,12400,"Sub-basin 1"
3126,100,4,900,1000,"Sub-basin 1"
3127,200,6,800,1000,"Sub-basin 1"
3128,1700,154,17000,18700,"Sub-basin 1"
3129,400,10,1800,2200,"Sub-basin 1"
3130,3500,105,11500,15000,"Sub-basin 1"
3131,100,4,600,700,"Sub-basin 1"
3132,100,2,1500,1600,"Sub-basin 1"
3133,100,1,2000,2100,"Sub-basin 1"
3134,4700,975,10700,15400,"Sub-basin 1"
3135,300,10,2700,3000,"Sub-basin 1"
3136,100,1,1800,1900,"Sub-basin 1"
3137,2900,211,22800,25700,"Sub-basin 1"
3138,400,44,5800,6200,"Sub-basin 1"
3139,3900,487,5300,9200,"Sub-basin 1"
3140,2700,99,11400,14100,"Sub-basin 1"
3141,100,2,800,900,"Sub-basin 1"
3142,300,9,2300,2600,"Sub-basin 1"
3143,100,1,700,800,"Sub-basin 1"
3144,6500,329,30800,37300,"Sub-basin 1"
3145,100,3,700,800,"Sub-basin 1"
3146,84900,10947.33,103300,188200,"Sub-basin 1"
3147,700,100,2500,3200,"Sub-basin 1"
3148,100,1,1000,1100,"Sub-basin 1"
3149,300,5,1100,1400,"Sub-basin 1"
3150,300,12,6100,6400,"Sub-basin 1"
3151,100,1,0,100,"Sub-basin 1"
3152,112800,5387,147300,260100,"Sub-basin 1"
3153,100,1,800,900,"Sub-basin 1"
3154,200,14,4500,4700,"Sub-basin 1"
3155,100,1,900,1000,"Sub-basin 1"
3156,700,30,1800,2500,"Sub-basin 1"
3157,200,11,1500,1700,"Sub-basin 1"
3158,100,1,1000,1100,"Sub-basin 1"
3159,400,10,4900,5300,"Sub-basin 1"
3160,600,34,7000,7600,"Sub-basin 1"
3161,100,1,2500,2600,"Sub-basin 1"
3162,200,4,5100,5300,"Sub-basin 1"
3163,100,1,1700,1800,"Sub-basin 1"
3164,400,6,5700,6100,"Sub-basin 1"
3165,100,2,1900,2000,"Sub-basin 1"
3166,600,19,4500,5100,"Sub-basin 1"
3167,2000,83,13000,15000,"Sub-basin 1"
3168,300,7,5900,6200,"Sub-basin 1"
3169,500,14,6800,7300,"Sub-basin 1"
3170,200,5,3800,4000,"Sub-basin 1"
3171,100,2,2300,2400,"Sub-basin 1"
3172,100,1,1300,1400,"Sub-basin 1"
3173,200,8,4500,4700,"Sub-basin 1"
3174,1400,62,7800,9200,"Sub-basin 1"
3175,2000,225,4500,6500,"Sub-basin 1"
3176,100,1,700,800,"Sub-basin 1"
3177,100,1,1200,1300,"Sub-basin 1"
3178,200,3,3900,4100,"Sub-basin 1"
3179,100,1,1800,1900,"Sub-basin 1"
3180,100,4,1700,1800,"Sub-basin 1"
3181,200,4,1200,1400,"Sub-basin 1"
3182,200,5,2500,2700,"Sub-basin 1"
3183,400,21,3900,4300,"Sub-basin 1"
3184,900,57,4200,5100,"Sub-basin 1"
3185,6400,198,20100,26500,"Sub-basin 1"
3186,400,26,4100,4500,"Sub-basin 1"
3187,100,1,2200,2300,"Sub-basin 1"
3188,700,105,500,1200,"Sub-basin 1"
3189,3600,148,8500,12100,"Sub-basin 1"
3190,100,2,800,900,"Sub-basin 1"
3191,100,1,1500,1600,"Sub-basin 1"
3192,800,45,2800,3600,"Sub-basin 1"
3193,200,3,3600,3800,"Sub-basin 1"
3194,600,32,13500,14100,"Sub-basin 1"
3195,10100,674,28900,39000,"Sub-basin 1"
3196,1200,38,11500,12700,"Sub-basin 1"
3197,500,37,5900,6400,"Sub-basin 1"
3198,200,5,2500,2700,"Sub-basin 1"
3199,200,8,2500,2700,"Sub-basin 1"
3200,900,54,5900,6800,"Sub-basin 1"
3201,100,4,400,500,"Sub-basin 1"
3202,100,3,300,400,"Sub-basin 1"
3203,100,2,1800,1900,"Sub-basin 1"
3204,100,1,1800,1900,"Sub-basin 1"
3205,100,3,1700,1800,"Sub-basin 1"
3206,100,4,1400,1500,"Sub-basin 1"
3207,500,23,4100,4600,"Sub-basin 1"
3208,2600,227,7500,10100,"Sub-basin 1"
3209,100,1,600,700,"Sub-basin 1"
3210,200,3,800,1000,"Sub-basin 1"
3211,900,21,2500,3400,"Sub-basin 1"
3212,1200,24,2800,4000,"Sub-basin 1"
3213,1500,105,9800,11300,"Sub-basin 1"
3214,300,9,5800,6100,"Sub-basin 1"
3215,200,3,3000,3200,"Sub-basin 1"
3216,200,3,2200,2400,"Sub-basin 1"
3217,100,2,300,400,"Sub-basin 1"
3218,6800,249,15000,21800,"Sub-basin 1"
3219,1400,195,6900,8300,"Sub-basin 1"
3220,600,29,6300,6900,"Sub-basin 1"
3221,100,1,1200,1300,"Sub-basin 1"
3222,100,1,700,800,"Sub-basin 1"
3223,200,3,900,1100,"Sub-basin 1"
3224,1300,148,7500,8800,"Sub-basin 1"
3225,16700,1404,61200,77900,"Sub-basin 1"
3226,900,114,4600,5500,"Sub-basin 1"
3227,100,1,800,900,"Sub-basin 1"
3228,1100,34,3400,4500,"Sub-basin 1"
3229,500,13,5500,6000,"Sub-basin 1"
3230,300,9,5900,6200,"Sub-basin 1"
3231,1100,35,6300,7400,"Sub-basin 1"
3232,700,21,6500,7200,"Sub-basin 1"
3233,6300,324,19600,25900,"Sub-basin 1"
3234,100,2,2600,2700,"Sub-basin 1"
3235,200,7,3500,3700,"Sub-basin 1"
3236,500,16,2000,2500,"Sub-basin 1"
3237,700,29,3600,4300,"Sub-basin 1"
3238,2700,115,4900,7600,"Sub-basin 1"
3239,200,6,900,1100,"Sub-basin 1"
3240,2700,246,29900,32600,"Sub-basin 1"
3241,100,4,2100,2200,"Sub-basin 1"
3242,16000,1158,33600,49600,"Sub-basin 1"
3243,100,2,2200,2300,"Sub-basin 1"
3244,100,2,2300,2400,"Sub-basin 1"
3245,100,1,1100,1200,"Sub-basin 1"
3246,100,5,2200,2300,"Sub-basin 1"
3247,1800,58,8400,10200,"Sub-basin 1"
3248,108500,10173.32,113300,221800,"Sub-basin 1"
3249,200,5,1300,1500,"Sub-basin 1"
3250,500,14,3300,3800,"Sub-basin 1"
3251,100,2,1000,1100,"Sub-basin 1"
3252,100,1,1900,2000,"Sub-basin 1"
3253,300,4,3000,3300,"Sub-basin 1"
3254,100,2,1700,1800,"Sub-basin 1"
3255,300,7,2800,3100,"Sub-basin 1"
3256,1900,324,3800,5700,"Sub-basin 1"
3257,200,2,1300,1500,"Sub-basin 1"
3258,9000,281,25900,34900,"Sub-basin 1"
3259,100,3,600,700,"Sub-basin 1"
3260,100,5,1000,1100,"Sub-basin 1"
3261,900,46,9900,10800,"Sub-basin 1"
3262,100,1,1800,1900,"Sub-basin 1"
3263,200,8,2000,2200,"Sub-basin 1"
3264,500,15,7100,7600,"Sub-basin 1"
3265,100,2,1400,1500,"Sub-basin 1"
3266,200,3,3400,3600,"Sub-basin 1"
3267,200,2,2700,2900,"Sub-basin 1"
3268,200,2,2100,2300,"Sub-basin 1"
3269,100,1,800,900,"Sub-basin 1"
3270,300,14,5500,5800,"Sub-basin 1"
3271,3400,158,9900,13300,"Sub-basin 1"
3272,4400,152,10500,14900,"Sub-basin 1"
3273,600,24,4200,4800,"Sub-basin 1"
3274,200,7,2700,2900,"Sub-basin 1"
3275,4200,248,25900,30100,"Sub-basin 1"
3276,200,6,2600,2800,"Sub-basin 1"
3277,500,12,1400,1900,"Sub-basin 1"
3278,300,17,4300,4600,"Sub-basin 1"
3279,900,55,10000,10900,"Sub-basin 1"
3280,100,5,500,600,"Sub-basin 1"
3281,600,19,8300,8900,"Sub-basin 1"
3282,100,2,2200,2300,"Sub-basin 1"
3283,600,123,2900,3500,"Sub-basin 1"
3284,100,2,1600,1700,"Sub-basin 1"
3285,100,2,2600,2700,"Sub-basin 1"
3286,100,1,1700,1800,"Sub-basin 1"
3287,200,4,3300,3500,"Sub-basin 1"
3288,3000,280,9200,12200,"Sub-basin 1"
3289,2200,324,6100,8300,"Sub-basin 1"
3290,100,2,1300,1400,"Sub-basin 1"
3291,400,9,5900,6300,"Sub-basin 1"
3292,100,1,900,1000,"Sub-basin 1"
3293,600,19,9100,9700,"Sub-basin 1"
3294,1700,161,5500,7200,"Sub-basin 1"
3295,200,7,1700,1900,"Sub-basin 1"
3296,800,19,5700,6500,"Sub-basin 1"
3297,2100,220,9300,11400,"Sub-basin 1"
3298,700,56,4100,4800,"Sub-basin 1"
3299,2800,217,9000,11800,"Sub-basin 1"
3300,100,3,2100,2200,"Sub-basin 1"
3301,5600,269,15200,20800,"Sub-basin 1"
3302,7500,216.67,22000,29500,"Sub-basin 1"
3303,100,6,200,300,"Sub-basin 1"
3304,3200,139,24700,27900,"Sub-basin 1"
3305,400,30,3900,4300,"Sub-basin 1"
3306,1400,97,13700,15100,"Sub-basin 1"
3307,2400,99,8400,10800,"Sub-basin 1"
3308,100,1,2100,2200,"Sub-basin 1"
3309,200,4,2400,2600,"Sub-basin 1"
3310,200,17,1300,1500,"Sub-basin 1"
3311,500,17,6800,7300,"Sub-basin 1"
3312,100,1,1300,1400,"Sub-basin 1"
3313,100,3,1200,1300,"Sub-basin 1"
3314,600,56,6400,7000,"Sub-basin 1"
3315,100,1,1700,1800,"Sub-basin 1"
3316,400,18,1200,1600,"Sub-basin 1"
3317,400,34,2900,3300,"Sub-basin 1"
3318,100,1,1000,1100,"Sub-basin 1"
3319,3200,82,7900,11100,"Sub-basin 1"
3320,1400,162,4000,5400,"Sub-basin 1"
3321,300,11,2800,3100,"Sub-basin 1"
3322,200,9,1500,1700,"Sub-basin 1"
3323,500,10,3000,3500,"Sub-basin 1"
3324,2000,98,10900,12900,"Sub-basin 1"
3325,200,6,3000,3200,"Sub-basin 1"
3326,800,72,4400,5200,"Sub-basin 1"
3327,300,20,3700,4000,"Sub-basin 1"
3328,800,27,5300,6100,"Sub-basin 1"
3329,100,1,2700,2800,"Sub-basin 1"
3330,9300,458,14500,23800,"Sub-basin 1"
3331,400,25,4700,5100,"Sub-basin 1"
3332,1600,140,14600,16200,"Sub-basin 1"
3333,200,8,2000,2200,"Sub-basin 1"
3334,400,21,2700,3100,"Sub-basin 1"
3335,5700,234,13700,19400,"Sub-basin 1"
3336,100,1,600,700,"Sub-basin 1"
3337,2300,153,17600,19900,"Sub-basin 1"
3338,1900,174,9300,11200,"Sub-basin 1"
3339,5700,384,10600,16300,"Sub-basin 1"
3340,500,34,2800,3300,"Sub-basin 1"
3341,100,1,500,600,"Sub-basin 1"
3342,3100,226,16900,20000,"Sub-basin 1"
3343,200,5,2200,2400,"Sub-basin 1"
3344,9000,651,19800,28800,"Sub-basin 1"
3345,100,1,400,500,"Sub-basin 1"
3346,100,2,1000,1100,"Sub-basin 1"
3347,100,1,1200,1300,"Sub-basin 1"
3348,700,54,2300,3000,"Sub-basin 1"
3349,2900,169,9500,12400,"Sub-basin 1"
3350,200,20,2100,2300,"Sub-basin 1"
3351,100,2,1000,1100,"Sub-basin 1"
3352,100,1,700,800,"Sub-basin 1"
3353,100,4,900,1000,"Sub-basin 1"
3354,200,12,2300,2500,"Sub-basin 1"
3355,400,12,1600,2000,"Sub-basin 1"
3356,500,38,4600,5100,"Sub-basin 1"
3357,1100,86,8600,9700,"Sub-basin 1"
3358,4400,168,11500,15900,"Sub-basin 1"
3359,200,7,2800,3000,"Sub-basin 1"
3360,200,11,2100,2300,"Sub-basin 1"
3361,400,10,1800,2200,"Sub-basin 1"
3362,5800,318.83,15400,21200,"Sub-basin 1"
3363,600,15,2900,3500,"Sub-basin 1"
3364,200,3,1200,1400,"Sub-basin 1"
3365,100,2,900,1000,"Sub-basin 1"
3366,2500,140,15800,18300,"Sub-basin 1"
3367,2300,380,10000,12300,"Sub-basin 1"
3368,300,4,1400,1700,"Sub-basin 1"
3369,3000,98,11200,14200,"Sub-basin 1"
3370,3100,351,13900,17000,"Sub-basin 1"
3371,400,8,5000,5400,"Sub-basin 1"
3372,600,44,4000,4600,"Sub-basin 1"
3373,8100,482,15200,23300,"Sub-basin 1"
3374,15000,4126,24300,39300,"Sub-basin 1"
3375,600,18,2200,2800,"Sub-basin 1"
3376,200,7,1700,1900,"Sub-basin 1"
3377,500,28,5700,6200,"Sub-basin 1"
3378,300,25,800,1100,"Sub-basin 1"
3379,300,3,2700,3000,"Sub-basin 1"
3380,900,112,8300,9200,"Sub-basin 1"
3381,400,31,1300,1700,"Sub-basin 1"
3382,3000,264,12000,15000,"Sub-basin 1"
3383,6600,239,59400,66000,"Sub-basin 1"
3384,2000,97,5700,7700,"Sub-basin 1"
3385,3900,283,6600,10500,"Sub-basin 1"
3386,300,20,4000,4300,"Sub-basin 1"
3387,200,12,3000,3200,"Sub-basin 1"
3388,100,1,1000,1100,"Sub-basin 1"
3389,100,1,800,900,"Sub-basin 1"
3390,15000,1130,25600,40600,"Sub-basin 1"
3391,7700,555,30600,38300,"Sub-basin 1"
3392,700,24,3500,4200,"Sub-basin 1"
3393,600,25,3500,4100,"Sub-basin 1"
3394,1800,102,13900,15700,"Sub-basin 1"
3395,1800,77,13000,14800,"Sub-basin 1"
3396,100,1,1500,1600,"Sub-basin 1"
3397,600,13,10200,10800,"Sub-basin 1"
3398,16700,1796,65200,81900,"Sub-basin 1"
3399,1900,50,8400,10300,"Sub-basin 1"
3400,500,15,5300,5800,"Sub-basin 1"
3401,100,2,1900,2000,"Sub-basin 1"
3402,100,3,2200,2300,"Sub-basin 1"
3403,200,2,3600,3800,"Sub-basin 1"
3404,2500,289,11200,13700,"Sub-basin 1"
3405,200,5,2700,2900,"Sub-basin 1"
3406,300,7,3500,3800,"Sub-basin 1"
3407,1000,54,8600,9600,"Sub-basin 1"
3408,200,2,2500,2700,"Sub-basin 1"
3409,1000,23,5500,6500,"Sub-basin 1"
3410,100,2,3600,3700,"Sub-basin 1"
3411,200,4,3300,3500,"Sub-basin 1"
3412,100,1,500,600,"Sub-basin 1"
3413,19500,1271.5,43900,63400,"Sub-basin 1"
3414,100,4,1600,1700,"Sub-basin 1"
3415,700,71,1400,2100,"Sub-basin 1"
3416,100,1,2000,2100,"Sub-basin 1"
3417,400,23,6300,6700,"Sub-basin 1"
3418,100,1,2900,3000,"Sub-basin 1"
3419,200,5,2300,2500,"Sub-basin 1"
3420,100,2,600,700,"Sub-basin 1"
3421,200,19,1700,1900,"Sub-basin 1"
3422,300,15,1500,1800,"Sub-basin 1"
3423,300,8,3800,4100,"Sub-basin 1"
3424,100,1,600,700,"Sub-basin 1"
3425,100,3,1700,1800,"Sub-basin 1"
3426,100,3,1000,1100,"Sub-basin 1"
3427,600,54,4800,5400,"Sub-basin 1"
3428,800,135,1400,2200,"Sub-basin 1"
3429,2000,344,5600,7600,"Sub-basin 1"
3430,500,28,3800,4300,"Sub-basin 1"
3431,100,1,2800,2900,"Sub-basin 1"
3432,1200,136,5900,7100,"Sub-basin 1"
3433,200,7,100,300,"Sub-basin 1"
3434,1300,125,2800,4100,"Sub-basin 1"
3435,100,1,2800,2900,"Sub-basin 1"
3436,100,1,1400,1500,"Sub-basin 1"
3437,1300,127,4500,5800,"Sub-basin 1"
3438,300,6,4100,4400,"Sub-basin 1"
3439,100,2,600,700,"Sub-basin 1"
3440,800,93,4600,5400,"Sub-basin 1"
3441,100,1,700,800,"Sub-basin 1"
3442,200,13,1200,1400,"Sub-basin 1"
3443,2000,84,2800,4800,"Sub-basin 1"
3444,1000,47,7900,8900,"Sub-basin 1"
3445,100,3,2100,2200,"Sub-basin 1"
3446,300,22,2700,3000,"Sub-basin 1"
3447,300,17,2100,2400,"Sub-basin 1"
3448,2300,211,9200,11500,"Sub-basin 1"
3449,14400,1152,33100,47500,"Sub-basin 1"
3450,300,13,5200,5500,"Sub-basin 1"
3451,600,19,12900,13500,"Sub-basin 1"
3452,200,6,1800,2000,"Sub-basin 1"
3453,800,82,2100,2900,"Sub-basin 1"
3454,2000,123,17400,19400,"Sub-basin 1"
3455,100,6,2900,3000,"Sub-basin 1"
3456,400,13,4500,4900,"Sub-basin 1"
3457,5000,400,21300,26300,"Sub-basin 1"
3458,700,48,3100,3800,"Sub-basin 1"
3459,200,4,2500,2700,"Sub-basin 1"
3460,100,1,1900,2000,"Sub-basin 1"
3461,200,17,2200,2400,"Sub-basin 1"
3462,600,24,12500,13100,"Sub-basin 1"
3463,100,2,1100,1200,"Sub-basin 1"
3464,1900,146,4200,6100,"Sub-basin 1"
3465,600,20,4500,5100,"Sub-basin 1"
3466,200,8,1500,1700,"Sub-basin 1"
3467,100,1,300,400,"Sub-basin 1"
3468,300,7,2000,2300,"Sub-basin 1"
3469,200,11,1500,1700,"Sub-basin 1"
3470,200,6,4500,4700,"Sub-basin 1"
3471,100,2,1700,1800,"Sub-basin 1"
3472,1000,64,10900,11900,"Sub-basin 1"
3473,100,2,1800,1900,"Sub-basin 1"
3474,300,15,4200,4500,"Sub-basin 1"
3475,200,10,1600,1800,"Sub-basin 1"
3476,300,9,1300,1600,"Sub-basin 1"
3477,800,126,10500,11300,"Sub-basin 1"
3478,400,21,3000,3400,"Sub-basin 1"
3479,2400,156,25000,27400,"Sub-basin 1"
3480,200,3,2800,3000,"Sub-basin 1"
3481,100,2,1800,1900,"Sub-basin 1"
3482,1500,120,11600,13100,"Sub-basin 1"
3483,100,2,1500,1600,"Sub-basin 1"
3484,500,26,2900,3400,"Sub-basin 1"
3485,9100,514,62800,71900,"Sub-basin 1"
3486,1600,137,7400,9000,"Sub-basin 1"
3487,100,1,1100,1200,"Sub-basin 1"
3488,1200,81,12700,13900,"Sub-basin 1"
3489,1300,286,16300,17600,"Sub-basin 1"
3490,2300,803,15600,17900,"Sub-basin 1"
3491,100,8,2100,2200,"Sub-basin 1"
3492,2600,107,8300,10900,"Sub-basin 1"
3493,2100,207,13800,15900,"Sub-basin 1"
3494,800,84,10100,10900,"Sub-basin 1"
3495,600,32,2200,2800,"Sub-basin 1"
3496,1200,64,9300,10500,"Sub-basin 1"
3497,600,49,5300,5900,"Sub-basin 1"
3498,400,5,4800,5200,"Sub-basin 1"
3499,400,15,800,1200,"Sub-basin 1"
3500,900,75,4500,5400,"Sub-basin 1"
3501,400,34,1100,1500,"Sub-basin 1"
3502,400,10,1600,2000,"Sub-basin 1"
3503,300,3,5400,5700,"Sub-basin 1"
3504,300,3,4500,4800,"Sub-basin 1"
3505,100,3,1000,1100,"Sub-basin 1"
3506,500,11,4900,5400,"Sub-basin 1"
3507,200,7,1800,2000,"Sub-basin 1"
3508,1900,221,18400,20300,"Sub-basin 1"
3509,16500,961,21600,38100,"Sub-basin 1"
3510,100,2,2000,2100,"Sub-basin 1"
3511,3700,375,19600,23300,"Sub-basin 1"
3512,1600,163,16300,17900,"Sub-basin 1"
3513,1900,116,10200,12100,"Sub-basin 1"
3514,200,5,800,1000,"Sub-basin 1"
3515,200,2,3500,3700,"Sub-basin 1"
3516,800,17,5000,5800,"Sub-basin 1"
3517,100,1,700,800,"Sub-basin 1"
3518,100,2,1200,1300,"Sub-basin 1"
3519,200,18,1400,1600,"Sub-basin 1"
3520,300,11,4600,4900,"Sub-basin 1"
3521,600,20,6400,7000,"Sub-basin 1"
3522,300,6,4600,4900,"Sub-basin 1"
3523,5600,801,22100,27700,"Sub-basin 1"
3524,400,273.3896,2000,2400,"Sub-basin 1"
3525,5600,345,9600,15200,"Sub-basin 1"
3526,1100,38,5400,6500,"Sub-basin 1"
3527,900,101,6200,7100,"Sub-basin 1"
3528,100,2,1200,1300,"Sub-basin 1"
3529,300,7,1800,2100,"Sub-basin 1"
3530,100,1,200,300,"Sub-basin 1"
3531,800,41,1900,2700,"Sub-basin 1"
3532,100,1,900,1000,"Sub-basin 1"
1,5600,1956,5300,10900,"Sub-basin 2"
2,7000,1715,14800,21800,"Sub-basin 2"
3,40200,16451.17,27100,67300,"Sub-basin 2"
4,1300,449,1900,3200,"Sub-basin 2"
5,400,64,400,800,"Sub-basin 2"
6,400,40,1400,1800,"Sub-basin 2"
7,1700,576,1600,3300,"Sub-basin 2"
8,3800,1125,4900,8700,"Sub-basin 2"
9,100,2,400,500,"Sub-basin 2"
10,9500,4935,8600,18100,"Sub-basin 2"
11,4300,1395,6300,10600,"Sub-basin 2"
12,100,2,1000,1100,"Sub-basin 2"
13,5200,2110,6000,11200,"Sub-basin 2"
14,400,30,2900,3300,"Sub-basin 2"
15,100,3,900,1000,"Sub-basin 2"
16,2700,836,7400,10100,"Sub-basin 2"
17,600,29,1300,1900,"Sub-basin 2"
18,400,27,1200,1600,"Sub-basin 2"
19,1300,283,2500,3800,"Sub-basin 2"
20,400,55,2000,2400,"Sub-basin 2"
21,300,60,600,900,"Sub-basin 2"
22,100,2,1200,1300,"Sub-basin 2"
23,1100,132,1600,2700,"Sub-basin 2"
24,8200,2948,11400,19600,"Sub-basin 2"
25,42700,18380,35700,78400,"Sub-basin 2"
26,2000,489,4200,6200,"Sub-basin 2"
27,5500,1262,12200,17700,"Sub-basin 2"
28,600,71,2400,3000,"Sub-basin 2"
29,1800,845,1900,3700,"Sub-basin 2"
30,500,103,2900,3400,"Sub-basin 2"
31,300,10,3000,3300,"Sub-basin 2"
32,8900,3246,15200,24100,"Sub-basin 2"
33,1600,700,3200,4800,"Sub-basin 2"
34,4600,689,14600,19200,"Sub-basin 2"
35,500,70,3600,4100,"Sub-basin 2"
36,900,199,2100,3000,"Sub-basin 2"
37,300,49,1600,1900,"Sub-basin 2"
38,600,155,1300,1900,"Sub-basin 2"
39,1700,266,4100,5800,"Sub-basin 2"
40,800,264,2400,3200,"Sub-basin 2"
41,600,84,5300,5900,"Sub-basin 2"
42,800,168,1400,2200,"Sub-basin 2"
43,1800,556,4100,5900,"Sub-basin 2"
44,3200,889,7300,10500,"Sub-basin 2"
45,100,1,400,500,"Sub-basin 2"
46,400,78,600,1000,"Sub-basin 2"
47,500,39,2000,2500,"Sub-basin 2"
48,1100,184,1200,2300,"Sub-basin 2"
49,700,135,3400,4100,"Sub-basin 2"
50,136000,64721,103200,239200,"Sub-basin 2"
51,25800,10193,22400,48200,"Sub-basin 2"
52,1500,338,2700,4200,"Sub-basin 2"
53,102300,62488.5,102300,204600,"Sub-basin 2"
54,300,14,400,700,"Sub-basin 2"
55,3000,793,4600,7600,"Sub-basin 2"
56,100,14,500,600,"Sub-basin 2"
57,1200,250.67,4200,5400,"Sub-basin 2"
58,7600,4025,16000,23600,"Sub-basin 2"
59,11800,5582,20700,32500,"Sub-basin 2"
60,2200,635,5500,7700,"Sub-basin 2"
61,100,7,1000,1100,"Sub-basin 2"
62,4600,1644,8700,13300,"Sub-basin 2"
63,5300,2054,11900,17200,"Sub-basin 2"
64,600,81,1300,1900,"Sub-basin 2"
65,200,20,1300,1500,"Sub-basin 2"
66,35200,22296,35200,70400,"Sub-basin 2"
67,300,23,1000,1300,"Sub-basin 2"
68,300,16,1000,1300,"Sub-basin 2"
69,800,121,1800,2600,"Sub-basin 2"
70,11800,4420,24700,36500,"Sub-basin 2"
71,500,60,1800,2300,"Sub-basin 2"
72,200,17,1600,1800,"Sub-basin 2"
73,3000,457,9900,12900,"Sub-basin 2"
74,400,118,1400,1800,"Sub-basin 2"
75,100,1,100,200,"Sub-basin 2"
76,200,19,1300,1500,"Sub-basin 2"
77,7400,2933,9800,17200,"Sub-basin 2"
78,300,23,2300,2600,"Sub-basin 2"
79,2300,849,3400,5700,"Sub-basin 2"
80,2300,162,10100,12400,"Sub-basin 2"
81,1200,365,3200,4400,"Sub-basin 2"
82,400,28,800,1200,"Sub-basin 2"
83,200,4,1600,1800,"Sub-basin 2"
84,69900,26164,61600,131500,"Sub-basin 2"
85,200,10,1900,2100,"Sub-basin 2"
86,25400,6631,42300,67700,"Sub-basin 2"
87,1200,316,2500,3700,"Sub-basin 2"
88,3800,746,14200,18000,"Sub-basin 2"
89,400,74,1500,1900,"Sub-basin 2"
90,600,28,2300,2900,"Sub-basin 2"
91,1300,592,2600,3900,"Sub-basin 2"
92,900,277,1400,2300,"Sub-basin 2"
93,100,1,500,600,"Sub-basin 2"
94,200,10,900,1100,"Sub-basin 2"
95,10900,5155,22400,33300,"Sub-basin 2"
96,400,128,1500,1900,"Sub-basin 2"
97,800,101,3300,4100,"Sub-basin 2"
98,7900,1598,15000,22900,"Sub-basin 2"
99,400,35,800,1200,"Sub-basin 2"
100,600,121,1800,2400,"Sub-basin 2"
101,200,16,1000,1200,"Sub-basin 2"
102,4400,538,13500,17900,"Sub-basin 2"
103,46900,20568,49500,96400,"Sub-basin 2"
104,1000,206,2600,3600,"Sub-basin 2"
105,600,367,2600,3200,"Sub-basin 2"
106,100,3,1000,1100,"Sub-basin 2"
107,200,34,600,800,"Sub-basin 2"
108,400,24,2600,3000,"Sub-basin 2"
109,1300,404,3400,4700,"Sub-basin 2"
110,300,298,1400,1700,"Sub-basin 2"
111,400,93,2200,2600,"Sub-basin 2"
112,100,2,1300,1400,"Sub-basin 2"
113,49400,30457,48200,97600,"Sub-basin 2"
114,2600,1279,5400,8000,"Sub-basin 2"
115,400,63,1900,2300,"Sub-basin 2"
116,6700,2611,14800,21500,"Sub-basin 2"
117,200,8,1400,1600,"Sub-basin 2"
118,100,12,800,900,"Sub-basin 2"
119,1100,250,3500,4600,"Sub-basin 2"
120,600,105,2500,3100,"Sub-basin 2"
121,5900,1273,13200,19100,"Sub-basin 2"
122,100,7,1200,1300,"Sub-basin 2"
123,4200,1538,9800,14000,"Sub-basin 2"
124,1700,334,4700,6400,"Sub-basin 2"
125,400,20,700,1100,"Sub-basin 2"
126,600,117,1800,2400,"Sub-basin 2"
127,300,31,1600,1900,"Sub-basin 2"
128,1900,617,3700,5600,"Sub-basin 2"
129,200,11,700,900,"Sub-basin 2"
130,200,4,2500,2700,"Sub-basin 2"
131,400,28,4200,4600,"Sub-basin 2"
132,5000,872,12500,17500,"Sub-basin 2"
133,5900,864.5,16400,22300,"Sub-basin 2"
134,1600,263,5200,6800,"Sub-basin 2"
135,1100,270,2500,3600,"Sub-basin 2"
136,300,19,1100,1400,"Sub-basin 2"
137,200,9,300,500,"Sub-basin 2"
138,100,3,1100,1200,"Sub-basin 2"
139,3000,941,2700,5700,"Sub-basin 2"
140,300,25,1700,2000,"Sub-basin 2"
141,1100,204,1200,2300,"Sub-basin 2"
142,1100,73,5300,6400,"Sub-basin 2"
143,800,53,2400,3200,"Sub-basin 2"
144,200,5,1300,1500,"Sub-basin 2"
145,3200,412,10500,13700,"Sub-basin 2"
146,300,18,1300,1600,"Sub-basin 2"
147,100,2,1700,1800,"Sub-basin 2"
148,2700,1258,4000,6700,"Sub-basin 2"
149,1300,229,4500,5800,"Sub-basin 2"
150,3300,621,7700,11000,"Sub-basin 2"
151,100,3,1200,1300,"Sub-basin 2"
152,100,3,400,500,"Sub-basin 2"
153,400,33,1600,2000,"Sub-basin 2"
154,100,2,800,900,"Sub-basin 2"
155,200,11,1300,1500,"Sub-basin 2"
156,300,11,1500,1800,"Sub-basin 2"
157,4100,1392,5400,9500,"Sub-basin 2"
158,600,115,1700,2300,"Sub-basin 2"
159,2000,459,4300,6300,"Sub-basin 2"
160,100,1,800,900,"Sub-basin 2"
161,4300,385,15900,20200,"Sub-basin 2"
162,500,100,600,1100,"Sub-basin 2"
163,800,277,1000,1800,"Sub-basin 2"
164,200,17,800,1000,"Sub-basin 2"
165,63200,22402.67,63300,126500,"Sub-basin 2"
166,3100,630,8600,11700,"Sub-basin 2"
167,800,78,1800,2600,"Sub-basin 2"
168,1200,338,4300,5500,"Sub-basin 2"
169,200,6,1500,1700,"Sub-basin 2"
170,2800,765,4700,7500,"Sub-basin 2"
171,900,307,2900,3800,"Sub-basin 2"
172,400,16,600,1000,"Sub-basin 2"
173,900,189,3300,4200,"Sub-basin 2"
174,700,143,3300,4000,"Sub-basin 2"
175,1800,455,5000,6800,"Sub-basin 2"
176,300,4,1400,1700,"Sub-basin 2"
177,700,83,2500,3200,"Sub-basin 2"
178,400,43,1700,2100,"Sub-basin 2"
179,1900,409,5200,7100,"Sub-basin 2"
180,200,19,1000,1200,"Sub-basin 2"
181,200,19,2500,2700,"Sub-basin 2"
182,100,6,800,900,"Sub-basin 2"
183,300,27,3100,3400,"Sub-basin 2"
184,3800,451,10400,14200,"Sub-basin 2"
185,1300,352,3100,4400,"Sub-basin 2"
186,2000,482,6000,8000,"Sub-basin 2"
187,47000,24031,46400,93400,"Sub-basin 2"
188,25500,10739,52600,78100,"Sub-basin 2"
189,400,21,700,1100,"Sub-basin 2"
190,600,173,2700,3300,"Sub-basin 2"
191,2200,722,3300,5500,"Sub-basin 2"
192,500,22,3400,3900,"Sub-basin 2"
193,2500,1558,4700,7200,"Sub-basin 2"
194,300,37,900,1200,"Sub-basin 2"
195,3800,812.5,10400,14200,"Sub-basin 2"
196,800,303,2200,3000,"Sub-basin 2"
197,100,1,600,700,"Sub-basin 2"
198,16300,6026,24000,40300,"Sub-basin 2"
199,600,29,3500,4100,"Sub-basin 2"
200,9400,3475,14200,23600,"Sub-basin 2"
201,100,4,1100,1200,"Sub-basin 2"
202,400,43,3200,3600,"Sub-basin 2"
203,100,2,1100,1200,"Sub-basin 2"
204,1100,340,2700,3800,"Sub-basin 2"
205,6500,1655,11800,18300,"Sub-basin 2"
206,2200,391,6100,8300,"Sub-basin 2"
207,100,2,200,300,"Sub-basin 2"
208,900,234,2400,3300,"Sub-basin 2"
209,200,8,2600,2800,"Sub-basin 2"
210,500,56,0,500,"Sub-basin 2"
211,100,6,1100,1200,"Sub-basin 2"
212,1200,231,3800,5000,"Sub-basin 2"
213,100,1,1000,1100,"Sub-basin 2"
214,3700,692,10300,14000,"Sub-basin 2"
215,100,2,1200,1300,"Sub-basin 2"
216,600,132,2200,2800,"Sub-basin 2"
217,400,62,2600,3000,"Sub-basin 2"
218,200,17,2600,2800,"Sub-basin 2"
219,100,3,700,800,"Sub-basin 2"
220,500,63,2800,3300,"Sub-basin 2"
221,1700,310,3800,5500,"Sub-basin 2"
222,900,258,6200,7100,"Sub-basin 2"
223,2900,576,10200,13100,"Sub-basin 2"
224,900,160,5200,6100,"Sub-basin 2"
225,400,33,3400,3800,"Sub-basin 2"
226,600,159,2300,2900,"Sub-basin 2"
227,400,12,800,1200,"Sub-basin 2"
228,100,2,800,900,"Sub-basin 2"
229,13000,4843,25200,38200,"Sub-basin 2"
230,100,1,700,800,"Sub-basin 2"
231,100,6,1000,1100,"Sub-basin 2"
232,500,59,2300,2800,"Sub-basin 2"
233,2000,592,3900,5900,"Sub-basin 2"
234,16200,6881.5,16300,32500,"Sub-basin 2"
235,600,177,3500,4100,"Sub-basin 2"
236,200,18,2900,3100,"Sub-basin 2"
237,800,151,2600,3400,"Sub-basin 2"
238,2500,660,5800,8300,"Sub-basin 2"
239,6400,2340,9300,15700,"Sub-basin 2"
240,100,7,1000,1100,"Sub-basin 2"
241,32800,9860,34100,66900,"Sub-basin 2"
242,100,7,300,400,"Sub-basin 2"
243,100,7,1400,1500,"Sub-basin 2"
244,9400,795,21500,30900,"Sub-basin 2"
245,100,3,600,700,"Sub-basin 2"
246,6300,2317,8600,14900,"Sub-basin 2"
247,300,18,2400,2700,"Sub-basin 2"
248,100,1,1000,1100,"Sub-basin 2"
249,3200,641,7600,10800,"Sub-basin 2"
250,1300,173,1800,3100,"Sub-basin 2"
251,1300,245,4600,5900,"Sub-basin 2"
252,1800,282,8600,10400,"Sub-basin 2"
253,400,50,3200,3600,"Sub-basin 2"
254,5200,911,18100,23300,"Sub-basin 2"
255,1700,493,3800,5500,"Sub-basin 2"
256,2600,630,10300,12900,"Sub-basin 2"
257,200,35,3200,3400,"Sub-basin 2"
258,700,79,3800,4500,"Sub-basin 2"
259,100,2,700,800,"Sub-basin 2"
260,1500,406,2900,4400,"Sub-basin 2"
261,2400,979.16,4400,6800,"Sub-basin 2"
262,200,5,1700,1900,"Sub-basin 2"
263,1900,107,12200,14100,"Sub-basin 2"
264,600,46,2300,2900,"Sub-basin 2"
265,100,3,800,900,"Sub-basin 2"
266,400,37,1000,1400,"Sub-basin 2"
267,500,51,2100,2600,"Sub-basin 2"
268,800,189,1600,2400,"Sub-basin 2"
269,200,10,1600,1800,"Sub-basin 2"
270,29800,9244,38100,67900,"Sub-basin 2"
271,400,22,1600,2000,"Sub-basin 2"
272,1400,307,4100,5500,"Sub-basin 2"
273,500,49,1800,2300,"Sub-basin 2"
274,1700,625,2100,3800,"Sub-basin 2"
275,6600,1836,11700,18300,"Sub-basin 2"
276,100,5,1300,1400,"Sub-basin 2"
277,2100,266,9700,11800,"Sub-basin 2"
278,300,15,1500,1800,"Sub-basin 2"
279,200,3,1100,1300,"Sub-basin 2"
280,20900,8633,21400,42300,"Sub-basin 2"
281,8900,3836,18200,27100,"Sub-basin 2"
282,200,7,600,800,"Sub-basin 2"
283,19600,10630,22600,42200,"Sub-basin 2"
284,16300,7509,14800,31100,"Sub-basin 2"
285,500,290,1500,2000,"Sub-basin 2"
286,600,52,5900,6500,"Sub-basin 2"
287,3000,1046,10900,13900,"Sub-basin 2"
288,1000,250,5800,6800,"Sub-basin 2"
289,4300,1613,7800,12100,"Sub-basin 2"
290,200,3,1300,1500,"Sub-basin 2"
291,4100,865,7700,11800,"Sub-basin 2"
292,100,2,1700,1800,"Sub-basin 2"
293,400,52,2000,2400,"Sub-basin 2"
294,2200,543,6300,8500,"Sub-basin 2"
295,900,143,4400,5300,"Sub-basin 2"
296,2000,501,6300,8300,"Sub-basin 2"
297,400,23,200,600,"Sub-basin 2"
298,300,12,1200,1500,"Sub-basin 2"
299,800,247,2300,3100,"Sub-basin 2"
300,700,155,2400,3100,"Sub-basin 2"
301,400,14,2400,2800,"Sub-basin 2"
302,400,23,1300,1700,"Sub-basin 2"
303,200,2,1200,1400,"Sub-basin 2"
304,1800,345,8700,10500,"Sub-basin 2"
305,4600,1309,10200,14800,"Sub-basin 2"
306,900,109,3000,3900,"Sub-basin 2"
307,3000,945,5000,8000,"Sub-basin 2"
308,100,1,800,900,"Sub-basin 2"
309,600,12,6900,7500,"Sub-basin 2"
310,400,14,4500,4900,"Sub-basin 2"
311,4500,2122,8500,13000,"Sub-basin 2"
312,200,5,1400,1600,"Sub-basin 2"
313,800,123,3600,4400,"Sub-basin 2"
314,20300,8230,24700,45000,"Sub-basin 2"
315,400,49,2800,3200,"Sub-basin 2"
316,600,51,5000,5600,"Sub-basin 2"
317,1500,291.17,4900,6400,"Sub-basin 2"
318,200,5,500,700,"Sub-basin 2"
319,900,275,2400,3300,"Sub-basin 2"
320,1700,666,2800,4500,"Sub-basin 2"
321,2000,314,7000,9000,"Sub-basin 2"
322,1800,173,8000,9800,"Sub-basin 2"
323,100,5,1000,1100,"Sub-basin 2"
324,1700,271.33,4800,6500,"Sub-basin 2"
325,900,159,8200,9100,"Sub-basin 2"
326,100,3,900,1000,"Sub-basin 2"
327,8600,2349,14800,23400,"Sub-basin 2"
328,2300,822,3700,6000,"Sub-basin 2"
329,200,30.66,1300,1500,"Sub-basin 2"
330,15200,3049,26400,41600,"Sub-basin 2"
331,100,1,900,1000,"Sub-basin 2"
332,400,33,800,1200,"Sub-basin 2"
333,400,29,2700,3100,"Sub-basin 2"
334,500,52,1200,1700,"Sub-basin 2"
335,500,42,1000,1500,"Sub-basin 2"
336,100,1,400,500,"Sub-basin 2"
337,100,2,1200,1300,"Sub-basin 2"
338,400,52,2800,3200,"Sub-basin 2"
339,600,85,1500,2100,"Sub-basin 2"
340,1200,226,2800,4000,"Sub-basin 2"
341,200,13,400,600,"Sub-basin 2"
342,25100,10599,34900,60000,"Sub-basin 2"
343,100,1,1100,1200,"Sub-basin 2"
344,5000,1289,10400,15400,"Sub-basin 2"
345,3100,336,18400,21500,"Sub-basin 2"
346,1500,355,4000,5500,"Sub-basin 2"
347,1400,307,2300,3700,"Sub-basin 2"
348,200,6,800,1000,"Sub-basin 2"
349,400,37,200,600,"Sub-basin 2"
350,5100,1879,9100,14200,"Sub-basin 2"
351,2700,1056,11000,13700,"Sub-basin 2"
352,100,3,400,500,"Sub-basin 2"
353,100,3,900,1000,"Sub-basin 2"
354,500,78,1500,2000,"Sub-basin 2"
355,600,30,800,1400,"Sub-basin 2"
356,3200,625,7100,10300,"Sub-basin 2"
357,100,1,1600,1700,"Sub-basin 2"
358,45300,25371,29600,74900,"Sub-basin 2"
359,1400,74,3900,5300,"Sub-basin 2"
360,700,161,1000,1700,"Sub-basin 2"
361,600,77,2600,3200,"Sub-basin 2"
362,600,123,3300,3900,"Sub-basin 2"
363,200,2,2700,2900,"Sub-basin 2"
364,15800,4966,39200,55000,"Sub-basin 2"
365,900,218,1500,2400,"Sub-basin 2"
366,800,123,2300,3100,"Sub-basin 2"
367,1200,151,9500,10700,"Sub-basin 2"
368,600,30,2800,3400,"Sub-basin 2"
369,700,66,3400,4100,"Sub-basin 2"
370,900,122,4000,4900,"Sub-basin 2"
371,800,191,2300,3100,"Sub-basin 2"
372,1100,273,1600,2700,"Sub-basin 2"
373,500,65,2600,3100,"Sub-basin 2"
374,100,1,200,300,"Sub-basin 2"
375,700,116,2000,2700,"Sub-basin 2"
376,600,150,2000,2600,"Sub-basin 2"
377,11500,2817,19800,31300,"Sub-basin 2"
378,200,5,1200,1400,"Sub-basin 2"
379,2700,561,6200,8900,"Sub-basin 2"
380,600,34,4700,5300,"Sub-basin 2"
381,4400,451,19600,24000,"Sub-basin 2"
382,400,37,1000,1400,"Sub-basin 2"
383,72400,30555,59300,131700,"Sub-basin 2"
384,1700,478,3700,5400,"Sub-basin 2"
385,600,166,2500,3100,"Sub-basin 2"
386,11700,3809,16300,28000,"Sub-basin 2"
387,4100,1362,3400,7500,"Sub-basin 2"
388,12600,4647,25400,38000,"Sub-basin 2"
389,16400,7279,17600,34000,"Sub-basin 2"
390,400,40,1300,1700,"Sub-basin 2"
391,500,68,4200,4700,"Sub-basin 2"
392,3400,1345,6000,9400,"Sub-basin 2"
393,1800,708,5600,7400,"Sub-basin 2"
394,400,43,2000,2400,"Sub-basin 2"
395,1800,353,5100,6900,"Sub-basin 2"
396,1600,312,2600,4200,"Sub-basin 2"
397,100,1,100,200,"Sub-basin 2"
398,1000,125,3300,4300,"Sub-basin 2"
399,100,1,1500,1600,"Sub-basin 2"
400,1500,242,4900,6400,"Sub-basin 2"
401,3400,482,12200,15600,"Sub-basin 2"
402,114200,63969.17,86700,200900,"Sub-basin 2"
403,400,25,1000,1400,"Sub-basin 2"
404,13700,5149.16,21500,35200,"Sub-basin 2"
405,400,14,2100,2500,"Sub-basin 2"
406,1100,155,2700,3800,"Sub-basin 2"
407,500,33,2300,2800,"Sub-basin 2"
408,100,8,1100,1200,"Sub-basin 2"
409,800,227,2000,2800,"Sub-basin 2"
410,100,10,1500,1600,"Sub-basin 2"
411,600,151,3800,4400,"Sub-basin 2"
412,300,12,400,700,"Sub-basin 2"
413,500,62,1700,2200,"Sub-basin 2"
414,100,5,1000,1100,"Sub-basin 2"
415,200,15,1500,1700,"Sub-basin 2"
416,200,10,2000,2200,"Sub-basin 2"
417,100,2,600,700,"Sub-basin 2"
418,22800,7916,38900,61700,"Sub-basin 2"
419,1100,71,6000,7100,"Sub-basin 2"
420,4800,930,19000,23800,"Sub-basin 2"
421,800,92,4300,5100,"Sub-basin 2"
422,8200,1983,13200,21400,"Sub-basin 2"
423,1200,241,3800,5000,"Sub-basin 2"
424,400,25,2900,3300,"Sub-basin 2"
425,100,2,1100,1200,"Sub-basin 2"
426,73200,29635,57800,131000,"Sub-basin 2"
427,1100,267,2900,4000,"Sub-basin 2"
428,3700,1206,6700,10400,"Sub-basin 2"
429,2200,337,5500,7700,"Sub-basin 2"
430,23200,7023,40500,63700,"Sub-basin 2"
431,400,29,1200,1600,"Sub-basin 2"
432,12600,1837,43900,56500,"Sub-basin 2"
433,700,56,1200,1900,"Sub-basin 2"
434,300,17,1900,2200,"Sub-basin 2"
435,400,50,1700,2100,"Sub-basin 2"
436,400,25,2200,2600,"Sub-basin 2"
437,3600,1162,6200,9800,"Sub-basin 2"
438,2200,500,2200,4400,"Sub-basin 2"
439,100,6,200,300,"Sub-basin 2"
440,1500,188,2200,3700,"Sub-basin 2"
441,200,5,2400,2600,"Sub-basin 2"
442,200,8,1800,2000,"Sub-basin 2"
443,700,52,3100,3800,"Sub-basin 2"
444,800,57,5700,6500,"Sub-basin 2"
445,300,17,1500,1800,"Sub-basin 2"
446,300,21,900,1200,"Sub-basin 2"
447,400,9,1800,2200,"Sub-basin 2"
448,500,16,1000,1500,"Sub-basin 2"
449,300,22,1500,1800,"Sub-basin 2"
450,600,101,1900,2500,"Sub-basin 2"
451,900,133,2700,3600,"Sub-basin 2"
452,100,3,800,900,"Sub-basin 2"
453,300,21,1500,1800,"Sub-basin 2"
454,800,160,4100,4900,"Sub-basin 2"
455,1100,248,3800,4900,"Sub-basin 2"
456,1200,372,4600,5800,"Sub-basin 2"
457,500,38,3300,3800,"Sub-basin 2"
458,300,10,1500,1800,"Sub-basin 2"
459,3200,800,8500,11700,"Sub-basin 2"
460,100,3,1700,1800,"Sub-basin 2"
461,1500,207,2500,4000,"Sub-basin 2"
462,400,88,1200,1600,"Sub-basin 2"
463,6500,2304,13500,20000,"Sub-basin 2"
464,300,15,2100,2400,"Sub-basin 2"
465,1300,221,5200,6500,"Sub-basin 2"
466,19100,7061,13900,33000,"Sub-basin 2"
467,200,21,1500,1700,"Sub-basin 2"
468,7000,2375,10900,17900,"Sub-basin 2"
469,400,29,2700,3100,"Sub-basin 2"
470,900,121,8000,8900,"Sub-basin 2"
471,200,8,700,900,"Sub-basin 2"
472,100,3,400,500,"Sub-basin 2"
473,1200,374,2600,3800,"Sub-basin 2"
474,1200,105,2600,3800,"Sub-basin 2"
475,6300,1352,28500,34800,"Sub-basin 2"
476,3400,587,12500,15900,"Sub-basin 2"
477,3100,1077,6900,10000,"Sub-basin 2"
478,1200,266,4100,5300,"Sub-basin 2"
479,200,5,1100,1300,"Sub-basin 2"
480,8100,2467,14100,22200,"Sub-basin 2"
481,400,48,1300,1700,"Sub-basin 2"
482,300,13,700,1000,"Sub-basin 2"
483,600,32,2200,2800,"Sub-basin 2"
484,9900,2568,14700,24600,"Sub-basin 2"
485,400,22,2700,3100,"Sub-basin 2"
486,1100,134,8200,9300,"Sub-basin 2"
487,3900,397,19800,23700,"Sub-basin 2"
488,100,2,600,700,"Sub-basin 2"
489,200,2,400,600,"Sub-basin 2"
490,4900,1538,8700,13600,"Sub-basin 2"
491,400,49,1900,2300,"Sub-basin 2"
492,2600,666,7700,10300,"Sub-basin 2"
493,23700,6875,23600,47300,"Sub-basin 2"
494,2700,823,9000,11700,"Sub-basin 2"
495,900,95,2400,3300,"Sub-basin 2"
496,1000,125,2200,3200,"Sub-basin 2"
497,200,6,2000,2200,"Sub-basin 2"
498,1600,131,3300,4900,"Sub-basin 2"
499,300,12,2900,3200,"Sub-basin 2"
500,200,22,1400,1600,"Sub-basin 2"
501,100,1,600,700,"Sub-basin 2"
502,1100,186,3800,4900,"Sub-basin 2"
503,600,86,3500,4100,"Sub-basin 2"
504,1000,134,5800,6800,"Sub-basin 2"
505,4100,860,8700,12800,"Sub-basin 2"
506,400,46,1400,1800,"Sub-basin 2"
507,1500,266,4600,6100,"Sub-basin 2"
508,100,8,900,1000,"Sub-basin 2"
509,100,5,400,500,"Sub-basin 2"
510,2800,396,10100,12900,"Sub-basin 2"
511,300,11,1800,2100,"Sub-basin 2"
512,1500,218,6200,7700,"Sub-basin 2"
513,8200,2995,18500,26700,"Sub-basin 2"
514,900,257,3100,4000,"Sub-basin 2"
515,2600,391,7200,9800,"Sub-basin 2"
516,300,17,2000,2300,"Sub-basin 2"
517,200,4,1100,1300,"Sub-basin 2"
518,300,52,600,900,"Sub-basin 2"
519,400,85,1500,1900,"Sub-basin 2"
520,100,1,1200,1300,"Sub-basin 2"
521,200,5,1100,1300,"Sub-basin 2"
522,1700,322,6200,7900,"Sub-basin 2"
523,400,80,2100,2500,"Sub-basin 2"
524,100,3,1200,1300,"Sub-basin 2"
525,14100,2828,22500,36600,"Sub-basin 2"
526,1000,91,2500,3500,"Sub-basin 2"
527,100,2,1200,1300,"Sub-basin 2"
528,5400,1703,9900,15300,"Sub-basin 2"
529,100,4,1300,1400,"Sub-basin 2"
530,3900,920,12800,16700,"Sub-basin 2"
531,100,3,700,800,"Sub-basin 2"
532,13600,3998,18100,31700,"Sub-basin 2"
533,200,12,1400,1600,"Sub-basin 2"
534,43100,16354,48000,91100,"Sub-basin 2"
535,6400,2376,10500,16900,"Sub-basin 2"
536,12600,2760.17,28200,40800,"Sub-basin 2"
537,3000,756,6200,9200,"Sub-basin 2"
538,300,6,1200,1500,"Sub-basin 2"
539,700,110,1900,2600,"Sub-basin 2"
540,400,22,2600,3000,"Sub-basin 2"
541,1600,528,5400,7000,"Sub-basin 2"
542,400,33,3700,4100,"Sub-basin 2"
543,1800,335,3200,5000,"Sub-basin 2"
544,59100,20785,65300,124400,"Sub-basin 2"
545,100,8,1000,1100,"Sub-basin 2"
546,1800,815,4200,6000,"Sub-basin 2"
547,300,11,3200,3500,"Sub-basin 2"
548,100,2,700,800,"Sub-basin 2"
549,900,106,4200,5100,"Sub-basin 2"
550,3600,764,6300,9900,"Sub-basin 2"
551,900,115,5000,5900,"Sub-basin 2"
552,700,64,1900,2600,"Sub-basin 2"
553,200,10,2500,2700,"Sub-basin 2"
554,200,3,1000,1200,"Sub-basin 2"
555,100,2,1000,1100,"Sub-basin 2"
556,600,164,1500,2100,"Sub-basin 2"
557,1800,269,6700,8500,"Sub-basin 2"
558,400,24,1400,1800,"Sub-basin 2"
559,400,87,2400,2800,"Sub-basin 2"
560,400,14,800,1200,"Sub-basin 2"
561,3700,384,16200,19900,"Sub-basin 2"
562,100,1,700,800,"Sub-basin 2"
563,400,55,700,1100,"Sub-basin 2"
564,1000,133,2500,3500,"Sub-basin 2"
565,600,133,3700,4300,"Sub-basin 2"
566,100,3,300,400,"Sub-basin 2"
567,2100,727,6600,8700,"Sub-basin 2"
568,4200,551,10600,14800,"Sub-basin 2"
569,1300,363,7200,8500,"Sub-basin 2"
570,3000,869,10700,13700,"Sub-basin 2"
571,200,5,1700,1900,"Sub-basin 2"
572,1000,124,4300,5300,"Sub-basin 2"
573,100,2,1000,1100,"Sub-basin 2"
574,1000,170,1100,2100,"Sub-basin 2"
575,100,2,400,500,"Sub-basin 2"
576,100,2,1600,1700,"Sub-basin 2"
577,1100,152,3100,4200,"Sub-basin 2"
578,3500,885,7600,11100,"Sub-basin 2"
579,2000,573,4100,6100,"Sub-basin 2"
580,300,22,3000,3300,"Sub-basin 2"
581,300,13,1400,1700,"Sub-basin 2"
582,6400,1966,11100,17500,"Sub-basin 2"
583,100,4,200,300,"Sub-basin 2"
584,500,37,2600,3100,"Sub-basin 2"
585,1100,74,6600,7700,"Sub-basin 2"
586,700,36,4200,4900,"Sub-basin 2"
587,600,24,3600,4200,"Sub-basin 2"
588,200,9,1200,1400,"Sub-basin 2"
589,1800,379,7900,9700,"Sub-basin 2"
590,600,49,3700,4300,"Sub-basin 2"
591,100,3,1400,1500,"Sub-basin 2"
592,800,114,4100,4900,"Sub-basin 2"
593,4300,1114,11700,16000,"Sub-basin 2"
594,500,40,2400,2900,"Sub-basin 2"
595,100,1,1000,1100,"Sub-basin 2"
596,3500,1179,5900,9400,"Sub-basin 2"
597,7800,1805,20100,27900,"Sub-basin 2"
598,2200,507,5300,7500,"Sub-basin 2"
599,100,4,500,600,"Sub-basin 2"
600,400,42,1600,2000,"Sub-basin 2"
601,2700,896,6200,8900,"Sub-basin 2"
602,7300,785,22600,29900,"Sub-basin 2"
603,17700,3408,24300,42000,"Sub-basin 2"
604,600,43,3500,4100,"Sub-basin 2"
605,1900,305,4300,6200,"Sub-basin 2"
606,400,121,2100,2500,"Sub-basin 2"
607,1600,304,4100,5700,"Sub-basin 2"
608,300,17,3100,3400,"Sub-basin 2"
609,200,4,1100,1300,"Sub-basin 2"
610,3900,1099,9000,12900,"Sub-basin 2"
611,200,8,2700,2900,"Sub-basin 2"
612,100,1,900,1000,"Sub-basin 2"
613,7100,2334,11200,18300,"Sub-basin 2"
614,400,51,1200,1600,"Sub-basin 2"
615,100,5,600,700,"Sub-basin 2"
616,100,2,1900,2000,"Sub-basin 2"
617,19800,6129,28300,48100,"Sub-basin 2"
618,500,49,3800,4300,"Sub-basin 2"
619,900,227,3900,4800,"Sub-basin 2"
620,400,36,2000,2400,"Sub-basin 2"
621,400,25,3100,3500,"Sub-basin 2"
622,300,9,3200,3500,"Sub-basin 2"
623,500,38,1900,2400,"Sub-basin 2"
624,1600,383,5400,7000,"Sub-basin 2"
625,400,115,2100,2500,"Sub-basin 2"
626,100,3,900,1000,"Sub-basin 2"
627,1200,321,2800,4000,"Sub-basin 2"
628,700,30,4800,5500,"Sub-basin 2"
629,100,1,800,900,"Sub-basin 2"
630,3900,663,18200,22100,"Sub-basin 2"
631,100,1,2100,2200,"Sub-basin 2"
632,1200,236,4900,6100,"Sub-basin 2"
633,1300,230,6100,7400,"Sub-basin 2"
634,4800,426,8500,13300,"Sub-basin 2"
635,4500,1313,9700,14200,"Sub-basin 2"
636,2600,748,6800,9400,"Sub-basin 2"
637,200,6,1600,1800,"Sub-basin 2"
638,38900,11774,57400,96300,"Sub-basin 2"
639,900,114,2700,3600,"Sub-basin 2"
640,200,14,1400,1600,"Sub-basin 2"
641,800,125,3200,4000,"Sub-basin 2"
642,200,21,600,800,"Sub-basin 2"
643,300,20,700,1000,"Sub-basin 2"
644,52100,17148,65700,117800,"Sub-basin 2"
645,1600,717,5400,7000,"Sub-basin 2"
646,1400,370,4300,5700,"Sub-basin 2"
647,700,46,2200,2900,"Sub-basin 2"
648,500,145,1700,2200,"Sub-basin 2"
649,400,24,2000,2400,"Sub-basin 2"
650,1300,173,4700,6000,"Sub-basin 2"
651,400,20,1500,1900,"Sub-basin 2"
652,400,29,1400,1800,"Sub-basin 2"
653,200,8,1300,1500,"Sub-basin 2"
654,400,10,1400,1800,"Sub-basin 2"
655,600,80,3200,3800,"Sub-basin 2"
656,100,1,1200,1300,"Sub-basin 2"
657,200,7,3900,4100,"Sub-basin 2"
658,3100,718,9100,12200,"Sub-basin 2"
659,600,84,1300,1900,"Sub-basin 2"
660,2100,653,5500,7600,"Sub-basin 2"
661,200,31,1700,1900,"Sub-basin 2"
662,400,8,2700,3100,"Sub-basin 2"
663,2300,554,9700,12000,"Sub-basin 2"
664,100,2,900,1000,"Sub-basin 2"
665,700,105,4200,4900,"Sub-basin 2"
666,1600,722,4100,5700,"Sub-basin 2"
667,1000,153,5300,6300,"Sub-basin 2"
668,1600,907,3100,4700,"Sub-basin 2"
669,83800,21944,118600,202400,"Sub-basin 2"
670,200,8,600,800,"Sub-basin 2"
671,200,3,1000,1200,"Sub-basin 2"
672,100,2,1400,1500,"Sub-basin 2"
673,200,9,800,1000,"Sub-basin 2"
674,100,9,1300,1400,"Sub-basin 2"
675,200,3,600,800,"Sub-basin 2"
676,300,48,4500,4800,"Sub-basin 2"
677,100,4,1100,1200,"Sub-basin 2"
678,1200,172,4100,5300,"Sub-basin 2"
679,200,14,1700,1900,"Sub-basin 2"
680,100,3,600,700,"Sub-basin 2"
681,100,3,900,1000,"Sub-basin 2"
682,300,38,2100,2400,"Sub-basin 2"
683,100,4,1500,1600,"Sub-basin 2"
684,4700,2056,8700,13400,"Sub-basin 2"
685,1400,218,5100,6500,"Sub-basin 2"
686,400,87,2000,2400,"Sub-basin 2"
687,1100,195,3200,4300,"Sub-basin 2"
688,280500,48863.0372,271300,551800,"Sub-basin 2"
689,100,1,900,1000,"Sub-basin 2"
690,1000,236,3700,4700,"Sub-basin 2"
691,300,11,2700,3000,"Sub-basin 2"
692,14300,2771,31400,45700,"Sub-basin 2"
693,1900,147,9500,11400,"Sub-basin 2"
694,200,28,1400,1600,"Sub-basin 2"
695,100,2,1300,1400,"Sub-basin 2"
696,100,4,700,800,"Sub-basin 2"
697,600,78,1500,2100,"Sub-basin 2"
698,1800,395,6800,8600,"Sub-basin 2"
699,100,5,700,800,"Sub-basin 2"
700,100,2,900,1000,"Sub-basin 2"
701,200,8,1500,1700,"Sub-basin 2"
702,200,3,500,700,"Sub-basin 2"
703,800,121,1400,2200,"Sub-basin 2"
704,700,111,2400,3100,"Sub-basin 2"
705,300,27,2900,3200,"Sub-basin 2"
706,200,10,300,500,"Sub-basin 2"
707,600,47,4100,4700,"Sub-basin 2"
708,400,47,2600,3000,"Sub-basin 2"
709,200,21,1300,1500,"Sub-basin 2"
710,13200,2124,24500,37700,"Sub-basin 2"
711,200,9,1200,1400,"Sub-basin 2"
712,400,24,900,1300,"Sub-basin 2"
713,2000,446.5,6500,8500,"Sub-basin 2"
714,400,17,4600,5000,"Sub-basin 2"
715,200,11,3100,3300,"Sub-basin 2"
716,4700,1341,11400,16100,"Sub-basin 2"
717,7500,2117,12000,19500,"Sub-basin 2"
718,400,63,1600,2000,"Sub-basin 2"
719,100,5,700,800,"Sub-basin 2"
720,1100,273,3500,4600,"Sub-basin 2"
721,100,2,800,900,"Sub-basin 2"
722,29300,10918,28100,57400,"Sub-basin 2"
723,200,15,600,800,"Sub-basin 2"
724,400,21,2300,2700,"Sub-basin 2"
725,1500,384,5900,7400,"Sub-basin 2"
726,200,32,1400,1600,"Sub-basin 2"
727,400,14,1000,1400,"Sub-basin 2"
728,400,66,2200,2600,"Sub-basin 2"
729,400,57,2100,2500,"Sub-basin 2"
730,2100,486,6300,8400,"Sub-basin 2"
731,300,23,2000,2300,"Sub-basin 2"
732,6300,1353.01,15700,22000,"Sub-basin 2"
733,500,57,3300,3800,"Sub-basin 2"
734,5400,617,10400,15800,"Sub-basin 2"
735,600,51,2500,3100,"Sub-basin 2"
736,600,131,1500,2100,"Sub-basin 2"
737,400,42,1700,2100,"Sub-basin 2"
738,1600,471,3000,4600,"Sub-basin 2"
739,200,5,1400,1600,"Sub-basin 2"
740,100,3,900,1000,"Sub-basin 2"
741,100,2,400,500,"Sub-basin 2"
742,600,135,2400,3000,"Sub-basin 2"
743,400,44,2500,2900,"Sub-basin 2"
744,300,17,1500,1800,"Sub-basin 2"
745,1800,739,3800,5600,"Sub-basin 2"
746,800,97,3900,4700,"Sub-basin 2"
747,1000,64,6500,7500,"Sub-basin 2"
748,8100,1416,15800,23900,"Sub-basin 2"
749,13000,4033,18900,31900,"Sub-basin 2"
750,2700,1071,7100,9800,"Sub-basin 2"
751,100,1,500,600,"Sub-basin 2"
752,500,91,3600,4100,"Sub-basin 2"
753,1700,355,8200,9900,"Sub-basin 2"
754,900,183,3400,4300,"Sub-basin 2"
755,400,52,1500,1900,"Sub-basin 2"
756,200,8,1900,2100,"Sub-basin 2"
757,6900,3589,12600,19500,"Sub-basin 2"
758,3600,1136,8500,12100,"Sub-basin 2"
759,1800,576,4400,6200,"Sub-basin 2"
760,500,38,1900,2400,"Sub-basin 2"
761,1000,121,1300,2300,"Sub-basin 2"
762,200,10,1500,1700,"Sub-basin 2"
763,600,120,2600,3200,"Sub-basin 2"
764,79300,37884.5,70800,150100,"Sub-basin 2"
765,100,1,1500,1600,"Sub-basin 2"
766,100,2,500,600,"Sub-basin 2"
767,700,196,2100,2800,"Sub-basin 2"
768,1500,656,6300,7800,"Sub-basin 2"
769,500,42,2700,3200,"Sub-basin 2"
770,300,17,1700,2000,"Sub-basin 2"
771,1000,84,4500,5500,"Sub-basin 2"
772,500,58,1700,2200,"Sub-basin 2"
773,100,8,1500,1600,"Sub-basin 2"
774,68100,18173,70200,138300,"Sub-basin 2"
775,9200,2696.83,22400,31600,"Sub-basin 2"
776,100,3,300,400,"Sub-basin 2"
777,100,1,400,500,"Sub-basin 2"
778,900,181,3400,4300,"Sub-basin 2"
779,300,10,2300,2600,"Sub-basin 2"
780,100,2,1100,1200,"Sub-basin 2"
781,1300,530,3800,5100,"Sub-basin 2"
782,4000,993,8900,12900,"Sub-basin 2"
783,100,3,300,400,"Sub-basin 2"
784,1700,253,3800,5500,"Sub-basin 2"
785,9700,3170,13400,23100,"Sub-basin 2"
786,900,286,4500,5400,"Sub-basin 2"
787,200,5,1000,1200,"Sub-basin 2"
788,1700,374,11400,13100,"Sub-basin 2"
789,200,14,1900,2100,"Sub-basin 2"
790,400,36,1100,1500,"Sub-basin 2"
791,15500,6140,33300,48800,"Sub-basin 2"
792,400,33,600,1000,"Sub-basin 2"
793,100,1,1100,1200,"Sub-basin 2"
794,100,1,1000,1100,"Sub-basin 2"
795,500,71,1500,2000,"Sub-basin 2"
796,3700,1395,9700,13400,"Sub-basin 2"
797,100,1,800,900,"Sub-basin 2"
798,600,106,2000,2600,"Sub-basin 2"
799,1300,222,9000,10300,"Sub-basin 2"
800,300,58,1600,1900,"Sub-basin 2"
801,500,92,3800,4300,"Sub-basin 2"
802,400,113,1900,2300,"Sub-basin 2"
803,1000,262,5500,6500,"Sub-basin 2"
804,400,16,1800,2200,"Sub-basin 2"
805,1400,382,3300,4700,"Sub-basin 2"
806,1700,373,8200,9900,"Sub-basin 2"
807,7100,2623,11100,18200,"Sub-basin 2"
808,100,2,600,700,"Sub-basin 2"
809,200,24,1300,1500,"Sub-basin 2"
810,400,60,2200,2600,"Sub-basin 2"
811,200,4,500,700,"Sub-basin 2"
812,400,28,900,1300,"Sub-basin 2"
813,400,72,2100,2500,"Sub-basin 2"
814,1600,460,5100,6700,"Sub-basin 2"
815,100,4,700,800,"Sub-basin 2"
816,17000,4980,42200,59200,"Sub-basin 2"
817,400,32,2200,2600,"Sub-basin 2"
818,3500,697,9300,12800,"Sub-basin 2"
819,800,115,4400,5200,"Sub-basin 2"
820,9100,2351.84,15700,24800,"Sub-basin 2"
821,300,23,1700,2000,"Sub-basin 2"
822,400,47,2600,3000,"Sub-basin 2"
823,2400,578,9200,11600,"Sub-basin 2"
824,600,25,1600,2200,"Sub-basin 2"
825,100,1,700,800,"Sub-basin 2"
826,200,5,700,900,"Sub-basin 2"
827,100,3,600,700,"Sub-basin 2"
828,1700,336,6300,8000,"Sub-basin 2"
829,100,2,500,600,"Sub-basin 2"
830,400,44,1800,2200,"Sub-basin 2"
831,1600,339,5000,6600,"Sub-basin 2"
832,8200,1838,17300,25500,"Sub-basin 2"
833,100,12,900,1000,"Sub-basin 2"
834,100,1,900,1000,"Sub-basin 2"
835,1100,75,1800,2900,"Sub-basin 2"
836,500,27,2300,2800,"Sub-basin 2"
837,100,1,200,300,"Sub-basin 2"
838,300,34,3000,3300,"Sub-basin 2"
839,1500,403,5000,6500,"Sub-basin 2"
840,7800,1429,22000,29800,"Sub-basin 2"
841,900,60,4500,5400,"Sub-basin 2"
842,2300,314,11500,13800,"Sub-basin 2"
843,100,13,1800,1900,"Sub-basin 2"
844,2600,1098,5800,8400,"Sub-basin 2"
845,400,54,1700,2100,"Sub-basin 2"
846,300,14,1800,2100,"Sub-basin 2"
847,1900,323,5600,7500,"Sub-basin 2"
848,2900,666,6200,9100,"Sub-basin 2"
849,500,107,1600,2100,"Sub-basin 2"
850,100,10,1500,1600,"Sub-basin 2"
851,100,1,400,500,"Sub-basin 2"
852,53900,10966,67100,121000,"Sub-basin 2"
853,1700,471,3700,5400,"Sub-basin 2"
854,200,7,300,500,"Sub-basin 2"
855,600,65,1900,2500,"Sub-basin 2"
856,1700,845,3500,5200,"Sub-basin 2"
857,800,63.17,5600,6400,"Sub-basin 2"
858,300,24,1100,1400,"Sub-basin 2"
859,10600,5220,20500,31100,"Sub-basin 2"
860,1400,242,4700,6100,"Sub-basin 2"
861,700,201,1900,2600,"Sub-basin 2"
862,800,133,1700,2500,"Sub-basin 2"
863,100,2,1100,1200,"Sub-basin 2"
864,700,114,4500,5200,"Sub-basin 2"
865,1600,276,6800,8400,"Sub-basin 2"
866,1800,520,6700,8500,"Sub-basin 2"
867,14500,6645,13300,27800,"Sub-basin 2"
868,300,16,1700,2000,"Sub-basin 2"
869,900,206,1300,2200,"Sub-basin 2"
870,100,3,700,800,"Sub-basin 2"
871,100,9,600,700,"Sub-basin 2"
872,200,4,1400,1600,"Sub-basin 2"
873,5700,1398,15700,21400,"Sub-basin 2"
874,100,5,1400,1500,"Sub-basin 2"
875,5200,1847,9000,14200,"Sub-basin 2"
876,100,1,500,600,"Sub-basin 2"
877,16900,8869,29100,46000,"Sub-basin 2"
878,12000,3789,18100,30100,"Sub-basin 2"
879,600,218,2500,3100,"Sub-basin 2"
880,100,1,1200,1300,"Sub-basin 2"
881,200,9,1100,1300,"Sub-basin 2"
882,1100,358,4200,5300,"Sub-basin 2"
883,700,59,2000,2700,"Sub-basin 2"
884,800,149,3000,3800,"Sub-basin 2"
885,700,169.5,2700,3400,"Sub-basin 2"
886,300,20,2800,3100,"Sub-basin 2"
887,3800,1197,11000,14800,"Sub-basin 2"
888,14400,5613,21200,35600,"Sub-basin 2"
889,14100,3817,24000,38100,"Sub-basin 2"
890,600,41,1500,2100,"Sub-basin 2"
891,500,57,2200,2700,"Sub-basin 2"
892,100,2,1300,1400,"Sub-basin 2"
893,17500,5925,28700,46200,"Sub-basin 2"
894,3700,903,15800,19500,"Sub-basin 2"
895,400,27,1000,1400,"Sub-basin 2"
896,2100,458,6600,8700,"Sub-basin 2"
897,1600,737,4800,6400,"Sub-basin 2"
898,100,3,700,800,"Sub-basin 2"
899,600,59,2300,2900,"Sub-basin 2"
900,1600,254,3100,4700,"Sub-basin 2"
901,1200,190,2900,4100,"Sub-basin 2"
902,1500,257,5600,7100,"Sub-basin 2"
903,1400,320,4800,6200,"Sub-basin 2"
904,400,60,1100,1500,"Sub-basin 2"
905,100,3,800,900,"Sub-basin 2"
906,300,4,1300,1600,"Sub-basin 2"
907,100,3,500,600,"Sub-basin 2"
908,1600,542,6000,7600,"Sub-basin 2"
909,12700,2107,20300,33000,"Sub-basin 2"
910,15000,5169,23100,38100,"Sub-basin 2"
911,2100,774,3800,5900,"Sub-basin 2"
912,300,26,1700,2000,"Sub-basin 2"
913,700,43,500,1200,"Sub-basin 2"
914,400,70,4100,4500,"Sub-basin 2"
915,1400,470,3500,4900,"Sub-basin 2"
916,9400,1599,25900,35300,"Sub-basin 2"
917,900,119,1200,2100,"Sub-basin 2"
918,900,87,4800,5700,"Sub-basin 2"
919,400,50,1400,1800,"Sub-basin 2"
920,9600,2107,22300,31900,"Sub-basin 2"
921,400,49,2000,2400,"Sub-basin 2"
922,1500,296,5600,7100,"Sub-basin 2"
923,800,148,1600,2400,"Sub-basin 2"
924,200,3,200,400,"Sub-basin 2"
925,227600,88588.83,168300,395900,"Sub-basin 2"
926,100,1,700,800,"Sub-basin 2"
927,800,132,1300,2100,"Sub-basin 2"
928,800,108,4300,5100,"Sub-basin 2"
929,5200,1923,7700,12900,"Sub-basin 2"
930,300,8,2000,2300,"Sub-basin 2"
931,700,141,3900,4600,"Sub-basin 2"
932,6600,979,9700,16300,"Sub-basin 2"
933,13000,3074,32600,45600,"Sub-basin 2"
934,1000,213,3500,4500,"Sub-basin 2"
935,400,31,4000,4400,"Sub-basin 2"
936,1800,1032,4300,6100,"Sub-basin 2"
937,100,2,500,600,"Sub-basin 2"
938,3100,419,11100,14200,"Sub-basin 2"
939,400,56,1700,2100,"Sub-basin 2"
940,52900,14124,64600,117500,"Sub-basin 2"
941,400,55,3200,3600,"Sub-basin 2"
942,100,1,1100,1200,"Sub-basin 2"
943,2100,232,8100,10200,"Sub-basin 2"
944,6500,2859,18200,24700,"Sub-basin 2"
945,200,6,700,900,"Sub-basin 2"
946,600,137,1700,2300,"Sub-basin 2"
947,11800,4031,15200,27000,"Sub-basin 2"
948,7800,1332.84,20600,28400,"Sub-basin 2"
949,600,54,1900,2500,"Sub-basin 2"
950,600,155,900,1500,"Sub-basin 2"
951,2700,1000,4500,7200,"Sub-basin 2"
952,2300,698,5700,8000,"Sub-basin 2"
953,100,3,1000,1100,"Sub-basin 2"
954,100,4,600,700,"Sub-basin 2"
955,400,43,2600,3000,"Sub-basin 2"
956,700,110,2100,2800,"Sub-basin 2"
957,3800,460,16900,20700,"Sub-basin 2"
958,2000,875,3600,5600,"Sub-basin 2"
959,200,9,1500,1700,"Sub-basin 2"
960,2300,88,12200,14500,"Sub-basin 2"
961,800,67,5200,6000,"Sub-basin 2"
962,300,6,2200,2500,"Sub-basin 2"
963,29700,4054,41800,71500,"Sub-basin 2"
964,5300,1330,7800,13100,"Sub-basin 2"
965,200,4,1400,1600,"Sub-basin 2"
966,16600,2974,28800,45400,"Sub-basin 2"
967,3300,942,7400,10700,"Sub-basin 2"
968,200,13,500,700,"Sub-basin 2"
969,800,37,4200,5000,"Sub-basin 2"
970,1600,364,3200,4800,"Sub-basin 2"
971,700,29,2700,3400,"Sub-basin 2"
972,5100,2357,12100,17200,"Sub-basin 2"
973,200,4,1000,1200,"Sub-basin 2"
974,100,9,1600,1700,"Sub-basin 2"
975,100,4,1500,1600,"Sub-basin 2"
976,100,5,1400,1500,"Sub-basin 2"
977,100,1,200,300,"Sub-basin 2"
978,100,1,100,200,"Sub-basin 2"
979,11900,1017,27200,39100,"Sub-basin 2"
980,700,107,1100,1800,"Sub-basin 2"
981,100,7,1100,1200,"Sub-basin 2"
982,300,5,2500,2800,"Sub-basin 2"
983,100,4,500,600,"Sub-basin 2"
984,400,45,3500,3900,"Sub-basin 2"
985,600,102,3100,3700,"Sub-basin 2"
986,9500,3043,15500,25000,"Sub-basin 2"
987,6300,2113,9000,15300,"Sub-basin 2"
988,400,22,1800,2200,"Sub-basin 2"
989,800,100,3000,3800,"Sub-basin 2"
990,1100,189,3700,4800,"Sub-basin 2"
991,1700,245,6600,8300,"Sub-basin 2"
992,100,12,2400,2500,"Sub-basin 2"
993,3600,655,5600,9200,"Sub-basin 2"
994,900,368,3000,3900,"Sub-basin 2"
995,200,3,1200,1400,"Sub-basin 2"
996,200,13,1400,1600,"Sub-basin 2"
997,600,54,2600,3200,"Sub-basin 2"
998,3600,848,7400,11000,"Sub-basin 2"
999,2600,550,7900,10500,"Sub-basin 2"
1000,100,1,500,600,"Sub-basin 2"
1001,4100,1101,14800,18900,"Sub-basin 2"
1002,100,2,1100,1200,"Sub-basin 2"
1003,400,57,2100,2500,"Sub-basin 2"
1004,2800,377,8200,11000,"Sub-basin 2"
1005,600,56,2300,2900,"Sub-basin 2"
1006,300,58,1300,1600,"Sub-basin 2"
1007,2300,94,9900,12200,"Sub-basin 2"
1008,1000,74,5000,6000,"Sub-basin 2"
1009,18500,2861,48500,67000,"Sub-basin 2"
1010,14700,2033,32800,47500,"Sub-basin 2"
1011,400,61,1700,2100,"Sub-basin 2"
1012,4500,143,8700,13200,"Sub-basin 2"
1013,400,12,2600,3000,"Sub-basin 2"
1014,100,2,500,600,"Sub-basin 2"
1015,800,135,3500,4300,"Sub-basin 2"
1016,1900,364,3000,4900,"Sub-basin 2"
1017,800,96,4300,5100,"Sub-basin 2"
1018,1600,395,3000,4600,"Sub-basin 2"
1019,100,7,1000,1100,"Sub-basin 2"
1020,200,10,1800,2000,"Sub-basin 2"
1021,600,106,2100,2700,"Sub-basin 2"
1022,100,1.0003,1000,1100,"Sub-basin 2"
1023,4200,2090,7100,11300,"Sub-basin 2"
1024,3900,1089,6700,10600,"Sub-basin 2"
1025,100,2,1000,1100,"Sub-basin 2"
1026,9200,2068,13700,22900,"Sub-basin 2"
1027,1200,192,2700,3900,"Sub-basin 2"
1028,600,30,2200,2800,"Sub-basin 2"
1029,400,24,1000,1400,"Sub-basin 2"
1030,300,9,600,900,"Sub-basin 2"
1031,100,3,400,500,"Sub-basin 2"
1032,800,73,3900,4700,"Sub-basin 2"
1033,400,13,1500,1900,"Sub-basin 2"
1034,700,16,3600,4300,"Sub-basin 2"
1035,200,7,2300,2500,"Sub-basin 2"
1036,200,16,500,700,"Sub-basin 2"
1037,1200,272,3300,4500,"Sub-basin 2"
1038,300,13,1400,1700,"Sub-basin 2"
1039,4700,1176,13900,18600,"Sub-basin 2"
1040,4200,1536,6100,10300,"Sub-basin 2"
1041,100,4,700,800,"Sub-basin 2"
1042,100,1,700,800,"Sub-basin 2"
1043,100,3,500,600,"Sub-basin 2"
1044,200,5,2000,2200,"Sub-basin 2"
1045,100,12,1000,1100,"Sub-basin 2"
1046,500,59,1600,2100,"Sub-basin 2"
1047,200,4,2100,2300,"Sub-basin 2"
1048,500,46,2100,2600,"Sub-basin 2"
1049,1000,228,2300,3300,"Sub-basin 2"
1050,100,11,1200,1300,"Sub-basin 2"
1051,400,19,900,1300,"Sub-basin 2"
1052,100,7,1400,1500,"Sub-basin 2"
1053,10500,1442,13700,24200,"Sub-basin 2"
1054,300,6,800,1100,"Sub-basin 2"
1055,400,27,2500,2900,"Sub-basin 2"
1056,1500,65,6100,7600,"Sub-basin 2"
1057,1100,159.0059,7900,9000,"Sub-basin 2"
1058,200,8,1500,1700,"Sub-basin 2"
1059,500,18,3900,4400,"Sub-basin 2"
1060,200,5,1500,1700,"Sub-basin 2"
1061,300,14,3200,3500,"Sub-basin 2"
1062,1500,110,5400,6900,"Sub-basin 2"
1063,100,6,1300,1400,"Sub-basin 2"
1064,200,7,300,500,"Sub-basin 2"
1065,100,3,1200,1300,"Sub-basin 2"
1066,400,11,1400,1800,"Sub-basin 2"
1067,100,2,500,600,"Sub-basin 2"
1068,100,2,1300,1400,"Sub-basin 2"
1069,700,25,3300,4000,"Sub-basin 2"
1070,400,49,1300,1700,"Sub-basin 2"
1071,500,120,2400,2900,"Sub-basin 2"
1072,1700,404,4100,5800,"Sub-basin 2"
1073,900,116,2300,3200,"Sub-basin 2"
1074,1400,236,3700,5100,"Sub-basin 2"
1075,1500,429,5200,6700,"Sub-basin 2"
1076,100,2,0,100,"Sub-basin 2"
1077,500,36,4600,5100,"Sub-basin 2"
1078,200,9,1500,1700,"Sub-basin 2"
1079,500,29,1100,1600,"Sub-basin 2"
1080,200,5,1700,1900,"Sub-basin 2"
1081,100,1,1100,1200,"Sub-basin 2"
1082,200,10,1200,1400,"Sub-basin 2"
1083,1500,301,4200,5700,"Sub-basin 2"
1084,100,2,200,300,"Sub-basin 2"
1085,800,40,2700,3500,"Sub-basin 2"
1086,5300,1941,13000,18300,"Sub-basin 2"
1087,1200,358,4300,5500,"Sub-basin 2"
1088,100,1,300,400,"Sub-basin 2"
1089,10400,2338,17600,28000,"Sub-basin 2"
1090,200,3,800,1000,"Sub-basin 2"
1091,300,9,600,900,"Sub-basin 2"
1092,100,6,1000,1100,"Sub-basin 2"
1093,500,39,1700,2200,"Sub-basin 2"
1094,700,26,3500,4200,"Sub-basin 2"
1095,100,3,1400,1500,"Sub-basin 2"
1096,100,10,800,900,"Sub-basin 2"
1097,100,2,400,500,"Sub-basin 2"
1098,2100,625,4000,6100,"Sub-basin 2"
1099,13800,2061,25200,39000,"Sub-basin 2"
1100,100,2,200,300,"Sub-basin 2"
1101,700,116,2100,2800,"Sub-basin 2"
1102,500,59,3000,3500,"Sub-basin 2"
1103,300,9,3200,3500,"Sub-basin 2"
1104,59000,15234,68600,127600,"Sub-basin 2"
1105,200,13,700,900,"Sub-basin 2"
1106,1100,247,3500,4600,"Sub-basin 2"
1107,2400,614,9600,12000,"Sub-basin 2"
1108,600,47,3000,3600,"Sub-basin 2"
1109,500,38,1800,2300,"Sub-basin 2"
1110,100,3,1300,1400,"Sub-basin 2"
1111,400,17,1500,1900,"Sub-basin 2"
1112,400,72,1500,1900,"Sub-basin 2"
1113,700,159,1900,2600,"Sub-basin 2"
1114,2600,286,7700,10300,"Sub-basin 2"
1115,100,2,500,600,"Sub-basin 2"
1116,600,49,2800,3400,"Sub-basin 2"
1117,200,6,1900,2100,"Sub-basin 2"
1118,400,61,1600,2000,"Sub-basin 2"
1119,600,91.99,1800,2400,"Sub-basin 2"
1120,2500,833,9300,11800,"Sub-basin 2"
1121,100,4,1500,1600,"Sub-basin 2"
1122,100,6,1000,1100,"Sub-basin 2"
1123,400,18,3400,3800,"Sub-basin 2"
1124,300,8,1200,1500,"Sub-basin 2"
1125,4100,508,12600,16700,"Sub-basin 2"
1126,600,51,3200,3800,"Sub-basin 2"
1127,1200,429,3300,4500,"Sub-basin 2"
1128,1500,715,2800,4300,"Sub-basin 2"
1129,100,4,600,700,"Sub-basin 2"
1130,1000,126,1600,2600,"Sub-basin 2"
1131,4100,1571,10300,14400,"Sub-basin 2"
1132,200,11,2100,2300,"Sub-basin 2"
1133,100,6,900,1000,"Sub-basin 2"
1134,400,15,800,1200,"Sub-basin 2"
1135,200,12,1300,1500,"Sub-basin 2"
1136,2100,331,8600,10700,"Sub-basin 2"
1137,1600,138,6000,7600,"Sub-basin 2"
1138,100,1,1500,1600,"Sub-basin 2"
1139,400,19,3600,4000,"Sub-basin 2"
1140,100,3,1100,1200,"Sub-basin 2"
1141,100,6,2100,2200,"Sub-basin 2"
1142,6000,1713,13900,19900,"Sub-basin 2"
1143,700,32,3800,4500,"Sub-basin 2"
1144,200,8,2200,2400,"Sub-basin 2"
1145,200,6,2100,2300,"Sub-basin 2"
1146,500,36,1900,2400,"Sub-basin 2"
1147,500,37,4500,5000,"Sub-basin 2"
1148,500,58,1600,2100,"Sub-basin 2"
1149,300,3,2000,2300,"Sub-basin 2"
1150,100,8,1100,1200,"Sub-basin 2"
1151,10800,1264.0919,18300,29100,"Sub-basin 2"
1152,200,5,1200,1400,"Sub-basin 2"
1153,800,138,3200,4000,"Sub-basin 2"
1154,5900,1582,6900,12800,"Sub-basin 2"
1155,100,1,1200,1300,"Sub-basin 2"
1156,100,4,500,600,"Sub-basin 2"
1157,400,66,1200,1600,"Sub-basin 2"
1158,100,6,1500,1600,"Sub-basin 2"
1159,100,5,2000,2100,"Sub-basin 2"
1160,200,14,900,1100,"Sub-basin 2"
1161,500,71,2500,3000,"Sub-basin 2"
1162,7200,2131,17000,24200,"Sub-basin 2"
1163,100,1,800,900,"Sub-basin 2"
1164,500,41,5500,6000,"Sub-basin 2"
1165,19600,2465,30800,50400,"Sub-basin 2"
1166,14900,2151,29300,44200,"Sub-basin 2"
1167,100,2,1200,1300,"Sub-basin 2"
1168,700,99,2600,3300,"Sub-basin 2"
1169,19700,2501,40000,59700,"Sub-basin 2"
1170,200,7,3200,3400,"Sub-basin 2"
1171,3500,539,8100,11600,"Sub-basin 2"
1172,1600,199,6300,7900,"Sub-basin 2"
1173,700,29,2600,3300,"Sub-basin 2"
1174,400,38,2900,3300,"Sub-basin 2"
1175,300,16,1400,1700,"Sub-basin 2"
1176,200,12,1200,1400,"Sub-basin 2"
1177,300,9,3900,4200,"Sub-basin 2"
1178,900,120,3500,4400,"Sub-basin 2"
1179,1000,284,3800,4800,"Sub-basin 2"
1180,1600,204,5400,7000,"Sub-basin 2"
1181,900,182,4200,5100,"Sub-basin 2"
1182,3300,1233,6700,10000,"Sub-basin 2"
1183,200,13,2500,2700,"Sub-basin 2"
1184,31700,4731,36800,68500,"Sub-basin 2"
1185,1200,249,6500,7700,"Sub-basin 2"
1186,100,2,1500,1600,"Sub-basin 2"
1187,100,1,1600,1700,"Sub-basin 2"
1188,21800,3441,55000,76800,"Sub-basin 2"
1189,500,51,5400,5900,"Sub-basin 2"
1190,9900,1979,20300,30200,"Sub-basin 2"
1191,4800,1035,16500,21300,"Sub-basin 2"
1192,100,2,1200,1300,"Sub-basin 2"
1193,10700,2098,43000,53700,"Sub-basin 2"
1194,5500,1799,15600,21100,"Sub-basin 2"
1195,1700,860,5600,7300,"Sub-basin 2"
1196,5500,392,14200,19700,"Sub-basin 2"
1197,2100,807,4200,6300,"Sub-basin 2"
1198,2800,1008,7300,10100,"Sub-basin 2"
1199,3400,1046,8800,12200,"Sub-basin 2"
1200,1700,175,9400,11100,"Sub-basin 2"
1201,600,74,1800,2400,"Sub-basin 2"
1202,500,22,3000,3500,"Sub-basin 2"
1203,300,20,1800,2100,"Sub-basin 2"
1204,300,19,2300,2600,"Sub-basin 2"
1205,11700,2517,29200,40900,"Sub-basin 2"
1206,1500,123,4000,5500,"Sub-basin 2"
1207,400,69,2800,3200,"Sub-basin 2"
1208,600,32,2500,3100,"Sub-basin 2"
1209,1200,544,2400,3600,"Sub-basin 2"
1210,1300,91,10200,11500,"Sub-basin 2"
1211,700,152,3700,4400,"Sub-basin 2"
1212,400,30,1800,2200,"Sub-basin 2"
1213,2900,348,12500,15400,"Sub-basin 2"
1214,200,6,800,1000,"Sub-basin 2"
1215,100,5,2000,2100,"Sub-basin 2"
1216,100,5,1300,1400,"Sub-basin 2"
1217,700,116,4700,5400,"Sub-basin 2"
1218,300,12,1500,1800,"Sub-basin 2"
1219,200,13,1700,1900,"Sub-basin 2"
1220,100,2,600,700,"Sub-basin 2"
1221,300,18,1300,1600,"Sub-basin 2"
1222,100,8,400,500,"Sub-basin 2"
1223,1600,518,3500,5100,"Sub-basin 2"
1224,1300,435,2800,4100,"Sub-basin 2"
1225,500,49,3900,4400,"Sub-basin 2"
1226,600,58,2200,2800,"Sub-basin 2"
1227,500,73,1500,2000,"Sub-basin 2"
1228,600,30,2200,2800,"Sub-basin 2"
1229,200,11,1000,1200,"Sub-basin 2"
1230,100,2,900,1000,"Sub-basin 2"
1231,2900,1260,7100,10000,"Sub-basin 2"
1232,100,12,900,1000,"Sub-basin 2"
1233,1800,477,5900,7700,"Sub-basin 2"
1234,1800,282,5500,7300,"Sub-basin 2"
1235,100,4,1800,1900,"Sub-basin 2"
1236,1900,300,7200,9100,"Sub-basin 2"
1237,600,55,3900,4500,"Sub-basin 2"
1238,200,3,1400,1600,"Sub-basin 2"
1239,400,57,1800,2200,"Sub-basin 2"
1240,5500,1257,16100,21600,"Sub-basin 2"
1241,600,100,3900,4500,"Sub-basin 2"
1242,400,32,2500,2900,"Sub-basin 2"
1243,1800,358,6600,8400,"Sub-basin 2"
1244,1100,278,4600,5700,"Sub-basin 2"
1245,800,32,2600,3400,"Sub-basin 2"
1246,100,2,800,900,"Sub-basin 2"
1247,100,1,1100,1200,"Sub-basin 2"
1248,100,5,1300,1400,"Sub-basin 2"
1249,100,5,800,900,"Sub-basin 2"
1250,500,83,3400,3900,"Sub-basin 2"
1251,1100,67,5200,6300,"Sub-basin 2"
1252,100,1,1500,1600,"Sub-basin 2"
1253,200,14,1800,2000,"Sub-basin 2"
1254,400,32,4700,5100,"Sub-basin 2"
1255,10000,3877,29800,39800,"Sub-basin 2"
1256,3500,946,14100,17600,"Sub-basin 2"
1257,900,49,4300,5200,"Sub-basin 2"
1258,700,88,6200,6900,"Sub-basin 2"
1259,138400,12767,172400,310800,"Sub-basin 2"
1260,500,72,2000,2500,"Sub-basin 2"
1261,11700,3821,22100,33800,"Sub-basin 2"
1262,1600,314,5800,7400,"Sub-basin 2"
1263,200,3,1500,1700,"Sub-basin 2"
1264,600,115,4000,4600,"Sub-basin 2"
1265,2500,334,13500,16000,"Sub-basin 2"
1266,500,12,4400,4900,"Sub-basin 2"
1267,600,69,1300,1900,"Sub-basin 2"
1268,2000,339,6400,8400,"Sub-basin 2"
1269,100,5,600,700,"Sub-basin 2"
1270,3400,876,7600,11000,"Sub-basin 2"
1271,100,1,2500,2600,"Sub-basin 2"
1272,100,1,1000,1100,"Sub-basin 2"
1273,1400,263,2700,4100,"Sub-basin 2"
1274,3400,884,5000,8400,"Sub-basin 2"
1275,2200,175,8700,10900,"Sub-basin 2"
1276,1900,292,9100,11000,"Sub-basin 2"
1277,100,1,1100,1200,"Sub-basin 2"
1278,100,1,0,100,"Sub-basin 2"
1279,100,4,800,900,"Sub-basin 2"
1280,400,20,5600,6000,"Sub-basin 2"
1281,100,2,900,1000,"Sub-basin 2"
1282,3600,738,8200,11800,"Sub-basin 2"
1283,700,101,3100,3800,"Sub-basin 2"
1284,600,73,2800,3400,"Sub-basin 2"
1285,500,39,4800,5300,"Sub-basin 2"
1286,9800,1865,28500,38300,"Sub-basin 2"
1287,900,157,3000,3900,"Sub-basin 2"
1288,1100,182,4200,5300,"Sub-basin 2"
1289,20300,8381,23500,43800,"Sub-basin 2"
1290,500,79,2800,3300,"Sub-basin 2"
1291,1100,221,4800,5900,"Sub-basin 2"
1292,200,9,1900,2100,"Sub-basin 2"
1293,300,14,2700,3000,"Sub-basin 2"
1294,54200,11831.83,80000,134200,"Sub-basin 2"
1295,2100,301,9100,11200,"Sub-basin 2"
1296,1600,183,3900,5500,"Sub-basin 2"
1297,4600,723,6600,11200,"Sub-basin 2"
1298,100,1,1100,1200,"Sub-basin 2"
1299,12100,2207,26000,38100,"Sub-basin 2"
1300,200,4,600,800,"Sub-basin 2"
1301,500,72,1000,1500,"Sub-basin 2"
1302,1100,60,3800,4900,"Sub-basin 2"
1303,900,152,1600,2500,"Sub-basin 2"
1304,100,2,300,400,"Sub-basin 2"
1305,300,17,2400,2700,"Sub-basin 2"
1306,100,6,1100,1200,"Sub-basin 2"
1307,500,48,3000,3500,"Sub-basin 2"
1308,600,124,2100,2700,"Sub-basin 2"
1309,600,44,4200,4800,"Sub-basin 2"
1310,800,137,6800,7600,"Sub-basin 2"
1311,300,10,1900,2200,"Sub-basin 2"
1312,500,75,2900,3400,"Sub-basin 2"
1313,300,18,1700,2000,"Sub-basin 2"
1314,500,34,2300,2800,"Sub-basin 2"
1315,200,11,2000,2200,"Sub-basin 2"
1316,800,141,3400,4200,"Sub-basin 2"
1317,600,20,3600,4200,"Sub-basin 2"
1318,200,6,2200,2400,"Sub-basin 2"
1319,3000,419,16300,19300,"Sub-basin 2"
1320,800,44,5500,6300,"Sub-basin 2"
1321,100,1,900,1000,"Sub-basin 2"
1322,700,61,3700,4400,"Sub-basin 2"
1323,1200,86,7600,8800,"Sub-basin 2"
1324,1500,127,3700,5200,"Sub-basin 2"
1325,1300,154,4700,6000,"Sub-basin 2"
1326,1000,59,2100,3100,"Sub-basin 2"
1327,1400,300,7000,8400,"Sub-basin 2"
1328,1700,521,4700,6400,"Sub-basin 2"
1329,600,19,3300,3900,"Sub-basin 2"
1330,800,157,4100,4900,"Sub-basin 2"
1331,1300,178,3300,4600,"Sub-basin 2"
1332,4100,582,13900,18000,"Sub-basin 2"
1333,1100,411,4400,5500,"Sub-basin 2"
1334,200,11,1300,1500,"Sub-basin 2"
1335,12500,6182,12100,24600,"Sub-basin 2"
1336,1100,144,7800,8900,"Sub-basin 2"
1337,31800,8308,44800,76600,"Sub-basin 2"
1338,1500,565,4000,5500,"Sub-basin 2"
1339,200,9,1100,1300,"Sub-basin 2"
1340,1900,253,7000,8900,"Sub-basin 2"
1341,200,7,2500,2700,"Sub-basin 2"
1342,1600,371,6700,8300,"Sub-basin 2"
1343,2400,451,2600,5000,"Sub-basin 2"
1344,13200,1836.17,23000,36200,"Sub-basin 2"
1345,1900,794,4300,6200,"Sub-basin 2"
1346,12600,3837,23700,36300,"Sub-basin 2"
1347,400,18,400,800,"Sub-basin 2"
1348,200,4,2100,2300,"Sub-basin 2"
1349,100,2,600,700,"Sub-basin 2"
1350,200,8,3100,3300,"Sub-basin 2"
1351,1000,201,3000,4000,"Sub-basin 2"
1352,200,13,1000,1200,"Sub-basin 2"
1353,800,99,3100,3900,"Sub-basin 2"
1354,4900,1380,10400,15300,"Sub-basin 2"
1355,200,4,1100,1300,"Sub-basin 2"
1356,10200,5489,14100,24300,"Sub-basin 2"
1357,100,2,1100,1200,"Sub-basin 2"
1358,300,20,2200,2500,"Sub-basin 2"
1359,200,5,1400,1600,"Sub-basin 2"
1360,1400,457,6700,8100,"Sub-basin 2"
1361,1700,355,3700,5400,"Sub-basin 2"
1362,700,34,1700,2400,"Sub-basin 2"
1363,100,13,500,600,"Sub-basin 2"
1364,100,1,900,1000,"Sub-basin 2"
1365,44500,18130.34,43600,88100,"Sub-basin 2"
1366,14800,2080,36400,51200,"Sub-basin 2"
1367,2200,162,13900,16100,"Sub-basin 2"
1368,200,5,2400,2600,"Sub-basin 2"
1369,100,1,1300,1400,"Sub-basin 2"
1370,1600,320,5700,7300,"Sub-basin 2"
1371,1400,33,7000,8400,"Sub-basin 2"
1372,26100,2106.33,48200,74300,"Sub-basin 2"
1373,100,3,800,900,"Sub-basin 2"
1374,100,1,1900,2000,"Sub-basin 2"
1375,800,45,5600,6400,"Sub-basin 2"
1376,700,34,6100,6800,"Sub-basin 2"
1377,100,3,700,800,"Sub-basin 2"
1378,100,2,400,500,"Sub-basin 2"
1379,14200,5672,18900,33100,"Sub-basin 2"
1380,100,2,400,500,"Sub-basin 2"
1381,600,61,5700,6300,"Sub-basin 2"
1382,500,17,4200,4700,"Sub-basin 2"
1383,300,8,2100,2400,"Sub-basin 2"
1384,1300,81,9500,10800,"Sub-basin 2"
1385,300,47,1200,1500,"Sub-basin 2"
1386,2100,380,8900,11000,"Sub-basin 2"
1387,200,25,2800,3000,"Sub-basin 2"
1388,1800,335,4300,6100,"Sub-basin 2"
1389,2500,296.0216,10200,12700,"Sub-basin 2"
1390,2400,601,4600,7000,"Sub-basin 2"
1391,13500,1974,12100,25600,"Sub-basin 2"
1392,400,24,800,1200,"Sub-basin 2"
1393,200,3,1900,2100,"Sub-basin 2"
1394,400,15,5900,6300,"Sub-basin 2"
1395,500,112,3200,3700,"Sub-basin 2"
1396,200,4,1400,1600,"Sub-basin 2"
1397,700,39,2000,2700,"Sub-basin 2"
1398,2900,944,3200,6100,"Sub-basin 2"
1399,2400,1094,4300,6700,"Sub-basin 2"
1400,7500,2317,11600,19100,"Sub-basin 2"
1401,1400,130,10000,11400,"Sub-basin 2"
1402,5600,563,30200,35800,"Sub-basin 2"
1403,600,26,6100,6700,"Sub-basin 2"
1404,2300,223,4900,7200,"Sub-basin 2"
1405,400,43,2200,2600,"Sub-basin 2"
1406,200,15,1400,1600,"Sub-basin 2"
1407,1000,133,9200,10200,"Sub-basin 2"
1408,2100,298,7800,9900,"Sub-basin 2"
1409,100,3.001,1200,1300,"Sub-basin 2"
1410,1000,186,6900,7900,"Sub-basin 2"
1411,1800,251,12200,14000,"Sub-basin 2"
1412,600,169,1700,2300,"Sub-basin 2"
1413,15000,4722.17,19200,34200,"Sub-basin 2"
1414,2100,430,3800,5900,"Sub-basin 2"
1415,800,107,5900,6700,"Sub-basin 2"
1416,300,9,1000,1300,"Sub-basin 2"
1417,900,56,3400,4300,"Sub-basin 2"
1418,1000,156,3600,4600,"Sub-basin 2"
1419,100,1,1600,1700,"Sub-basin 2"
1420,100,6,1500,1600,"Sub-basin 2"
1421,1100,311,6000,7100,"Sub-basin 2"
1422,400,99,1400,1800,"Sub-basin 2"
1423,500,62,2700,3200,"Sub-basin 2"
1424,100,1,1800,1900,"Sub-basin 2"
1425,5300,2236,11000,16300,"Sub-basin 2"
1426,1900,490,3400,5300,"Sub-basin 2"
1427,300,12,2000,2300,"Sub-basin 2"
1428,100,17,1200,1300,"Sub-basin 2"
1429,300,13,1700,2000,"Sub-basin 2"
1430,4900,3393.6667,11600,16500,"Sub-basin 2"
1431,1400,211,4400,5800,"Sub-basin 2"
1432,600,14,2100,2700,"Sub-basin 2"
1433,2500,188,12300,14800,"Sub-basin 2"
1434,100,8,1300,1400,"Sub-basin 2"
1435,200,5,3900,4100,"Sub-basin 2"
1436,500,14,5300,5800,"Sub-basin 2"
1437,300,7,2100,2400,"Sub-basin 2"
1438,400,11,1700,2100,"Sub-basin 2"
1439,400,56,1900,2300,"Sub-basin 2"
1440,200,5,1200,1400,"Sub-basin 2"
1441,600,63.98,2800,3400,"Sub-basin 2"
1442,500,33,5000,5500,"Sub-basin 2"
1443,4200,849.5,9600,13800,"Sub-basin 2"
1444,1600,375,3500,5100,"Sub-basin 2"
1445,100,2,200,300,"Sub-basin 2"
1446,100,2,1000,1100,"Sub-basin 2"
1447,200,6,2900,3100,"Sub-basin 2"
1448,268100,35721.1093,182600,450700,"Sub-basin 2"
1449,100,25,500,600,"Sub-basin 2"
1450,1900,611.16,4300,6200,"Sub-basin 2"
1451,1800,216,6300,8100,"Sub-basin 2"
1452,300,25,3400,3700,"Sub-basin 2"
1453,500,86,5200,5700,"Sub-basin 2"
1454,500,22,5700,6200,"Sub-basin 2"
1455,200,5,3700,3900,"Sub-basin 2"
1456,1900,426,7700,9600,"Sub-basin 2"
1457,7100,2075,19900,27000,"Sub-basin 2"
1458,5200,1224,7800,13000,"Sub-basin 2"
1459,100,5,1100,1200,"Sub-basin 2"
1460,600,113.17,2600,3200,"Sub-basin 2"
1461,100,2,900,1000,"Sub-basin 2"
1462,700,99,4800,5500,"Sub-basin 2"
1463,400,91,1200,1600,"Sub-basin 2"
1464,2700,178,8900,11600,"Sub-basin 2"
1465,17700,6523,20800,38500,"Sub-basin 2"
1466,1700,197,5600,7300,"Sub-basin 2"
1467,100,2,1100,1200,"Sub-basin 2"
1468,800,70,2300,3100,"Sub-basin 2"
1469,100,1,1200,1300,"Sub-basin 2"
1470,300,6,5100,5400,"Sub-basin 2"
1471,1400,176,9500,10900,"Sub-basin 2"
1472,6500,642.34,8400,14900,"Sub-basin 2"
1473,600,40,1000,1600,"Sub-basin 2"
1474,200,8,2100,2300,"Sub-basin 2"
1475,400,30,4500,4900,"Sub-basin 2"
1476,100,3,1600,1700,"Sub-basin 2"
1477,100,2,800,900,"Sub-basin 2"
1478,800,172,1800,2600,"Sub-basin 2"
1479,3100,625,13400,16500,"Sub-basin 2"
1480,1400,353,3500,4900,"Sub-basin 2"
1481,400,41,3600,4000,"Sub-basin 2"
1482,700,17,10200,10900,"Sub-basin 2"
1483,100,1,1600,1700,"Sub-basin 2"
1484,100,10,1300,1400,"Sub-basin 2"
1485,100,1,1100,1200,"Sub-basin 2"
1486,300,6,3300,3600,"Sub-basin 2"
1487,300,16,1600,1900,"Sub-basin 2"
1488,1600,536,5400,7000,"Sub-basin 2"
1489,100,14,2500,2600,"Sub-basin 2"
1490,1700,288,7000,8700,"Sub-basin 2"
1491,1500,468,3800,5300,"Sub-basin 2"
1492,100,2,1800,1900,"Sub-basin 2"
1493,8200,1391,8500,16700,"Sub-basin 2"
1494,200,2,700,900,"Sub-basin 2"
1495,1000,71,4300,5300,"Sub-basin 2"
1496,100,3,400,500,"Sub-basin 2"
1497,100,2.0002,1300,1400,"Sub-basin 2"
1498,100,2,1200,1300,"Sub-basin 2"
1499,200,8,700,900,"Sub-basin 2"
1500,500,113,2900,3400,"Sub-basin 2"
1501,12300,4922,14300,26600,"Sub-basin 2"
1502,3200,966,5400,8600,"Sub-basin 2"
1503,6400,450,14300,20700,"Sub-basin 2"
1504,1000,194,9200,10200,"Sub-basin 2"
1505,300,11,5300,5600,"Sub-basin 2"
1506,1700,267,5500,7200,"Sub-basin 2"
1507,900,117,5200,6100,"Sub-basin 2"
1508,1100,117,3900,5000,"Sub-basin 2"
1509,1700,129,9000,10700,"Sub-basin 2"
1510,1200,449,3300,4500,"Sub-basin 2"
1511,3200,817,6100,9300,"Sub-basin 2"
1512,800,21,7400,8200,"Sub-basin 2"
1513,100,1,1500,1600,"Sub-basin 2"
1514,100,2,500,600,"Sub-basin 2"
1515,1400,178,4700,6100,"Sub-basin 2"
1516,10400,797,15400,25800,"Sub-basin 2"
1517,100,2,300,400,"Sub-basin 2"
1518,300,12,800,1100,"Sub-basin 2"
1519,21600,8482,20700,42300,"Sub-basin 2"
1520,200,3,400,600,"Sub-basin 2"
1521,55900,2331.1874,104800,160700,"Sub-basin 2"
1522,1700,240,5100,6800,"Sub-basin 2"
1523,1900,99,20100,22000,"Sub-basin 2"
1524,200,4,2700,2900,"Sub-basin 2"
1525,200,7,4600,4800,"Sub-basin 2"
1526,200,2,2500,2700,"Sub-basin 2"
1527,400,11,2600,3000,"Sub-basin 2"
1528,100,2,1300,1400,"Sub-basin 2"
1529,200,6,1500,1700,"Sub-basin 2"
1530,1000,211,3300,4300,"Sub-basin 2"
1531,1400,362,2900,4300,"Sub-basin 2"
1532,8100,1423,15200,23300,"Sub-basin 2"
1533,800,177,2500,3300,"Sub-basin 2"
1534,7800,1751,18400,26200,"Sub-basin 2"
1535,600,13,10600,11200,"Sub-basin 2"
1536,100,3,1500,1600,"Sub-basin 2"
1537,100,1,2600,2700,"Sub-basin 2"
1538,200,4,2700,2900,"Sub-basin 2"
1539,500,43,9600,10100,"Sub-basin 2"
1540,500,69,2400,2900,"Sub-basin 2"
1541,600,115,5500,6100,"Sub-basin 2"
1542,9300,1563,21100,30400,"Sub-basin 2"
1543,1000,179,4700,5700,"Sub-basin 2"
1544,400,41,1400,1800,"Sub-basin 2"
1545,8300,2776,11400,19700,"Sub-basin 2"
1546,8200,501,24500,32700,"Sub-basin 2"
1547,400,12,6000,6400,"Sub-basin 2"
1548,10800,1397,12900,23700,"Sub-basin 2"
1549,200,5,2000,2200,"Sub-basin 2"
1550,2000,707,6700,8700,"Sub-basin 2"
1551,300,12,1200,1500,"Sub-basin 2"
1552,1000,199,2200,3200,"Sub-basin 2"
1553,400,33,1300,1700,"Sub-basin 2"
1554,1500,317,3400,4900,"Sub-basin 2"
1555,200,2,3600,3800,"Sub-basin 2"
1556,300,23,5800,6100,"Sub-basin 2"
1557,100,10.0002,1600,1700,"Sub-basin 2"
1558,200,7,1700,1900,"Sub-basin 2"
1559,18200,3013,31800,50000,"Sub-basin 2"
1560,100,2,300,400,"Sub-basin 2"
1561,1100,254,3600,4700,"Sub-basin 2"
1562,200,10,3700,3900,"Sub-basin 2"
1563,100,2,1800,1900,"Sub-basin 2"
1564,100,1,1800,1900,"Sub-basin 2"
1565,100,2.0001,700,800,"Sub-basin 2"
1566,3400,1022,8400,11800,"Sub-basin 2"
1567,3500,242,9900,13400,"Sub-basin 2"
1568,200,9,3200,3400,"Sub-basin 2"
1569,100,1.0007,2500,2600,"Sub-basin 2"
1570,11900,7810,7700,19600,"Sub-basin 2"
1571,3900,1031,6800,10700,"Sub-basin 2"
1572,2300,305,7700,10000,"Sub-basin 2"
1573,200,7,1300,1500,"Sub-basin 2"
1574,2100,94,7200,9300,"Sub-basin 2"
1575,600,22,1600,2200,"Sub-basin 2"
1576,10000,1971,16600,26600,"Sub-basin 2"
1577,9900,3948,14300,24200,"Sub-basin 2"
1578,1800,683,3500,5300,"Sub-basin 2"
1579,100,3,3700,3800,"Sub-basin 2"
1580,100,5,500,600,"Sub-basin 2"
1581,100,1,600,700,"Sub-basin 2"
1582,100,9,900,1000,"Sub-basin 2"
1583,4400,1677,8300,12700,"Sub-basin 2"
1584,1000,185,2800,3800,"Sub-basin 2"
1585,400,10,10800,11200,"Sub-basin 2"
1586,4600,242,29000,33600,"Sub-basin 2"
1587,100,1,1000,1100,"Sub-basin 2"
1588,900,41,6200,7100,"Sub-basin 2"
1589,100,2,2200,2300,"Sub-basin 2"
1590,1700,97.0064,11700,13400,"Sub-basin 2"
1591,21500,3039.1024,76400,97900,"Sub-basin 2"
1592,400,12,2200,2600,"Sub-basin 2"
1593,1000,230,3800,4800,"Sub-basin 2"
1594,1200,397,1500,2700,"Sub-basin 2"
1595,400,16.0008,3800,4200,"Sub-basin 2"
1596,300,19,2600,2900,"Sub-basin 2"
1597,200,3,2200,2400,"Sub-basin 2"
1598,500,43,1200,1700,"Sub-basin 2"
1599,300,8,700,1000,"Sub-basin 2"
1600,8200,487,22800,31000,"Sub-basin 2"
1601,1700,266,7700,9400,"Sub-basin 2"
1602,200,2,4300,4500,"Sub-basin 2"
1603,100,1.0001,400,500,"Sub-basin 2"
1604,600,41,2000,2600,"Sub-basin 2"
1605,800,245,2100,2900,"Sub-basin 2"
1606,4300,1075,9500,13800,"Sub-basin 2"
1607,400,51,1400,1800,"Sub-basin 2"
1608,300,11,2400,2700,"Sub-basin 2"
1609,200,3,2600,2800,"Sub-basin 2"
1610,600,14,1700,2300,"Sub-basin 2"
1611,62000,4329.3843,92800,154800,"Sub-basin 2"
1612,200,4,2200,2400,"Sub-basin 2"
1613,1600,375,4600,6200,"Sub-basin 2"
1614,4700,1463,6800,11500,"Sub-basin 2"
1615,1700,480,4000,5700,"Sub-basin 2"
1616,400,58,2200,2600,"Sub-basin 2"
1617,400,17,2600,3000,"Sub-basin 2"
1618,100,3,2800,2900,"Sub-basin 2"
1619,200,13,1000,1200,"Sub-basin 2"
1620,100,1,1700,1800,"Sub-basin 2"
1621,100,2,900,1000,"Sub-basin 2"
1622,400,15.0039,2200,2600,"Sub-basin 2"
1623,1000,37,3400,4400,"Sub-basin 2"
1624,100,3,1700,1800,"Sub-basin 2"
1625,100,3,3400,3500,"Sub-basin 2"
1626,2400,498,6000,8400,"Sub-basin 2"
1627,8100,2071,14400,22500,"Sub-basin 2"
1628,2000,154,6900,8900,"Sub-basin 2"
1629,2600,874,7800,10400,"Sub-basin 2"
1630,400,11,3500,3900,"Sub-basin 2"
1631,100,3,800,900,"Sub-basin 2"
1632,700,108,2200,2900,"Sub-basin 2"
1633,800,86,1200,2000,"Sub-basin 2"
1634,500,50,2600,3100,"Sub-basin 2"
1635,900,84,3700,4600,"Sub-basin 2"
1636,200,7,1100,1300,"Sub-basin 2"
1637,200,21,2100,2300,"Sub-basin 2"
1638,400,78,2600,3000,"Sub-basin 2"
1639,400,55,3600,4000,"Sub-basin 2"
1640,500,27,5900,6400,"Sub-basin 2"
1641,4700,173,21200,25900,"Sub-basin 2"
1642,100,2.0006,200,300,"Sub-basin 2"
1643,200,10,2400,2600,"Sub-basin 2"
1644,9600,2203,15500,25100,"Sub-basin 2"
1645,2000,433,6100,8100,"Sub-basin 2"
1646,5900,1746,11500,17400,"Sub-basin 2"
1647,3500,473,12900,16400,"Sub-basin 2"
1648,100,1,2000,2100,"Sub-basin 2"
1649,2600,233,13300,15900,"Sub-basin 2"
1650,2200,262,8100,10300,"Sub-basin 2"
1651,1400,330,4800,6200,"Sub-basin 2"
1652,600,18,1600,2200,"Sub-basin 2"
1653,1100,304,4000,5100,"Sub-basin 2"
1654,500,53,2300,2800,"Sub-basin 2"
1655,700,124,1400,2100,"Sub-basin 2"
1656,300,9.0003,1500,1800,"Sub-basin 2"
1657,1000,143,3200,4200,"Sub-basin 2"
1658,18800,6083,32600,51400,"Sub-basin 2"
1659,900,122,3000,3900,"Sub-basin 2"
1660,2500,822,3800,6300,"Sub-basin 2"
1661,39400,3266,64900,104300,"Sub-basin 2"
1662,1000,100,4400,5400,"Sub-basin 2"
1663,100,7,1200,1300,"Sub-basin 2"
1664,300,41,1200,1500,"Sub-basin 2"
1665,2300,628,4300,6600,"Sub-basin 2"
1666,24500,9625,31700,56200,"Sub-basin 2"
1667,400,11,2300,2700,"Sub-basin 2"
1668,6500,698,13700,20200,"Sub-basin 2"
1669,1600,226,4400,6000,"Sub-basin 2"
1670,400,19,5500,5900,"Sub-basin 2"
1671,1400,62,11500,12900,"Sub-basin 2"
1672,100,2,700,800,"Sub-basin 2"
1673,2400,1190,3000,5400,"Sub-basin 2"
1674,800,123,2100,2900,"Sub-basin 2"
1675,200,15,1600,1800,"Sub-basin 2"
1676,100,2,800,900,"Sub-basin 2"
1677,8400,1261,14600,23000,"Sub-basin 2"
1678,2900,550,7200,10100,"Sub-basin 2"
1679,600,74,2200,2800,"Sub-basin 2"
1680,900,201,1800,2700,"Sub-basin 2"
1681,200,10,2000,2200,"Sub-basin 2"
1682,2400,386,10200,12600,"Sub-basin 2"
1683,16400,6921.67,20600,37000,"Sub-basin 2"
1684,100,3,500,600,"Sub-basin 2"
1685,700,135,1800,2500,"Sub-basin 2"
1686,200,5,2200,2400,"Sub-basin 2"
1687,100,2,600,700,"Sub-basin 2"
1688,200,12,2700,2900,"Sub-basin 2"
1689,1200,175,4600,5800,"Sub-basin 2"
1690,4600,1254,9300,13900,"Sub-basin 2"
1691,100,25,1700,1800,"Sub-basin 2"
1692,200,12,600,800,"Sub-basin 2"
1693,100,1,600,700,"Sub-basin 2"
1694,500,162,2000,2500,"Sub-basin 2"
1695,100,1,1200,1300,"Sub-basin 2"
1696,300,7,2600,2900,"Sub-basin 2"
1697,2900,652,9500,12400,"Sub-basin 2"
1698,100,1,800,900,"Sub-basin 2"
1699,400,9,5100,5500,"Sub-basin 2"
1700,100,2.0005,400,500,"Sub-basin 2"
1701,1800,465,2300,4100,"Sub-basin 2"
1702,1600,227,4200,5800,"Sub-basin 2"
1703,400,34,2700,3100,"Sub-basin 2"
1704,23200,12143,27300,50500,"Sub-basin 2"
1705,2000,137,6700,8700,"Sub-basin 2"
1706,600,92,2100,2700,"Sub-basin 2"
1707,100,2,900,1000,"Sub-basin 2"
1708,22300,11110,20500,42800,"Sub-basin 2"
1709,3400,536,5800,9200,"Sub-basin 2"
1710,100,1,800,900,"Sub-basin 2"
1711,600,81,4200,4800,"Sub-basin 2"
1712,200,3,600,800,"Sub-basin 2"
1713,600,37,2600,3200,"Sub-basin 2"
1714,800,32,2600,3400,"Sub-basin 2"
1715,1200,398,5200,6400,"Sub-basin 2"
1716,200,8,900,1100,"Sub-basin 2"
1717,1300,309,4300,5600,"Sub-basin 2"
1718,800,207,2000,2800,"Sub-basin 2"
1719,1300,99,5700,7000,"Sub-basin 2"
1720,300,18,1500,1800,"Sub-basin 2"
1721,700,200,2800,3500,"Sub-basin 2"
1722,2500,686,5800,8300,"Sub-basin 2"
1723,2600,317,9800,12400,"Sub-basin 2"
1724,600,29,700,1300,"Sub-basin 2"
1725,200,5,1400,1600,"Sub-basin 2"
1726,9900,402,18000,27900,"Sub-basin 2"
1727,800,135,2300,3100,"Sub-basin 2"
1728,400,12,3100,3500,"Sub-basin 2"
1729,300,26,2500,2800,"Sub-basin 2"
1730,800,131,2500,3300,"Sub-basin 2"
1731,1700,115,12200,13900,"Sub-basin 2"
1732,200,6.0004,1000,1200,"Sub-basin 2"
1733,1400,151,9000,10400,"Sub-basin 2"
1734,1300,53,2300,3600,"Sub-basin 2"
1735,600,56,2800,3400,"Sub-basin 2"
1736,100,7,700,800,"Sub-basin 2"
1737,300,25,2200,2500,"Sub-basin 2"
1738,100,8,1000,1100,"Sub-basin 2"
1739,5000,379,22200,27200,"Sub-basin 2"
1740,800,15.0021,7900,8700,"Sub-basin 2"
1741,200,26,1300,1500,"Sub-basin 2"
1742,600,74,4100,4700,"Sub-basin 2"
1743,1900,569,4200,6100,"Sub-basin 2"
1744,500,14,2600,3100,"Sub-basin 2"
1745,500,27,5400,5900,"Sub-basin 2"
1746,3700,456,10600,14300,"Sub-basin 2"
1747,100,2,800,900,"Sub-basin 2"
1748,8800,3805,8000,16800,"Sub-basin 2"
1749,100,2,900,1000,"Sub-basin 2"
1750,7300,883,16300,23600,"Sub-basin 2"
1751,900,81,6200,7100,"Sub-basin 2"
1752,500,69,3400,3900,"Sub-basin 2"
1753,16600,5633,30500,47100,"Sub-basin 2"
1754,800,69,2700,3500,"Sub-basin 2"
1755,1300,90,4500,5800,"Sub-basin 2"
1756,100,8,1100,1200,"Sub-basin 2"
1757,700,36,3500,4200,"Sub-basin 2"
1758,200,9,400,600,"Sub-basin 2"
1759,1700,883,7500,9200,"Sub-basin 2"
1760,400,14,2400,2800,"Sub-basin 2"
1761,100,1,2200,2300,"Sub-basin 2"
1762,1200,148,5300,6500,"Sub-basin 2"
1763,6100,865,13500,19600,"Sub-basin 2"
1764,1400,151,4900,6300,"Sub-basin 2"
1765,1300,196,3800,5100,"Sub-basin 2"
1766,100,1,700,800,"Sub-basin 2"
1767,400,49,2500,2900,"Sub-basin 2"
1768,600,30,800,1400,"Sub-basin 2"
1769,100,6,1300,1400,"Sub-basin 2"
1770,1400,138,8100,9500,"Sub-basin 2"
1771,6000,760.0466,28200,34200,"Sub-basin 2"
1772,300,17.0042,3300,3600,"Sub-basin 2"
1773,600,103,2400,3000,"Sub-basin 2"
1774,300,21,1700,2000,"Sub-basin 2"
1775,800,108,4300,5100,"Sub-basin 2"
1776,2800,723,4800,7600,"Sub-basin 2"
1777,5900,2108,12600,18500,"Sub-basin 2"
1778,400,22,2900,3300,"Sub-basin 2"
1779,69100,14722,102400,171500,"Sub-basin 2"
1780,100,3,900,1000,"Sub-basin 2"
1781,3400,1053,4100,7500,"Sub-basin 2"
1782,3000,911,6900,9900,"Sub-basin 2"
1783,500,17,2800,3300,"Sub-basin 2"
1784,15700,1481,33000,48700,"Sub-basin 2"
1785,100,1,1700,1800,"Sub-basin 2"
1786,100,1,800,900,"Sub-basin 2"
1787,100,5,1300,1400,"Sub-basin 2"
1788,200,7,1100,1300,"Sub-basin 2"
1789,400,47,1300,1700,"Sub-basin 2"
1790,200,11,1700,1900,"Sub-basin 2"
1791,400,18,4200,4600,"Sub-basin 2"
1792,200,6,1000,1200,"Sub-basin 2"
1793,100,2,300,400,"Sub-basin 2"
1794,100,1,1000,1100,"Sub-basin 2"
1795,600,22,2700,3300,"Sub-basin 2"
1796,200,6,1200,1400,"Sub-basin 2"
1797,600,86,1200,1800,"Sub-basin 2"
1798,600,60,2100,2700,"Sub-basin 2"
1799,2300,175,8800,11100,"Sub-basin 2"
1800,1900,256,8900,10800,"Sub-basin 2"
1801,100,3,700,800,"Sub-basin 2"
1802,300,15,1700,2000,"Sub-basin 2"
1803,900,103,5600,6500,"Sub-basin 2"
1804,500,121,5100,5600,"Sub-basin 2"
1805,1100,61,4600,5700,"Sub-basin 2"
1806,300,10,2300,2600,"Sub-basin 2"
1807,5100,1457,10000,15100,"Sub-basin 2"
1808,2000,789,3700,5700,"Sub-basin 2"
1809,600,51,3800,4400,"Sub-basin 2"
1810,16200,6663,16800,33000,"Sub-basin 2"
1811,100,1,900,1000,"Sub-basin 2"
1812,1200,45,5300,6500,"Sub-basin 2"
1813,1200,169,2000,3200,"Sub-basin 2"
1814,600,42,3000,3600,"Sub-basin 2"
1815,2100,547,5500,7600,"Sub-basin 2"
1816,200,5,1400,1600,"Sub-basin 2"
1817,300,29,2500,2800,"Sub-basin 2"
1818,300,30,2500,2800,"Sub-basin 2"
1819,2400,201,5000,7400,"Sub-basin 2"
1820,400,23,200,600,"Sub-basin 2"
1821,3500,962,8500,12000,"Sub-basin 2"
1822,1000,124,3900,4900,"Sub-basin 2"
1823,4200,656,16400,20600,"Sub-basin 2"
1824,6900,847,16500,23400,"Sub-basin 2"
1825,3600,1283,7000,10600,"Sub-basin 2"
1826,100,1,1300,1400,"Sub-basin 2"
1827,600,31,4400,5000,"Sub-basin 2"
1828,200,3,500,700,"Sub-basin 2"
1829,300,19,1400,1700,"Sub-basin 2"
1830,6700,3005,7900,14600,"Sub-basin 2"
1831,2100,258,9400,11500,"Sub-basin 2"
1832,300,15,2100,2400,"Sub-basin 2"
1833,1500,445,5100,6600,"Sub-basin 2"
1834,400,6,2600,3000,"Sub-basin 2"
1835,800,64,4300,5100,"Sub-basin 2"
1836,1300,98,5500,6800,"Sub-basin 2"
1837,5100,1258,7900,13000,"Sub-basin 2"
1838,100,3,1200,1300,"Sub-basin 2"
1839,10500,2609,22900,33400,"Sub-basin 2"
1840,1100,97,3400,4500,"Sub-basin 2"
1841,3100,809,6200,9300,"Sub-basin 2"
1842,400,14,4500,4900,"Sub-basin 2"
1843,200,10,1900,2100,"Sub-basin 2"
1844,2800,591,4200,7000,"Sub-basin 2"
1845,100,4,1000,1100,"Sub-basin 2"
1846,7400,1044,15500,22900,"Sub-basin 2"
1847,300,29,3000,3300,"Sub-basin 2"
1848,1400,130,7500,8900,"Sub-basin 2"
1849,200,7,1000,1200,"Sub-basin 2"
1850,1900,149,6100,8000,"Sub-basin 2"
1851,3300,713,8300,11600,"Sub-basin 2"
1852,900,235,2700,3600,"Sub-basin 2"
1853,100,1,1300,1400,"Sub-basin 2"
1854,800,70,5800,6600,"Sub-basin 2"
1855,36000,8548,52900,88900,"Sub-basin 2"
1856,100,1,1000,1100,"Sub-basin 2"
1857,800,32,3000,3800,"Sub-basin 2"
1858,600,101,900,1500,"Sub-basin 2"
1859,1100,154,5300,6400,"Sub-basin 2"
1860,100,9,800,900,"Sub-basin 2"
1861,900,18,4100,5000,"Sub-basin 2"
1862,500,27,3900,4400,"Sub-basin 2"
1863,1400,91,3500,4900,"Sub-basin 2"
1864,1800,218,4500,6300,"Sub-basin 2"
1865,200,6,2200,2400,"Sub-basin 2"
1866,100,2,400,500,"Sub-basin 2"
1867,1700,205,5400,7100,"Sub-basin 2"
1868,800,31,2300,3100,"Sub-basin 2"
1869,100,3,700,800,"Sub-basin 2"
1870,1700,237.5,6600,8300,"Sub-basin 2"
1871,100,1,1500,1600,"Sub-basin 2"
1872,27600,2025,47000,74600,"Sub-basin 2"
1873,3800,1698,5800,9600,"Sub-basin 2"
1874,900,106,2500,3400,"Sub-basin 2"
1875,800,78,5700,6500,"Sub-basin 2"
1876,100,4.0002,1400,1500,"Sub-basin 2"
1877,4600,799,11000,15600,"Sub-basin 2"
1878,6100,2311,3900,10000,"Sub-basin 2"
1879,900,24,5600,6500,"Sub-basin 2"
1880,2100,629,4400,6500,"Sub-basin 2"
1881,100,3,1300,1400,"Sub-basin 2"
1882,600,26,2600,3200,"Sub-basin 2"
1883,200,6,600,800,"Sub-basin 2"
1884,800,41,4800,5600,"Sub-basin 2"
1885,100,2,1000,1100,"Sub-basin 2"
1886,7900,2050,12900,20800,"Sub-basin 2"
1887,300,18,1100,1400,"Sub-basin 2"
1888,24900,4947,35700,60600,"Sub-basin 2"
1889,13500,3849,15700,29200,"Sub-basin 2"
1890,900,97,4800,5700,"Sub-basin 2"
1891,200,14.0005,2300,2500,"Sub-basin 2"
1892,8200,1999,12100,20300,"Sub-basin 2"
1893,100,2,900,1000,"Sub-basin 2"
1894,200,16,900,1100,"Sub-basin 2"
1895,800,66,3800,4600,"Sub-basin 2"
1896,300,25,1200,1500,"Sub-basin 2"
1897,400,10,800,1200,"Sub-basin 2"
1898,3300,328,8100,11400,"Sub-basin 2"
1899,100,1,700,800,"Sub-basin 2"
1900,700,19,5400,6100,"Sub-basin 2"
1901,500,26,2900,3400,"Sub-basin 2"
1902,900,123,1600,2500,"Sub-basin 2"
1903,100,5,1200,1300,"Sub-basin 2"
1904,800,80,6200,7000,"Sub-basin 2"
1905,3700,632,11300,15000,"Sub-basin 2"
1906,600,47,2800,3400,"Sub-basin 2"
1907,13300,2178,22200,35500,"Sub-basin 2"
1908,300,9,1000,1300,"Sub-basin 2"
1909,700,115,3700,4400,"Sub-basin 2"
1910,500,45,4200,4700,"Sub-basin 2"
1911,300,11.0011,4600,4900,"Sub-basin 2"
1912,7100,3170,15000,22100,"Sub-basin 2"
1913,2100,462,4400,6500,"Sub-basin 2"
1914,400,19,3700,4100,"Sub-basin 2"
1915,1900,215,10000,11900,"Sub-basin 2"
1916,1100,100,8900,10000,"Sub-basin 2"
1917,1100,204,4900,6000,"Sub-basin 2"
1918,300,37,1600,1900,"Sub-basin 2"
1919,200,6,900,1100,"Sub-basin 2"
1920,1800,260,10700,12500,"Sub-basin 2"
1921,100,1,700,800,"Sub-basin 2"
1922,100,2,500,600,"Sub-basin 2"
1923,500,76,1300,1800,"Sub-basin 2"
1924,9700,4870,10300,20000,"Sub-basin 2"
1925,1400,245,2000,3400,"Sub-basin 2"
1926,500,78,2700,3200,"Sub-basin 2"
1927,500,61,4000,4500,"Sub-basin 2"
1928,100,1,1000,1100,"Sub-basin 2"
1929,700,42,4100,4800,"Sub-basin 2"
1930,1900,295,8000,9900,"Sub-basin 2"
1931,12100,2049.0354,45200,57300,"Sub-basin 2"
1932,300,5,1300,1600,"Sub-basin 2"
1933,1100,210,2200,3300,"Sub-basin 2"
1934,400,37,1100,1500,"Sub-basin 2"
1935,3500,1194,9300,12800,"Sub-basin 2"
1936,100,1,700,800,"Sub-basin 2"
1937,400,51,3800,4200,"Sub-basin 2"
1938,3600,980,7000,10600,"Sub-basin 2"
1939,100,2,400,500,"Sub-basin 2"
1940,300,9,2200,2500,"Sub-basin 2"
1941,1100,498,3200,4300,"Sub-basin 2"
1942,100,2,900,1000,"Sub-basin 2"
1943,1600,63,8000,9600,"Sub-basin 2"
1944,6700,2195,6700,13400,"Sub-basin 2"
1945,400,14,1800,2200,"Sub-basin 2"
1946,600,68,1800,2400,"Sub-basin 2"
1947,400,39,3300,3700,"Sub-basin 2"
1948,400,28,2200,2600,"Sub-basin 2"
1949,500,63,4400,4900,"Sub-basin 2"
1950,300,5,2100,2400,"Sub-basin 2"
1951,1200,146,4300,5500,"Sub-basin 2"
1952,800,62,2100,2900,"Sub-basin 2"
1953,18100,1257,44100,62200,"Sub-basin 2"
1954,2000,416,5100,7100,"Sub-basin 2"
1955,2100,673,6000,8100,"Sub-basin 2"
1956,700,219,2900,3600,"Sub-basin 2"
1957,14600,4054,26000,40600,"Sub-basin 2"
1958,100,1,700,800,"Sub-basin 2"
1959,600,55,3900,4500,"Sub-basin 2"
1960,1700,296,5400,7100,"Sub-basin 2"
1961,8000,2885,14900,22900,"Sub-basin 2"
1962,27800,4184.0554,60200,88000,"Sub-basin 2"
1963,2800,231,6200,9000,"Sub-basin 2"
1964,2600,128,7800,10400,"Sub-basin 2"
1965,100,4,1200,1300,"Sub-basin 2"
1966,600,41,2600,3200,"Sub-basin 2"
1967,600,41,6200,6800,"Sub-basin 2"
1968,100,2,300,400,"Sub-basin 2"
1969,400,22,3300,3700,"Sub-basin 2"
1970,300,5,2700,3000,"Sub-basin 2"
1971,4600,720,12300,16900,"Sub-basin 2"
1972,300,10,2900,3200,"Sub-basin 2"
1973,600,90,1700,2300,"Sub-basin 2"
1974,100,2,1000,1100,"Sub-basin 2"
1975,2200,236,11200,13400,"Sub-basin 2"
1976,100,1,2600,2700,"Sub-basin 2"
1977,500,37,4300,4800,"Sub-basin 2"
1978,100,2,1600,1700,"Sub-basin 2"
1979,200,3,1200,1400,"Sub-basin 2"
1980,300,13,5900,6200,"Sub-basin 2"
1981,100,1,800,900,"Sub-basin 2"
1982,700,27,7900,8600,"Sub-basin 2"
1983,700,62,5300,6000,"Sub-basin 2"
1984,100,1,1100,1200,"Sub-basin 2"
1985,200,2,900,1100,"Sub-basin 2"
1986,1200,111,6400,7600,"Sub-basin 2"
1987,200,5,1400,1600,"Sub-basin 2"
1988,100,3,900,1000,"Sub-basin 2"
1989,19200,4006,39900,59100,"Sub-basin 2"
1990,400,57,1900,2300,"Sub-basin 2"
1991,400,16,2800,3200,"Sub-basin 2"
1992,800,135,3400,4200,"Sub-basin 2"
1993,400,87,2800,3200,"Sub-basin 2"
1994,100,4,700,800,"Sub-basin 2"
1995,400,15,3100,3500,"Sub-basin 2"
1996,9400,2916,17500,26900,"Sub-basin 2"
1997,8700,1586,24800,33500,"Sub-basin 2"
1998,500,42,2300,2800,"Sub-basin 2"
1999,1700,246,8900,10600,"Sub-basin 2"
2000,900,64,9700,10600,"Sub-basin 2"
2001,15400,2161.17,19700,35100,"Sub-basin 2"
2002,6100,1198,15500,21600,"Sub-basin 2"
2003,100,3,700,800,"Sub-basin 2"
2004,100,1,700,800,"Sub-basin 2"
2005,300,8,1100,1400,"Sub-basin 2"
2006,2100,276,14600,16700,"Sub-basin 2"
2007,18700,1400,43100,61800,"Sub-basin 2"
2008,200,3,2500,2700,"Sub-basin 2"
2009,1500,97,8900,10400,"Sub-basin 2"
2010,37500,8356,64200,101700,"Sub-basin 2"
2011,1100,105,3300,4400,"Sub-basin 2"
2012,2200,250,8600,10800,"Sub-basin 2"
2013,1000,133,4600,5600,"Sub-basin 2"
2014,300,14,1300,1600,"Sub-basin 2"
2015,1300,201.66,7100,8400,"Sub-basin 2"
2016,400,35,1900,2300,"Sub-basin 2"
2017,600,65,7500,8100,"Sub-basin 2"
2018,100,1,2100,2200,"Sub-basin 2"
2019,1900,332,5200,7100,"Sub-basin 2"
2020,100,17,0,100,"Sub-basin 2"
2021,200,7,1400,1600,"Sub-basin 2"
2022,100,7,900,1000,"Sub-basin 2"
2023,2200,576,11300,13500,"Sub-basin 2"
2024,1200,386,4300,5500,"Sub-basin 2"
2025,100,1,200,300,"Sub-basin 2"
2026,1600,258,6300,7900,"Sub-basin 2"
2027,3000,351,7900,10900,"Sub-basin 2"
2028,7800,1958,11600,19400,"Sub-basin 2"
2029,2300,542,7900,10200,"Sub-basin 2"
2030,800,143,2000,2800,"Sub-basin 2"
2031,300,20,700,1000,"Sub-basin 2"
2032,1800,230,8400,10200,"Sub-basin 2"
2033,500,24,2200,2700,"Sub-basin 2"
2034,500,22,2900,3400,"Sub-basin 2"
2035,200,6,1900,2100,"Sub-basin 2"
2036,100,4,200,300,"Sub-basin 2"
2037,4000,253,22600,26600,"Sub-basin 2"
2038,300,15,900,1200,"Sub-basin 2"
2039,1200,226,2500,3700,"Sub-basin 2"
2040,800,81,2800,3600,"Sub-basin 2"
2041,100,1,1100,1200,"Sub-basin 2"
2042,600,97,2600,3200,"Sub-basin 2"
2043,100,1,1600,1700,"Sub-basin 2"
2044,3200,1163,6400,9600,"Sub-basin 2"
2045,100,1,900,1000,"Sub-basin 2"
2046,100,1,1200,1300,"Sub-basin 2"
2047,200,7,2500,2700,"Sub-basin 2"
2048,200,5,3600,3800,"Sub-basin 2"
2049,100,6,1000,1100,"Sub-basin 2"
2050,100,4,1100,1200,"Sub-basin 2"
2051,200,9,900,1100,"Sub-basin 2"
2052,700,26,6800,7500,"Sub-basin 2"
2053,1200,292,3200,4400,"Sub-basin 2"
2054,6900,1117,17700,24600,"Sub-basin 2"
2055,100,7,400,500,"Sub-basin 2"
2056,400,72,2900,3300,"Sub-basin 2"
2057,600,58,5100,5700,"Sub-basin 2"
2058,400,20,400,800,"Sub-basin 2"
2059,400,21,2100,2500,"Sub-basin 2"
2060,2500,677,5000,7500,"Sub-basin 2"
2061,200,9,1000,1200,"Sub-basin 2"
2062,1500,316,9000,10500,"Sub-basin 2"
2063,500,24,4700,5200,"Sub-basin 2"
2064,1400,126,4900,6300,"Sub-basin 2"
2065,5800,206,24700,30500,"Sub-basin 2"
2066,1900,181,7700,9600,"Sub-basin 2"
2067,900,230,3500,4400,"Sub-basin 2"
2068,200,2,2000,2200,"Sub-basin 2"
2069,600,63,4500,5100,"Sub-basin 2"
2070,100,1,900,1000,"Sub-basin 2"
2071,1800,85,6100,7900,"Sub-basin 2"
2072,1100,125,5300,6400,"Sub-basin 2"
2073,900,49,8600,9500,"Sub-basin 2"
2074,2200,237.83,19700,21900,"Sub-basin 2"
2075,800,43,10500,11300,"Sub-basin 2"
2076,2000,352,5400,7400,"Sub-basin 2"
2077,2400,782,12900,15300,"Sub-basin 2"
2078,8100,981,19500,27600,"Sub-basin 2"
2079,2900,480,8000,10900,"Sub-basin 2"
2080,200,13,1100,1300,"Sub-basin 2"
2081,200,6,2400,2600,"Sub-basin 2"
2082,400,38,4400,4800,"Sub-basin 2"
2083,200,18,500,700,"Sub-basin 2"
2084,900,139,6200,7100,"Sub-basin 2"
2085,200,5,900,1100,"Sub-basin 2"
2086,100,2,800,900,"Sub-basin 2"
2087,700,61,2900,3600,"Sub-basin 2"
2088,200,9,1500,1700,"Sub-basin 2"
2089,700,38,2300,3000,"Sub-basin 2"
2090,1500,163,2900,4400,"Sub-basin 2"
2091,100,3,700,800,"Sub-basin 2"
2092,100,17,1600,1700,"Sub-basin 2"
2093,500,35.17,3200,3700,"Sub-basin 2"
2094,1200,450.17,1800,3000,"Sub-basin 2"
2095,500,36,1400,1900,"Sub-basin 2"
2096,100,4,1100,1200,"Sub-basin 2"
2097,100,6,700,800,"Sub-basin 2"
2098,7300,2283,13700,21000,"Sub-basin 2"
2099,200,4,1800,2000,"Sub-basin 2"
2100,300,11,6300,6600,"Sub-basin 2"
2101,43500,8311,50200,93700,"Sub-basin 2"
2102,100,1,700,800,"Sub-basin 2"
2103,11200,3671,9200,20400,"Sub-basin 2"
2104,13500,1594,20900,34400,"Sub-basin 2"
2105,7300,1152,27200,34500,"Sub-basin 2"
2106,2200,215,6700,8900,"Sub-basin 2"
2107,700,133,2700,3400,"Sub-basin 2"
2108,300,19,1300,1600,"Sub-basin 2"
2109,800,287,4200,5000,"Sub-basin 2"
2110,900,32,5200,6100,"Sub-basin 2"
2111,300,18,1200,1500,"Sub-basin 2"
2112,12300,1649,23500,35800,"Sub-basin 2"
2113,1300,140,3700,5000,"Sub-basin 2"
2114,900,187,3300,4200,"Sub-basin 2"
2115,1300,93,14900,16200,"Sub-basin 2"
2116,500,57,2400,2900,"Sub-basin 2"
2117,500,55,1700,2200,"Sub-basin 2"
2118,100,2,1100,1200,"Sub-basin 2"
2119,200,6,1700,1900,"Sub-basin 2"
2120,300,11,700,1000,"Sub-basin 2"
2121,200,11,1800,2000,"Sub-basin 2"
2122,2200,79,9000,11200,"Sub-basin 2"
2123,100,1,900,1000,"Sub-basin 2"
2124,1300,259,3800,5100,"Sub-basin 2"
2125,1500,188,5900,7400,"Sub-basin 2"
2126,200,16,1300,1500,"Sub-basin 2"
2127,1800,196,4300,6100,"Sub-basin 2"
2128,100,1,800,900,"Sub-basin 2"
2129,1100,242,4500,5600,"Sub-basin 2"
2130,100,2,800,900,"Sub-basin 2"
2131,200,6,1000,1200,"Sub-basin 2"
2132,100,1,500,600,"Sub-basin 2"
2133,100,2,400,500,"Sub-basin 2"
2134,200,6,4400,4600,"Sub-basin 2"
2135,400,21,4600,5000,"Sub-basin 2"
2136,1800,352,5700,7500,"Sub-basin 2"
2137,200,11,900,1100,"Sub-basin 2"
2138,3300,333,10500,13800,"Sub-basin 2"
2139,100,1,500,600,"Sub-basin 2"
2140,300,19,1500,1800,"Sub-basin 2"
2141,200,7,900,1100,"Sub-basin 2"
2142,1700,131,8600,10300,"Sub-basin 2"
2143,100,2,1900,2000,"Sub-basin 2"
2144,1200,40.0013,6000,7200,"Sub-basin 2"
2145,200,9,900,1100,"Sub-basin 2"
2146,200,9,1500,1700,"Sub-basin 2"
2147,100,1,1300,1400,"Sub-basin 2"
2148,32400,3877,44800,77200,"Sub-basin 2"
2149,4800,223.33,13400,18200,"Sub-basin 2"
2150,100,5,900,1000,"Sub-basin 2"
2151,200,12,1700,1900,"Sub-basin 2"
2152,1800,195,7200,9000,"Sub-basin 2"
2153,800,45,3300,4100,"Sub-basin 2"
2154,100,2,2400,2500,"Sub-basin 2"
2155,9000,3978,6400,15400,"Sub-basin 2"
2156,100,1,600,700,"Sub-basin 2"
2157,200,9,2500,2700,"Sub-basin 2"
2158,200,10,2300,2500,"Sub-basin 2"
2159,400,9,2800,3200,"Sub-basin 2"
2160,200,3,2100,2300,"Sub-basin 2"
2161,300,4,3700,4000,"Sub-basin 2"
2162,1100,73,10100,11200,"Sub-basin 2"
2163,1500,290,2000,3500,"Sub-basin 2"
2164,1100,32,5100,6200,"Sub-basin 2"
2165,200,9,1700,1900,"Sub-basin 2"
2166,700,78,4900,5600,"Sub-basin 2"
2167,1300,372,2500,3800,"Sub-basin 2"
2168,5100,2161,6600,11700,"Sub-basin 2"
2169,12100,4328,18300,30400,"Sub-basin 2"
2170,200,11,1700,1900,"Sub-basin 2"
2171,300,23,2100,2400,"Sub-basin 2"
2172,100,2,500,600,"Sub-basin 2"
2173,1000,174,1700,2700,"Sub-basin 2"
2174,10200,1462,21800,32000,"Sub-basin 2"
2175,200,4,1400,1600,"Sub-basin 2"
2176,100,2,1500,1600,"Sub-basin 2"
2177,1200,402,2100,3300,"Sub-basin 2"
2178,3600,1563,3400,7000,"Sub-basin 2"
2179,1100,146,4400,5500,"Sub-basin 2"
2180,1900,111,12600,14500,"Sub-basin 2"
2181,1900,492,3100,5000,"Sub-basin 2"
2182,100,2,1500,1600,"Sub-basin 2"
2183,700,24.0007,5000,5700,"Sub-basin 2"
2184,300,8.0003,1700,2000,"Sub-basin 2"
2185,2300,254,7600,9900,"Sub-basin 2"
2186,1600,267,5300,6900,"Sub-basin 2"
2187,200,11,1200,1400,"Sub-basin 2"
2188,7700,841,30800,38500,"Sub-basin 2"
2189,1500,195,10800,12300,"Sub-basin 2"
2190,400,44,2700,3100,"Sub-basin 2"
2191,100,6,800,900,"Sub-basin 2"
2192,1200,133,6000,7200,"Sub-basin 2"
2193,100,1.0004,1100,1200,"Sub-basin 2"
2194,7500,2367,19100,26600,"Sub-basin 2"
2195,100,37,1100,1200,"Sub-basin 2"
2196,2100,260,9900,12000,"Sub-basin 2"
2197,100,1,1200,1300,"Sub-basin 2"
2198,900,155,1700,2600,"Sub-basin 2"
2199,1000,235,4500,5500,"Sub-basin 2"
2200,48800,2519.0655,76500,125300,"Sub-basin 2"
2201,400,15,5500,5900,"Sub-basin 2"
2202,2600,571,3700,6300,"Sub-basin 2"
2203,14900,4143,17900,32800,"Sub-basin 2"
2204,4800,792,10900,15700,"Sub-basin 2"
2205,7600,351,22600,30200,"Sub-basin 2"
2206,800,144,1300,2100,"Sub-basin 2"
2207,300,9.0003,2400,2700,"Sub-basin 2"
2208,6800,1112,19600,26400,"Sub-basin 2"
2209,3200,813,5500,8700,"Sub-basin 2"
2210,900,399,7700,8600,"Sub-basin 2"
2211,300,11,3700,4000,"Sub-basin 2"
2212,2900,1036,9500,12400,"Sub-basin 2"
2213,100,1,500,600,"Sub-basin 2"
2214,300,17,3500,3800,"Sub-basin 2"
2215,1400,236,1800,3200,"Sub-basin 2"
2216,200,6,1500,1700,"Sub-basin 2"
2217,2900,728,8200,11100,"Sub-basin 2"
2218,100,4,1300,1400,"Sub-basin 2"
2219,100,1,1800,1900,"Sub-basin 2"
2220,100,5,2200,2300,"Sub-basin 2"
2221,400,43,2900,3300,"Sub-basin 2"
2222,100,1,500,600,"Sub-basin 2"
2223,200,5,700,900,"Sub-basin 2"
2224,100,1,500,600,"Sub-basin 2"
2225,1400,479,4600,6000,"Sub-basin 2"
2226,100,7,1200,1300,"Sub-basin 2"
2227,400,26,2600,3000,"Sub-basin 2"
2228,500,61,1300,1800,"Sub-basin 2"
2229,700,162,1200,1900,"Sub-basin 2"
2230,200,6,1100,1300,"Sub-basin 2"
2231,1900,232,9200,11100,"Sub-basin 2"
2232,1100,271,3700,4800,"Sub-basin 2"
2233,500,103,1600,2100,"Sub-basin 2"
2234,200,4,1600,1800,"Sub-basin 2"
2235,900,112,5600,6500,"Sub-basin 2"
2236,700,76,1500,2200,"Sub-basin 2"
2237,100,2,1700,1800,"Sub-basin 2"
2238,100,7,2300,2400,"Sub-basin 2"
2239,2200,311,6500,8700,"Sub-basin 2"
2240,30700,4054,75600,106300,"Sub-basin 2"
2241,100,3,800,900,"Sub-basin 2"
2242,200,22,2200,2400,"Sub-basin 2"
2243,100,1,1600,1700,"Sub-basin 2"
2244,200,4.0002,1300,1500,"Sub-basin 2"
2245,1200,215,1800,3000,"Sub-basin 2"
2246,100,8,1000,1100,"Sub-basin 2"
2247,1200,469,3000,4200,"Sub-basin 2"
2248,400,92,1300,1700,"Sub-basin 2"
2249,100,7,700,800,"Sub-basin 2"
2250,100,1,100,200,"Sub-basin 2"
2251,100,2,1100,1200,"Sub-basin 2"
2252,500,40,4100,4600,"Sub-basin 2"
2253,5600,845,10500,16100,"Sub-basin 2"
2254,200,7,3100,3300,"Sub-basin 2"
2255,9600,640,23500,33100,"Sub-basin 2"
2256,100,2,800,900,"Sub-basin 2"
2257,100,3,1600,1700,"Sub-basin 2"
2258,600,145,900,1500,"Sub-basin 2"
2259,1400,411,2700,4100,"Sub-basin 2"
2260,1000,222,3900,4900,"Sub-basin 2"
2261,300,27,3700,4000,"Sub-basin 2"
2262,100,1.0002,1400,1500,"Sub-basin 2"
2263,5300,489,17000,22300,"Sub-basin 2"
2264,100,3,1100,1200,"Sub-basin 2"
2265,400,54,1600,2000,"Sub-basin 2"
2266,200,3,1300,1500,"Sub-basin 2"
2267,100,3,700,800,"Sub-basin 2"
2268,900,207,3600,4500,"Sub-basin 2"
2269,1100,91,5600,6700,"Sub-basin 2"
2270,1600,278,9200,10800,"Sub-basin 2"
2271,400,53,2300,2700,"Sub-basin 2"
2272,200,18,1700,1900,"Sub-basin 2"
2273,700,52,5100,5800,"Sub-basin 2"
2274,100,1,1000,1100,"Sub-basin 2"
2275,200,11,1000,1200,"Sub-basin 2"
2276,2600,311,8600,11200,"Sub-basin 2"
2277,200,16,2400,2600,"Sub-basin 2"
2278,700,58,4200,4900,"Sub-basin 2"
2279,50700,6809,72600,123300,"Sub-basin 2"
2280,500,39,4200,4700,"Sub-basin 2"
2281,600,89,5100,5700,"Sub-basin 2"
2282,100,4.0001,1100,1200,"Sub-basin 2"
2283,400,291.8396,1800,2200,"Sub-basin 2"
2284,400,48,2800,3200,"Sub-basin 2"
2285,400,44,2200,2600,"Sub-basin 2"
2286,100,16,1100,1200,"Sub-basin 2"
2287,1500,158,9300,10800,"Sub-basin 2"
2288,400,82,3900,4300,"Sub-basin 2"
2289,1600,473,4900,6500,"Sub-basin 2"
2290,1100,84,6600,7700,"Sub-basin 2"
2291,5400,1631,6700,12100,"Sub-basin 2"
2292,1900,581,4900,6800,"Sub-basin 2"
2293,800,226,4900,5700,"Sub-basin 2"
2294,1300,142,8800,10100,"Sub-basin 2"
2295,1100,170,4400,5500,"Sub-basin 2"
2296,500,121,3300,3800,"Sub-basin 2"
2297,200,12,1600,1800,"Sub-basin 2"
2298,200,16,2700,2900,"Sub-basin 2"
2299,900,90,8100,9000,"Sub-basin 2"
2300,100,1,1900,2000,"Sub-basin 2"
2301,100,1,1400,1500,"Sub-basin 2"
2302,8200,1630,12100,20300,"Sub-basin 2"
2303,100,1,1500,1600,"Sub-basin 2"
2304,600,167,1300,1900,"Sub-basin 2"
2305,900,89,2700,3600,"Sub-basin 2"
2306,33300,20447,39300,72600,"Sub-basin 2"
2307,200,3,2300,2500,"Sub-basin 2"
2308,6400,825,39900,46300,"Sub-basin 2"
2309,100,4.0001,1200,1300,"Sub-basin 2"
2310,1000,100,4400,5400,"Sub-basin 2"
2311,200,6,700,900,"Sub-basin 2"
2312,600,85,3600,4200,"Sub-basin 2"
2313,11300,725,33400,44700,"Sub-basin 2"
2314,900,107,6400,7300,"Sub-basin 2"
2315,52800,20408,56300,109100,"Sub-basin 2"
2316,2400,851,4000,6400,"Sub-basin 2"
2317,200,6,2900,3100,"Sub-basin 2"
2318,100,4,800,900,"Sub-basin 2"
2319,1100,128,5100,6200,"Sub-basin 2"
2320,100,2.0003,1700,1800,"Sub-basin 2"
2321,100,3,1500,1600,"Sub-basin 2"
2322,400,23,1700,2100,"Sub-basin 2"
2323,300,7,1200,1500,"Sub-basin 2"
2324,500,18,5400,5900,"Sub-basin 2"
2325,300,15,2700,3000,"Sub-basin 2"
2326,3800,436,23200,27000,"Sub-basin 2"
2327,2500,45.0022,18500,21000,"Sub-basin 2"
2328,100,2,300,400,"Sub-basin 2"
2329,600,217,3800,4400,"Sub-basin 2"
2330,400,39,2500,2900,"Sub-basin 2"
2331,200,7,2300,2500,"Sub-basin 2"
2332,1400,214,3400,4800,"Sub-basin 2"
2333,200,11,200,400,"Sub-basin 2"
2334,400,31,5800,6200,"Sub-basin 2"
2335,700,87,3100,3800,"Sub-basin 2"
2336,1200,186,6000,7200,"Sub-basin 2"
2337,6500,1562,7900,14400,"Sub-basin 2"
2338,1000,375,2200,3200,"Sub-basin 2"
2339,400,30,1900,2300,"Sub-basin 2"
2340,1800,104,9300,11100,"Sub-basin 2"
2341,100,2.0001,600,700,"Sub-basin 2"
2342,100,2,700,800,"Sub-basin 2"
2343,500,32,1700,2200,"Sub-basin 2"
2344,300,16,1600,1900,"Sub-basin 2"
2345,200,9,4500,4700,"Sub-basin 2"
2346,1400,178,7900,9300,"Sub-basin 2"
2347,200,5.0015,1000,1200,"Sub-basin 2"
2348,2100,763,6500,8600,"Sub-basin 2"
2349,300,6,3000,3300,"Sub-basin 2"
2350,100,1,1000,1100,"Sub-basin 2"
2351,600,11.0002,5200,5800,"Sub-basin 2"
2352,400,28,1400,1800,"Sub-basin 2"
2353,1100,41,10100,11200,"Sub-basin 2"
2354,100,1,200,300,"Sub-basin 2"
2355,8800,4293,23100,31900,"Sub-basin 2"
2356,2700,1156,4000,6700,"Sub-basin 2"
2357,2000,42.0077,15100,17100,"Sub-basin 2"
2358,200,5,2300,2500,"Sub-basin 2"
2359,300,34,2300,2600,"Sub-basin 2"
2360,400,88,2500,2900,"Sub-basin 2"
2361,500,65,2000,2500,"Sub-basin 2"
2362,100,1,400,500,"Sub-basin 2"
2363,4700,2640,6900,11600,"Sub-basin 2"
2364,100,4,1400,1500,"Sub-basin 2"
2365,2700,313,20000,22700,"Sub-basin 2"
2366,100,3,1400,1500,"Sub-basin 2"
2367,100,2,2100,2200,"Sub-basin 2"
2368,100,2,900,1000,"Sub-basin 2"
2369,200,3,1800,2000,"Sub-basin 2"
2370,14800,2011,25800,40600,"Sub-basin 2"
2371,3600,1038,10600,14200,"Sub-basin 2"
2372,100,1,1000,1100,"Sub-basin 2"
2373,900,74,7400,8300,"Sub-basin 2"
2374,100,1,600,700,"Sub-basin 2"
2375,11900,1880,33000,44900,"Sub-basin 2"
2376,100,2,900,1000,"Sub-basin 2"
2377,100,1,700,800,"Sub-basin 2"
2378,100,1,1200,1300,"Sub-basin 2"
2379,200,15,700,900,"Sub-basin 2"
2380,500,86,2600,3100,"Sub-basin 2"
2381,1100,139,6100,7200,"Sub-basin 2"
2382,100,2.0002,1200,1300,"Sub-basin 2"
2383,600,56,3500,4100,"Sub-basin 2"
2384,2400,145,13300,15700,"Sub-basin 2"
2385,100,3,1300,1400,"Sub-basin 2"
2386,200,6,1900,2100,"Sub-basin 2"
2387,1300,251,3500,4800,"Sub-basin 2"
2388,44900,22140,43100,88000,"Sub-basin 2"
2389,3700,660,8400,12100,"Sub-basin 2"
2390,400,17,7300,7700,"Sub-basin 2"
2391,1200,435,4600,5800,"Sub-basin 2"
2392,300,21,1700,2000,"Sub-basin 2"
2393,500,45,6000,6500,"Sub-basin 2"
2394,100,4,700,800,"Sub-basin 2"
2395,400,90,1800,2200,"Sub-basin 2"
2396,1200,132,4200,5400,"Sub-basin 2"
2397,400,35,3000,3400,"Sub-basin 2"
2398,3700,530,17900,21600,"Sub-basin 2"
2399,2500,1290,9700,12200,"Sub-basin 2"
2400,400,40,2700,3100,"Sub-basin 2"
2401,900,66.0027,9700,10600,"Sub-basin 2"
2402,2400,541,9900,12300,"Sub-basin 2"
2403,1500,425,4100,5600,"Sub-basin 2"
2404,4500,1097,7800,12300,"Sub-basin 2"
2405,6600,1139,14100,20700,"Sub-basin 2"
2406,100,3,700,800,"Sub-basin 2"
2407,400,21,2700,3100,"Sub-basin 2"
2408,300,16,2300,2600,"Sub-basin 2"
2409,400,44,600,1000,"Sub-basin 2"
2410,800,196,4600,5400,"Sub-basin 2"
2411,500,72,2500,3000,"Sub-basin 2"
2412,6800,1200,11800,18600,"Sub-basin 2"
2413,1100,284,3000,4100,"Sub-basin 2"
2414,3000,1088,6400,9400,"Sub-basin 2"
2415,200,4,2500,2700,"Sub-basin 2"
2416,100,2,900,1000,"Sub-basin 2"
2417,200,3.0006,4000,4200,"Sub-basin 2"
2418,2000,391,2600,4600,"Sub-basin 2"
2419,13400,7637,18800,32200,"Sub-basin 2"
2420,200,17,1100,1300,"Sub-basin 2"
2421,22000,7999,44800,66800,"Sub-basin 2"
2422,100,4,1900,2000,"Sub-basin 2"
2423,4900,1733,10000,14900,"Sub-basin 2"
2424,3000,417,6800,9800,"Sub-basin 2"
2425,700,43,5800,6500,"Sub-basin 2"
2426,46700,16614,55800,102500,"Sub-basin 2"
2427,20700,3604.5,42400,63100,"Sub-basin 2"
2428,100,2.0002,3400,3500,"Sub-basin 2"
2429,200,22,900,1100,"Sub-basin 2"
2430,12200,4890,18200,30400,"Sub-basin 2"
2431,400,20,2600,3000,"Sub-basin 2"
2432,300,9,1600,1900,"Sub-basin 2"
2433,500,36,4900,5400,"Sub-basin 2"
2434,200,4.0002,3700,3900,"Sub-basin 2"
2435,100,2,1800,1900,"Sub-basin 2"
2436,400,20,5700,6100,"Sub-basin 2"
2437,200,4,3200,3400,"Sub-basin 2"
2438,200,10,1800,2000,"Sub-basin 2"
2439,900,153,2600,3500,"Sub-basin 2"
2440,500,70,1800,2300,"Sub-basin 2"
2441,8400,3867,18800,27200,"Sub-basin 2"
2442,1200,68,6400,7600,"Sub-basin 2"
2443,600,18.0007,5000,5600,"Sub-basin 2"
2444,200,6,4400,4600,"Sub-basin 2"
2445,600,46,900,1500,"Sub-basin 2"
2446,100,2,1800,1900,"Sub-basin 2"
2447,700,33,8000,8700,"Sub-basin 2"
2448,400,27,1200,1600,"Sub-basin 2"
2449,18600,6952,30600,49200,"Sub-basin 2"
2450,14400,5455,22200,36600,"Sub-basin 2"
2451,200,3,2100,2300,"Sub-basin 2"
2452,100,1,1400,1500,"Sub-basin 2"
2453,300,19,1800,2100,"Sub-basin 2"
2454,5400,389,21600,27000,"Sub-basin 2"
2455,1500,127,9100,10600,"Sub-basin 2"
2456,9200,510.3075,24700,33900,"Sub-basin 2"
2457,600,17,2400,3000,"Sub-basin 2"
2458,100,1,600,700,"Sub-basin 2"
2459,400,53,3700,4100,"Sub-basin 2"
2460,200,5,3000,3200,"Sub-basin 2"
2461,800,152,2500,3300,"Sub-basin 2"
2462,1200,162,6900,8100,"Sub-basin 2"
2463,600,74,4100,4700,"Sub-basin 2"
2464,400,17,2100,2500,"Sub-basin 2"
2465,900,191,2800,3700,"Sub-basin 2"
2466,13100,4662,22700,35800,"Sub-basin 2"
2467,1000,254,3100,4100,"Sub-basin 2"
2468,1600,356,5500,7100,"Sub-basin 2"
2469,182400,11494.4309,251100,433500,"Sub-basin 2"
2470,6200,1376,16000,22200,"Sub-basin 2"
2471,600,161,4800,5400,"Sub-basin 2"
2472,1000,64,11900,12900,"Sub-basin 2"
2473,10400,556,30600,41000,"Sub-basin 2"
2474,200,11,1300,1500,"Sub-basin 2"
2475,400,27,1300,1700,"Sub-basin 2"
2476,15600,8381.666,12100,27700,"Sub-basin 2"
2477,100,3,1200,1300,"Sub-basin 2"
2478,100,2,200,300,"Sub-basin 2"
2479,600,54,6000,6600,"Sub-basin 2"
2480,1500,166,9000,10500,"Sub-basin 2"
2481,2800,96,7600,10400,"Sub-basin 2"
2482,3700,1741,6300,10000,"Sub-basin 2"
2483,1700,432,3200,4900,"Sub-basin 2"
2484,400,33,1700,2100,"Sub-basin 2"
2485,3100,942,9600,12700,"Sub-basin 2"
2486,500,9.0689,1200,1700,"Sub-basin 2"
2487,200,3,1300,1500,"Sub-basin 2"
2488,100,2,1300,1400,"Sub-basin 2"
2489,900,32,10900,11800,"Sub-basin 2"
2490,500,28,2200,2700,"Sub-basin 2"
2491,1800,210.34,7600,9400,"Sub-basin 2"
2492,200,2,800,1000,"Sub-basin 2"
2493,1200,158,4700,5900,"Sub-basin 2"
2494,1200,214,2900,4100,"Sub-basin 2"
2495,100,1.014,400,500,"Sub-basin 2"
2496,200,7,1700,1900,"Sub-basin 2"
2497,200,3.0275,1200,1400,"Sub-basin 2"
2498,800,121,1600,2400,"Sub-basin 2"
2499,1500,183,4700,6200,"Sub-basin 2"
2500,100,1.0139,500,600,"Sub-basin 2"
2501,1000,174,3900,4900,"Sub-basin 2"
2502,700,120,6700,7400,"Sub-basin 2"
2503,3800,273,16200,20000,"Sub-basin 2"
2504,900,163,2700,3600,"Sub-basin 2"
2505,3000,359,16000,19000,"Sub-basin 2"
2506,400,27,5200,5600,"Sub-basin 2"
2507,200,4,2900,3100,"Sub-basin 2"
2508,79800,21002,75300,155100,"Sub-basin 2"
2509,200,7,2100,2300,"Sub-basin 2"
2510,100,2,1900,2000,"Sub-basin 2"
2511,400,8.0544,2000,2400,"Sub-basin 2"
2512,100,2,1600,1700,"Sub-basin 2"
2513,200,7,900,1100,"Sub-basin 2"
2514,1200,233,2500,3700,"Sub-basin 2"
2515,1100,102,5300,6400,"Sub-basin 2"
2516,600,115,3400,4000,"Sub-basin 2"
2517,100,6,2100,2200,"Sub-basin 2"
2518,3400,221,8900,12300,"Sub-basin 2"
2519,600,22,1700,2300,"Sub-basin 2"
2520,5500,2760,7400,12900,"Sub-basin 2"
2521,4600,757.16,17000,21600,"Sub-basin 2"
2522,400,31,3400,3800,"Sub-basin 2"
2523,200,4,1500,1700,"Sub-basin 2"
2524,5400,1400,15400,20800,"Sub-basin 2"
2525,100,3,400,500,"Sub-basin 2"
2526,2700,1055,4900,7600,"Sub-basin 2"
2527,2900,799,11200,14100,"Sub-basin 2"
2528,300,13,1500,1800,"Sub-basin 2"
2529,100,2,500,600,"Sub-basin 2"
2530,2200,838,9700,11900,"Sub-basin 2"
2531,1700,645,2800,4500,"Sub-basin 2"
2532,200,6,1900,2100,"Sub-basin 2"
2533,1400,408,5700,7100,"Sub-basin 2"
2534,100,4,1900,2000,"Sub-basin 2"
2535,200,7,1200,1400,"Sub-basin 2"
2536,600,35,3300,3900,"Sub-basin 2"
2537,200,10,2200,2400,"Sub-basin 2"
2538,1600,425,7700,9300,"Sub-basin 2"
2539,1700,273,8400,10100,"Sub-basin 2"
2540,200,14,2100,2300,"Sub-basin 2"
2541,100,1,700,800,"Sub-basin 2"
2542,600,55,3500,4100,"Sub-basin 2"
2543,1300,411,4000,5300,"Sub-basin 2"
2544,3000,675,13700,16700,"Sub-basin 2"
2545,200,4,2100,2300,"Sub-basin 2"
2546,400,20,1800,2200,"Sub-basin 2"
2547,100,1,1200,1300,"Sub-basin 2"
2548,300,6,1500,1800,"Sub-basin 2"
2549,900,133,5400,6300,"Sub-basin 2"
2550,1300,459,3700,5000,"Sub-basin 2"
2551,4100,1501,8700,12800,"Sub-basin 2"
2552,2600,642,6800,9400,"Sub-basin 2"
2553,2100,722,7400,9500,"Sub-basin 2"
2554,200,2,2300,2500,"Sub-basin 2"
2555,800,114,3000,3800,"Sub-basin 2"
2556,100,4,1200,1300,"Sub-basin 2"
2557,1400,336,6000,7400,"Sub-basin 2"
2558,1600,757,5100,6700,"Sub-basin 2"
2559,100,3,800,900,"Sub-basin 2"
2560,400,62,3100,3500,"Sub-basin 2"
2561,1400,495,4700,6100,"Sub-basin 2"
2562,5000,1820,6800,11800,"Sub-basin 2"
2563,6800,1341,15200,22000,"Sub-basin 2"
2564,800,102,3600,4400,"Sub-basin 2"
2565,200,11,1600,1800,"Sub-basin 2"
2566,100,6,1200,1300,"Sub-basin 2"
2567,1000,67,6100,7100,"Sub-basin 2"
2568,9500,414,36000,45500,"Sub-basin 2"
2569,400,44,1500,1900,"Sub-basin 2"
2570,1100,377,5400,6500,"Sub-basin 2"
2571,23700,13229,21200,44900,"Sub-basin 2"
2572,200,2,2500,2700,"Sub-basin 2"
2573,2000,267,8000,10000,"Sub-basin 2"
2574,200,11,1600,1800,"Sub-basin 2"
2575,1200,263,4600,5800,"Sub-basin 2"
2576,1200,329,5000,6200,"Sub-basin 2"
2577,100,9,1400,1500,"Sub-basin 2"
2578,1300,384,4200,5500,"Sub-basin 2"
2579,700,127,2500,3200,"Sub-basin 2"
2580,1400,326,6800,8200,"Sub-basin 2"
2581,300,22,2000,2300,"Sub-basin 2"
2582,400,48,700,1100,"Sub-basin 2"
2583,1300,183,5500,6800,"Sub-basin 2"
2584,100,2,600,700,"Sub-basin 2"
2585,1100,41,6100,7200,"Sub-basin 2"
2586,8800,1039,24800,33600,"Sub-basin 2"
2587,4400,274,14700,19100,"Sub-basin 2"
2588,500,33,5500,6000,"Sub-basin 2"
2589,400,17,5000,5400,"Sub-basin 2"
2590,100,1,800,900,"Sub-basin 2"
2591,10400,2340,14400,24800,"Sub-basin 2"
2592,100,1,900,1000,"Sub-basin 2"
2593,1600,516,3500,5100,"Sub-basin 2"
2594,400,37,2700,3100,"Sub-basin 2"
2595,100,3,2200,2300,"Sub-basin 2"
2596,2000,811,4800,6800,"Sub-basin 2"
2597,100,2,800,900,"Sub-basin 2"
2598,1100,68,6700,7800,"Sub-basin 2"
2599,200,3,1600,1800,"Sub-basin 2"
2600,100,1,1000,1100,"Sub-basin 2"
2601,200,2,1200,1400,"Sub-basin 2"
2602,100,2,1300,1400,"Sub-basin 2"
2603,7100,1418,22000,29100,"Sub-basin 2"
2604,300,36,1300,1600,"Sub-basin 2"
2605,100,4,1500,1600,"Sub-basin 2"
2606,300,12,2700,3000,"Sub-basin 2"
2607,200,5,1700,1900,"Sub-basin 2"
2608,200,3,2600,2800,"Sub-basin 2"
2609,700,93,2600,3300,"Sub-basin 2"
2610,900,154,5000,5900,"Sub-basin 2"
2611,200,5,900,1100,"Sub-basin 2"
2612,200,4,1500,1700,"Sub-basin 2"
2613,100,1,1000,1100,"Sub-basin 2"
2614,100,1,1700,1800,"Sub-basin 2"
2615,3300,184,15000,18300,"Sub-basin 2"
2616,300,7,1500,1800,"Sub-basin 2"
2617,200,5,900,1100,"Sub-basin 2"
2618,800,50,3800,4600,"Sub-basin 2"
2619,2200,804,5500,7700,"Sub-basin 2"
2620,2800,175,11600,14400,"Sub-basin 2"
2621,400,30,1400,1800,"Sub-basin 2"
2622,100,1,2500,2600,"Sub-basin 2"
2623,500,131,2900,3400,"Sub-basin 2"
2624,2600,316,10300,12900,"Sub-basin 2"
2625,400,16,4200,4600,"Sub-basin 2"
2626,100,1,200,300,"Sub-basin 2"
2627,2600,309,12800,15400,"Sub-basin 2"
2628,4700,1597,13000,17700,"Sub-basin 2"
2629,1200,294,4700,5900,"Sub-basin 2"
2630,1200,275,3800,5000,"Sub-basin 2"
2631,2900,700,9000,11900,"Sub-basin 2"
2632,900,206,2400,3300,"Sub-basin 2"
2633,6100,1013,11400,17500,"Sub-basin 2"
2634,5700,758,11100,16800,"Sub-basin 2"
2635,100,1.0128,100,200,"Sub-basin 2"
2636,1600,454,9500,11100,"Sub-basin 2"
2637,4600,2542,13700,18300,"Sub-basin 2"
2638,1200,196,4300,5500,"Sub-basin 2"
2639,1800,550,5300,7100,"Sub-basin 2"
2640,10200,3222,21200,31400,"Sub-basin 2"
2641,5500,620,16000,21500,"Sub-basin 2"
2642,100,1,1200,1300,"Sub-basin 2"
2643,100,1,500,600,"Sub-basin 2"
2644,3700,1167,8100,11800,"Sub-basin 2"
2645,200,9,1900,2100,"Sub-basin 2"
2646,600,61,4300,4900,"Sub-basin 2"
2647,2700,595,6800,9500,"Sub-basin 2"
2648,100,1,400,500,"Sub-basin 2"
2649,900,109,4400,5300,"Sub-basin 2"
2650,800,140,4500,5300,"Sub-basin 2"
2651,4800,1061,13000,17800,"Sub-basin 2"
2652,300,26,2000,2300,"Sub-basin 2"
2653,100,6,800,900,"Sub-basin 2"
2654,1300,520,4800,6100,"Sub-basin 2"
2655,300,17,2700,3000,"Sub-basin 2"
2656,100,3,1100,1200,"Sub-basin 2"
2657,500,51,2000,2500,"Sub-basin 2"
2658,600,25,3000,3600,"Sub-basin 2"
2659,400,32,2100,2500,"Sub-basin 2"
2660,2300,272,15000,17300,"Sub-basin 2"
2661,1000,45,8000,9000,"Sub-basin 2"
2662,100,4,1600,1700,"Sub-basin 2"
2663,8500,1147,21600,30100,"Sub-basin 2"
2664,500,32,1600,2100,"Sub-basin 2"
2665,300,17,1800,2100,"Sub-basin 2"
2666,100,2,1800,1900,"Sub-basin 2"
2667,4800,1113,19500,24300,"Sub-basin 2"
2668,1100,156,3800,4900,"Sub-basin 2"
2669,100,5,900,1000,"Sub-basin 2"
2670,100,2,1700,1800,"Sub-basin 2"
2671,1900,285,8800,10700,"Sub-basin 2"
2672,1200,264,3200,4400,"Sub-basin 2"
2673,800,97,3200,4000,"Sub-basin 2"
2674,2700,145,8500,11200,"Sub-basin 2"
2675,3200,885,11100,14300,"Sub-basin 2"
2676,800,110,6000,6800,"Sub-basin 2"
2677,700,81,2600,3300,"Sub-basin 2"
2678,2600,600,8300,10900,"Sub-basin 2"
2679,100,3,1600,1700,"Sub-basin 2"
2680,1700,512,6400,8100,"Sub-basin 2"
2681,100,1,1700,1800,"Sub-basin 2"
2682,4500,486,18600,23100,"Sub-basin 2"
2683,1200,113,6900,8100,"Sub-basin 2"
2684,100,1,800,900,"Sub-basin 2"
2685,100,2,1600,1700,"Sub-basin 2"
2686,200,19,900,1100,"Sub-basin 2"
2687,100,1,1600,1700,"Sub-basin 2"
2688,600,126,5200,5800,"Sub-basin 2"
2689,800,113,5000,5800,"Sub-basin 2"
2690,200,5,1500,1700,"Sub-basin 2"
2691,800,203,2600,3400,"Sub-basin 2"
2692,900,120,4200,5100,"Sub-basin 2"
2693,1200,319,5900,7100,"Sub-basin 2"
2694,1800,627,6800,8600,"Sub-basin 2"
2695,600,49,5700,6300,"Sub-basin 2"
2696,1900,140,7600,9500,"Sub-basin 2"
2697,900,103,2700,3600,"Sub-basin 2"
2698,500,58,2200,2700,"Sub-basin 2"
2699,200,4,2000,2200,"Sub-basin 2"
2700,1600,180,9800,11400,"Sub-basin 2"
2701,400,50,3400,3800,"Sub-basin 2"
2702,1300,155,7100,8400,"Sub-basin 2"
2703,400,62,2100,2500,"Sub-basin 2"
2704,1000,77,7600,8600,"Sub-basin 2"
2705,200,7,3500,3700,"Sub-basin 2"
2706,400,49,2600,3000,"Sub-basin 2"
2707,800,88,4500,5300,"Sub-basin 2"
2708,700,52,5300,6000,"Sub-basin 2"
2709,100,5,1300,1400,"Sub-basin 2"
2710,200,21,3100,3300,"Sub-basin 2"
2711,600,108,5700,6300,"Sub-basin 2"
2712,100,1,1100,1200,"Sub-basin 2"
2713,100,1,1800,1900,"Sub-basin 2"
2714,100,1,800,900,"Sub-basin 2"
2715,100,3,2600,2700,"Sub-basin 2"
2716,100,1,1100,1200,"Sub-basin 2"
2717,1800,375,10300,12100,"Sub-basin 2"
2718,300,5,1400,1700,"Sub-basin 2"
2719,6400,862,29800,36200,"Sub-basin 2"
2720,100,2,1000,1100,"Sub-basin 2"
2721,200,14,2100,2300,"Sub-basin 2"
2722,100,4,2500,2600,"Sub-basin 2"
2723,200,8,4400,4600,"Sub-basin 2"
2724,100,5,1000,1100,"Sub-basin 2"
2725,100,2,1400,1500,"Sub-basin 2"
2726,200,29,1500,1700,"Sub-basin 2"
2727,700,105,6000,6700,"Sub-basin 2"
2728,800,54,8500,9300,"Sub-basin 2"
2729,2800,388,17300,20100,"Sub-basin 2"
2730,200,18,2600,2800,"Sub-basin 2"
2731,100,1,1100,1200,"Sub-basin 2"
2732,200,8,1800,2000,"Sub-basin 2"
2733,100,2,1800,1900,"Sub-basin 2"
2734,100,1,2300,2400,"Sub-basin 2"
2735,900,123,9000,9900,"Sub-basin 2"
2736,300,29,3000,3300,"Sub-basin 2"
2737,100,2,1200,1300,"Sub-basin 2"
2738,10100,1859,75900,86000,"Sub-basin 2"
2739,200,7,2000,2200,"Sub-basin 2"
2740,300,28,6400,6700,"Sub-basin 2"
2741,100,5,1600,1700,"Sub-basin 2"
2742,200,5,2600,2800,"Sub-basin 2"
2743,100,2,500,600,"Sub-basin 2"
2744,100,3,1700,1800,"Sub-basin 2"
2745,5800,2056,11200,17000,"Sub-basin 2"
2746,100,8,500,600,"Sub-basin 2"
2747,600,35,11100,11700,"Sub-basin 2"
2748,100,3,2000,2100,"Sub-basin 2"
2749,600,17,5300,5900,"Sub-basin 2"
2750,200,3,400,600,"Sub-basin 2"
2751,1100,74,13500,14600,"Sub-basin 2"
2752,800,74,3800,4600,"Sub-basin 2"
2753,500,55,8100,8600,"Sub-basin 2"
2754,200,6,3900,4100,"Sub-basin 2"
2755,300,24,4400,4700,"Sub-basin 2"
2756,200,3,4700,4900,"Sub-basin 2"
2757,100,11,900,1000,"Sub-basin 2"
2758,200,3,1800,2000,"Sub-basin 2"
2759,400,12,6600,7000,"Sub-basin 2"
2760,100,4,700,800,"Sub-basin 2"
2761,800,60,11800,12600,"Sub-basin 2"
2762,100,33,1300,1400,"Sub-basin 2"
2763,100,2,1800,1900,"Sub-basin 2"
2764,200,6,2900,3100,"Sub-basin 2"
2765,100,2,600,700,"Sub-basin 2"
2766,400,12,11000,11400,"Sub-basin 2"
2767,400,28,2800,3200,"Sub-basin 2"
2768,9400,2540,14000,23400,"Sub-basin 2"
2769,500,28,4200,4700,"Sub-basin 2"
2770,100,1,400,500,"Sub-basin 2"
2771,200,2,4000,4200,"Sub-basin 2"
2772,3000,349,48500,51500,"Sub-basin 2"
2773,100,1,1000,1100,"Sub-basin 2"
2774,3000,642,7000,10000,"Sub-basin 2"
2775,1100,154,5400,6500,"Sub-basin 2"
2776,400,13,2300,2700,"Sub-basin 2"
2777,100,1,2600,2700,"Sub-basin 2"
2778,300,12,2800,3100,"Sub-basin 2"
2779,100,1,1300,1400,"Sub-basin 2"
2780,400,16,500,900,"Sub-basin 2"
2781,100,1,200,300,"Sub-basin 2"
2782,7200,276.3124,39000,46200,"Sub-basin 2"
2783,1600,152,4800,6400,"Sub-basin 2"
2784,4900,795,16500,21400,"Sub-basin 2"
2785,300,11,3800,4100,"Sub-basin 2"
2786,300,17,4000,4300,"Sub-basin 2"
2787,200,2,6000,6200,"Sub-basin 2"
2788,200,2,7400,7600,"Sub-basin 2"
2789,100,2,2900,3000,"Sub-basin 2"
2790,200,11,5800,6000,"Sub-basin 2"
2791,600,32,6000,6600,"Sub-basin 2"
2792,200,3,4100,4300,"Sub-basin 2"
2793,800,49,8900,9700,"Sub-basin 2"
2794,100,1,900,1000,"Sub-basin 2"
2795,200,31,3000,3200,"Sub-basin 2"
2796,100,2,1100,1200,"Sub-basin 2"
2797,200,21,3500,3700,"Sub-basin 2"
2798,43300,5633,232700,276000,"Sub-basin 2"
2799,9800,583,15400,25200,"Sub-basin 2"
2800,900,118,800,1700,"Sub-basin 2"
2801,600,26,4900,5500,"Sub-basin 2"
2802,1400,161,11700,13100,"Sub-basin 2"
2803,300,8,8300,8600,"Sub-basin 2"
2804,200,4,4000,4200,"Sub-basin 2"
2805,800,55,12700,13500,"Sub-basin 2"
2806,2000,134,14000,16000,"Sub-basin 2"
2807,900,99,3300,4200,"Sub-basin 2"
2808,200,40,3900,4100,"Sub-basin 2"
2809,100,5,2600,2700,"Sub-basin 2"
2810,200,7,4800,5000,"Sub-basin 2"
2811,400,6,3000,3400,"Sub-basin 2"
2812,200,8,3900,4100,"Sub-basin 2"
2813,12400,2264,18600,31000,"Sub-basin 2"
2814,100,1,1500,1600,"Sub-basin 2"
2815,1200,128,4100,5300,"Sub-basin 2"
2816,100,2,1700,1800,"Sub-basin 2"
2817,600,19,6000,6600,"Sub-basin 2"
2818,35800,2041,61100,96900,"Sub-basin 2"
2819,1900,151,7700,9600,"Sub-basin 2"
2820,200,8,2600,2800,"Sub-basin 2"
2821,100,1,2400,2500,"Sub-basin 2"
2822,100,1,1300,1400,"Sub-basin 2"
2823,200,3,3600,3800,"Sub-basin 2"
2824,300,12,4600,4900,"Sub-basin 2"
2825,100,1,2600,2700,"Sub-basin 2"
2826,700,45,10800,11500,"Sub-basin 2"
2827,200,8,3700,3900,"Sub-basin 2"
2828,200,13,3400,3600,"Sub-basin 2"
2829,400,16,5000,5400,"Sub-basin 2"
2830,100,2.002,1300,1400,"Sub-basin 2"
2831,200,4,2600,2800,"Sub-basin 2"
2832,1500,112,8400,9900,"Sub-basin 2"
2833,10100,1479,105800,115900,"Sub-basin 2"
2834,700,45,7600,8300,"Sub-basin 2"
2835,1400,69,13600,15000,"Sub-basin 2"
2836,200,4,2300,2500,"Sub-basin 2"
2837,600,42,9700,10300,"Sub-basin 2"
2838,4500,360,67300,71800,"Sub-basin 2"
2839,100,2,1500,1600,"Sub-basin 2"
2840,100,3,1500,1600,"Sub-basin 2"
2841,400,20,7000,7400,"Sub-basin 2"
2842,100,3,3700,3800,"Sub-basin 2"
2843,1600,110,15600,17200,"Sub-basin 2"
2844,100,1,900,1000,"Sub-basin 2"
2845,100,1,2100,2200,"Sub-basin 2"
2846,1500,89.0418,21700,23200,"Sub-basin 2"
2847,100,1,2900,3000,"Sub-basin 2"
2848,100,2,500,600,"Sub-basin 2"
2849,1000,95,10000,11000,"Sub-basin 2"
2850,300,8,4900,5200,"Sub-basin 2"
2851,400,10,2900,3300,"Sub-basin 2"
2852,100,2,1700,1800,"Sub-basin 2"
2853,100,3,2400,2500,"Sub-basin 2"
2854,200,8,5200,5400,"Sub-basin 2"
2855,1200,75,10100,11300,"Sub-basin 2"
2856,300,8,2900,3200,"Sub-basin 2"
2857,100,3,3200,3300,"Sub-basin 2"
2858,6400,751,18900,25300,"Sub-basin 2"
2859,100,1,400,500,"Sub-basin 2"
2860,800,39,9000,9800,"Sub-basin 2"
2861,100,3,1300,1400,"Sub-basin 2"
2862,100,1,800,900,"Sub-basin 2"
2863,200,18,1800,2000,"Sub-basin 2"
2864,500,11,5900,6400,"Sub-basin 2"
2865,100,1.0017,2700,2800,"Sub-basin 2"
2866,100,1,1100,1200,"Sub-basin 2"
2867,100,3,1500,1600,"Sub-basin 2"
2868,100,1,900,1000,"Sub-basin 2"
2869,1600,92,11700,13300,"Sub-basin 2"
2870,200,2,1800,2000,"Sub-basin 2"
2871,400,29,2800,3200,"Sub-basin 2"
2872,1400,112,3800,5200,"Sub-basin 2"
2873,100,2,2000,2100,"Sub-basin 2"
2874,5600,811,40200,45800,"Sub-basin 2"
2875,100,2,1800,1900,"Sub-basin 2"
2876,400,9,3100,3500,"Sub-basin 2"
2877,4300,389,24700,29000,"Sub-basin 2"
2878,200,16,3400,3600,"Sub-basin 2"
2879,200,5.0028,5000,5200,"Sub-basin 2"
2880,200,9,5000,5200,"Sub-basin 2"
2881,300,11,4000,4300,"Sub-basin 2"
2882,500,22,9100,9600,"Sub-basin 2"
2883,1700,278,5200,6900,"Sub-basin 2"
2884,800,47,3100,3900,"Sub-basin 2"
2885,200,17,3200,3400,"Sub-basin 2"
2886,200,8,3100,3300,"Sub-basin 2"
2887,100,2,2600,2700,"Sub-basin 2"
2888,500,12,2000,2500,"Sub-basin 2"
2889,1900,225,9200,11100,"Sub-basin 2"
2890,100,3,700,800,"Sub-basin 2"
2891,100,1,2500,2600,"Sub-basin 2"
2892,3500,313.0685,22000,25500,"Sub-basin 2"
2893,200,3,800,1000,"Sub-basin 2"
2894,4200,437,12200,16400,"Sub-basin 2"
2895,100,2,800,900,"Sub-basin 2"
2896,1200,88,6800,8000,"Sub-basin 2"
2897,1000,98,7300,8300,"Sub-basin 2"
2898,500,14,5400,5900,"Sub-basin 2"
2899,200,19,1300,1500,"Sub-basin 2"
2900,500,16,6500,7000,"Sub-basin 2"
2901,900,58,12800,13700,"Sub-basin 2"
2902,200,3,3800,4000,"Sub-basin 2"
2903,600,36,5700,6300,"Sub-basin 2"
2904,400,21,4600,5000,"Sub-basin 2"
2905,400,16,5300,5700,"Sub-basin 2"
2906,100,1,2400,2500,"Sub-basin 2"
2907,2100,147,15000,17100,"Sub-basin 2"
2908,400,11,4300,4700,"Sub-basin 2"
2909,300,9,4600,4900,"Sub-basin 2"
2910,100,6,1400,1500,"Sub-basin 2"
2911,6300,330,15700,22000,"Sub-basin 2"
2912,700,31,5800,6500,"Sub-basin 2"
2913,100,2,3000,3100,"Sub-basin 2"
2914,100,2,1600,1700,"Sub-basin 2"
2915,300,8,3800,4100,"Sub-basin 2"
2916,5300,333,27000,32300,"Sub-basin 2"
2917,400,25,2900,3300,"Sub-basin 2"
2918,1200,93,3700,4900,"Sub-basin 2"
2919,1000,67,2000,3000,"Sub-basin 2"
2920,600,27,3400,4000,"Sub-basin 2"
2921,2000,114,7800,9800,"Sub-basin 2"
2922,200,2,2600,2800,"Sub-basin 2"
2923,100,3,600,700,"Sub-basin 2"
2924,600,8,4500,5100,"Sub-basin 2"
2925,700,39,3000,3700,"Sub-basin 2"
2926,700,45,5100,5800,"Sub-basin 2"
2927,3000,313,10600,13600,"Sub-basin 2"
2928,100,2,2500,2600,"Sub-basin 2"
2929,100,2,700,800,"Sub-basin 2"
2930,100,1,2000,2100,"Sub-basin 2"
2931,200,4,2500,2700,"Sub-basin 2"
2932,900,57,4600,5500,"Sub-basin 2"
2933,300,25,4800,5100,"Sub-basin 2"
2934,100,1,1100,1200,"Sub-basin 2"
2935,100,1,1300,1400,"Sub-basin 2"
2936,500,19,2500,3000,"Sub-basin 2"
2937,900,41,9800,10700,"Sub-basin 2"
2938,100,1,3300,3400,"Sub-basin 2"
2939,100,1,2100,2200,"Sub-basin 2"
2940,100,2,2400,2500,"Sub-basin 2"
2941,400,22,3700,4100,"Sub-basin 2"
2942,100,2,1500,1600,"Sub-basin 2"
2943,200,5,700,900,"Sub-basin 2"
2944,600,19,2900,3500,"Sub-basin 2"
2945,1200,36,8100,9300,"Sub-basin 2"
2946,400,9,6100,6500,"Sub-basin 2"
2947,700,31.0154,3700,4400,"Sub-basin 2"
2948,700,28,4500,5200,"Sub-basin 2"
2949,100,4,2000,2100,"Sub-basin 2"
2950,200,3,700,900,"Sub-basin 2"
2951,100,4,3500,3600,"Sub-basin 2"
2952,800,85,900,1700,"Sub-basin 2"
2953,200,3,3400,3600,"Sub-basin 2"
2954,500,9,1900,2400,"Sub-basin 2"
2955,300,5,3900,4200,"Sub-basin 2"
2956,400,17,6000,6400,"Sub-basin 2"
2957,1000,75,2000,3000,"Sub-basin 2"
2958,600,30,3300,3900,"Sub-basin 2"
2959,500,11,4900,5400,"Sub-basin 2"
2960,4000,178,25800,29800,"Sub-basin 2"
2961,2900,219,12300,15200,"Sub-basin 2"
2962,1300,120,11100,12400,"Sub-basin 2"
2963,200,6,2500,2700,"Sub-basin 2"
2964,100,1,3500,3600,"Sub-basin 2"
2965,500,10,5300,5800,"Sub-basin 2"
2966,300,6,4500,4800,"Sub-basin 2"
2967,100,4.0021,1000,1100,"Sub-basin 2"
2968,400,10,4000,4400,"Sub-basin 2"
2969,1800,75,6200,8000,"Sub-basin 2"
2970,800,77,2600,3400,"Sub-basin 2"
2971,100,2,1900,2000,"Sub-basin 2"
2972,400,8,3700,4100,"Sub-basin 2"
2973,1700,105,19200,20900,"Sub-basin 2"
2974,200,4,4600,4800,"Sub-basin 2"
2975,400,13,10200,10600,"Sub-basin 2"
2976,1900,133,10900,12800,"Sub-basin 2"
2977,400,6,2300,2700,"Sub-basin 2"
2978,8200,922,96700,104900,"Sub-basin 2"
2979,400,14,5000,5400,"Sub-basin 2"
2980,200,8,2900,3100,"Sub-basin 2"
2981,4600,423.0718,19600,24200,"Sub-basin 2"
2982,200,2,2900,3100,"Sub-basin 2"
2983,16700,1107,58500,75200,"Sub-basin 2"
2984,100,3,1700,1800,"Sub-basin 2"
2985,100,1,1100,1200,"Sub-basin 2"
2986,3600,448,9600,13200,"Sub-basin 2"
2987,100,1,700,800,"Sub-basin 2"
2988,400,12,4200,4600,"Sub-basin 2"
2989,100,1,1400,1500,"Sub-basin 2"
2990,1200,100,6500,7700,"Sub-basin 2"
2991,600,31,4000,4600,"Sub-basin 2"
2992,100,1,500,600,"Sub-basin 2"
2993,2600,99,12300,14900,"Sub-basin 2"
2994,1000,96,1600,2600,"Sub-basin 2"
2995,100,3,1100,1200,"Sub-basin 2"
2996,5300,204,18500,23800,"Sub-basin 2"
2997,800,57,5400,6200,"Sub-basin 2"
2998,100,2,900,1000,"Sub-basin 2"
2999,100,1,500,600,"Sub-basin 2"
3000,16200,1030.149,34400,50600,"Sub-basin 2"
3001,100,2,1100,1200,"Sub-basin 2"
3002,100,2,1300,1400,"Sub-basin 2"
3003,200,5,2300,2500,"Sub-basin 2"
3004,300,9,3000,3300,"Sub-basin 2"
3005,100,1,500,600,"Sub-basin 2"
3006,6200,336,14500,20700,"Sub-basin 2"
3007,100,4,1100,1200,"Sub-basin 2"
3008,200,6,1400,1600,"Sub-basin 2"
3009,3300,196.219,18900,22200,"Sub-basin 2"
3010,300,6,2400,2700,"Sub-basin 2"
3011,200,5,2600,2800,"Sub-basin 2"
3012,900,80,4300,5200,"Sub-basin 2"
3013,700,35,4100,4800,"Sub-basin 2"
3014,5400,2314,7300,12700,"Sub-basin 2"
3015,4600,760,32400,37000,"Sub-basin 2"
3016,600,10,3400,4000,"Sub-basin 2"
3017,1700,157,6600,8300,"Sub-basin 2"
3018,400,22,3200,3600,"Sub-basin 2"
3019,1100,140,9700,10800,"Sub-basin 2"
3020,100,2,100,200,"Sub-basin 2"
3021,100,1,1500,1600,"Sub-basin 2"
3022,100,6,800,900,"Sub-basin 2"
3023,2100,85,10900,13000,"Sub-basin 2"
3024,700,54,5600,6300,"Sub-basin 2"
3025,300,9,2600,2900,"Sub-basin 2"
3026,1600,182,8200,9800,"Sub-basin 2"
3027,300,7,3500,3800,"Sub-basin 2"
3028,300,9,2700,3000,"Sub-basin 2"
3029,900,26,2700,3600,"Sub-basin 2"
3030,3600,448,26300,29900,"Sub-basin 2"
3031,100,1,1400,1500,"Sub-basin 2"
3032,100,4,600,700,"Sub-basin 2"
3033,500,51,3000,3500,"Sub-basin 2"
3034,200,10,1800,2000,"Sub-basin 2"
3035,400,19,3700,4100,"Sub-basin 2"
3036,100,1,900,1000,"Sub-basin 2"
3037,100,6,1200,1300,"Sub-basin 2"
3038,2200,103,9100,11300,"Sub-basin 2"
3039,100,1,1500,1600,"Sub-basin 2"
3040,28800,9259,30200,59000,"Sub-basin 2"
3041,300,4,4800,5100,"Sub-basin 2"
3042,1600,155,9100,10700,"Sub-basin 2"
3043,100,2,600,700,"Sub-basin 2"
3044,400,27,4400,4800,"Sub-basin 2"
3045,200,4,1500,1700,"Sub-basin 2"
3046,900,41,6500,7400,"Sub-basin 2"
3047,100,5,900,1000,"Sub-basin 2"
3048,200,7,1000,1200,"Sub-basin 2"
3049,1400,104,6200,7600,"Sub-basin 2"
3050,1500,129,6900,8400,"Sub-basin 2"
3051,900,81,5400,6300,"Sub-basin 2"
3052,200,10,2900,3100,"Sub-basin 2"
3053,1700,99,12300,14000,"Sub-basin 2"
3054,300,9,2300,2600,"Sub-basin 2"
3055,100,1,900,1000,"Sub-basin 2"
3056,3300,347,8500,11800,"Sub-basin 2"
3057,300,28,1300,1600,"Sub-basin 2"
3058,200,11.0317,1800,2000,"Sub-basin 2"
3059,600,32,4200,4800,"Sub-basin 2"
3060,1400,190,9600,11000,"Sub-basin 2"
3061,100,1,900,1000,"Sub-basin 2"
3062,800,34,4000,4800,"Sub-basin 2"
3063,300,10,2900,3200,"Sub-basin 2"
3064,100,2,300,400,"Sub-basin 2"
3065,100,1,800,900,"Sub-basin 2"
3066,400,27,1300,1700,"Sub-basin 2"
3067,400,29,2800,3200,"Sub-basin 2"
3068,500,15,1800,2300,"Sub-basin 2"
3069,100,1,1800,1900,"Sub-basin 2"
3070,300,12,1100,1400,"Sub-basin 2"
3071,1700,213,4400,6100,"Sub-basin 2"
3072,200,5,2800,3000,"Sub-basin 2"
3073,200,3,1900,2100,"Sub-basin 2"
3074,1400,116,8100,9500,"Sub-basin 2"
3075,2400,371,6100,8500,"Sub-basin 2"
3076,1700,90,6300,8000,"Sub-basin 2"
3077,4400,235,23300,27700,"Sub-basin 2"
3078,1000,66,7100,8100,"Sub-basin 2"
3079,75000,8388.9302,101500,176500,"Sub-basin 2"
3080,100,2,600,700,"Sub-basin 2"
3081,400,31,6300,6700,"Sub-basin 2"
3082,200,3,900,1100,"Sub-basin 2"
3083,700,92,2900,3600,"Sub-basin 2"
3084,700,74,6300,7000,"Sub-basin 2"
3085,100,2,500,600,"Sub-basin 2"
3086,3600,452,8100,11700,"Sub-basin 2"
3087,100,1,700,800,"Sub-basin 2"
3088,300,6,2300,2600,"Sub-basin 2"
3089,900,32,10900,11800,"Sub-basin 2"
3090,1100,30,4900,6000,"Sub-basin 2"
3091,200,4,1500,1700,"Sub-basin 2"
3092,500,13,5100,5600,"Sub-basin 2"
3093,200,5,2900,3100,"Sub-basin 2"
3094,6400,364,13800,20200,"Sub-basin 2"
3095,200,4,600,800,"Sub-basin 2"
3096,200,2,1500,1700,"Sub-basin 2"
3097,100,4,2700,2800,"Sub-basin 2"
3098,1400,108,11200,12600,"Sub-basin 2"
3099,200,3,1100,1300,"Sub-basin 2"
3100,100,14,1200,1300,"Sub-basin 2"
3101,300,6,3000,3300,"Sub-basin 2"
3102,300,16,2900,3200,"Sub-basin 2"
3103,100,4,700,800,"Sub-basin 2"
3104,200,2,800,1000,"Sub-basin 2"
3105,2800,219,17900,20700,"Sub-basin 2"
3106,100,1,100,200,"Sub-basin 2"
3107,1800,41,6900,8700,"Sub-basin 2"
3108,1000,106,4100,5100,"Sub-basin 2"
3109,100,1,800,900,"Sub-basin 2"
3110,48400,5318,47000,95400,"Sub-basin 2"
3111,100,1,900,1000,"Sub-basin 2"
3112,100,1,800,900,"Sub-basin 2"
3113,3200,253,11700,14900,"Sub-basin 2"
3114,300,13,3000,3300,"Sub-basin 2"
3115,400,6,5600,6000,"Sub-basin 2"
3116,18000,1303,29400,47400,"Sub-basin 2"
3117,200,2,2200,2400,"Sub-basin 2"
3118,600,59,3400,4000,"Sub-basin 2"
3119,900,53,5200,6100,"Sub-basin 2"
3120,500,9,1900,2400,"Sub-basin 2"
3121,15600,1266,39800,55400,"Sub-basin 2"
3122,200,3,2100,2300,"Sub-basin 2"
3123,100,5,800,900,"Sub-basin 2"
3124,2300,132,4700,7000,"Sub-basin 2"
3125,2500,363,7600,10100,"Sub-basin 2"
3126,100,1,700,800,"Sub-basin 2"
3127,100,4,900,1000,"Sub-basin 2"
3128,100,1,300,400,"Sub-basin 2"
3129,2900,115,7800,10700,"Sub-basin 2"
3130,200,4,1100,1300,"Sub-basin 2"
3131,1800,111,10400,12200,"Sub-basin 2"
3132,100,2,2000,2100,"Sub-basin 2"
3133,100,1,2100,2200,"Sub-basin 2"
3134,400,8,3700,4100,"Sub-basin 2"
3135,500,28,1700,2200,"Sub-basin 2"
3136,1100,43,7000,8100,"Sub-basin 2"
3137,400,10,3800,4200,"Sub-basin 2"
3138,200,4,3600,3800,"Sub-basin 2"
3139,200,7,3700,3900,"Sub-basin 2"
3140,500,58,2000,2500,"Sub-basin 2"
3141,100,2,900,1000,"Sub-basin 2"
3142,1000,35,3000,4000,"Sub-basin 2"
3143,100,1,2100,2200,"Sub-basin 2"
3144,200,4,200,400,"Sub-basin 2"
3145,200,6,1600,1800,"Sub-basin 2"
3146,500,27,5600,6100,"Sub-basin 2"
3147,100,1,800,900,"Sub-basin 2"
3148,100,1,700,800,"Sub-basin 2"
3149,300,8,600,900,"Sub-basin 2"
3150,400,53,3500,3900,"Sub-basin 2"
3151,100,1,1100,1200,"Sub-basin 2"
3152,7000,530,15000,22000,"Sub-basin 2"
3153,100,1,900,1000,"Sub-basin 2"
3154,1100,62,2600,3700,"Sub-basin 2"
3155,100,1,600,700,"Sub-basin 2"
3156,400,53,4800,5200,"Sub-basin 2"
3157,300,18,3600,3900,"Sub-basin 2"
3158,900,48,400,1300,"Sub-basin 2"
3159,34100,5319,17800,51900,"Sub-basin 2"
3160,300,14,3300,3600,"Sub-basin 2"
3161,200,6,4100,4300,"Sub-basin 2"
3162,2500,292,4500,7000,"Sub-basin 2"
3163,100,6,700,800,"Sub-basin 2"
3164,100,1,200,300,"Sub-basin 2"
3165,500,32,3300,3800,"Sub-basin 2"
3166,600,96,1700,2300,"Sub-basin 2"
3167,100,4,900,1000,"Sub-basin 2"
3168,300,9,2300,2600,"Sub-basin 2"
3169,100,1,1700,1800,"Sub-basin 2"
3170,100,2,700,800,"Sub-basin 2"
3171,100,1.0011,900,1000,"Sub-basin 2"
3172,200,4,800,1000,"Sub-basin 2"
3173,400,22,3100,3500,"Sub-basin 2"
3174,600,25,7100,7700,"Sub-basin 2"
3175,100,2,1400,1500,"Sub-basin 2"
3176,300,7.0006,4400,4700,"Sub-basin 2"
3177,200,3,1700,1900,"Sub-basin 2"
3178,500,23,2200,2700,"Sub-basin 2"
3179,700,28,2100,2800,"Sub-basin 2"
3180,300,8,1100,1400,"Sub-basin 2"
3181,1900,167,7000,8900,"Sub-basin 2"
3182,1200,42.045,7400,8600,"Sub-basin 2"
3183,2200,185,9200,11400,"Sub-basin 2"
3184,100,1,900,1000,"Sub-basin 2"
3185,500,12,3200,3700,"Sub-basin 2"
3186,800,15,3600,4400,"Sub-basin 2"
3187,800,72,1700,2500,"Sub-basin 2"
3188,200,7,2200,2400,"Sub-basin 2"
3189,4500,990,11400,15900,"Sub-basin 2"
3190,100,1,1100,1200,"Sub-basin 2"
3191,3300,86,16700,20000,"Sub-basin 2"
3192,200,6,2400,2600,"Sub-basin 2"
3193,100,1,200,300,"Sub-basin 2"
3194,700,14.0133,1700,2400,"Sub-basin 2"
3195,200,7.0042,1100,1300,"Sub-basin 2"
3196,1300,131,6200,7500,"Sub-basin 2"
3197,100,3,700,800,"Sub-basin 2"
3198,100,1,1700,1800,"Sub-basin 2"
3199,100,2,900,1000,"Sub-basin 2"
3200,3300,129.0591,10000,13300,"Sub-basin 2"
3201,100,1.0008,1000,1100,"Sub-basin 2"
3202,200,7,1600,1800,"Sub-basin 2"
3203,3500,328,11400,14900,"Sub-basin 2"
3204,100,2,1100,1200,"Sub-basin 2"
3205,500,27,2600,3100,"Sub-basin 2"
3206,200,4,1300,1500,"Sub-basin 2"
3207,3500,80,8900,12400,"Sub-basin 2"
3208,100,2,1300,1400,"Sub-basin 2"
3209,500,18,5000,5500,"Sub-basin 2"
3210,100,1,1900,2000,"Sub-basin 2"
3211,2700,143,10700,13400,"Sub-basin 2"
3212,100,1,1400,1500,"Sub-basin 2"
3213,100,1,2900,3000,"Sub-basin 2"
3214,100,1,1800,1900,"Sub-basin 2"
3215,200,2,900,1100,"Sub-basin 2"
3216,300,5,3600,3900,"Sub-basin 2"
3217,100,1,1600,1700,"Sub-basin 2"
3218,1600,43,14600,16200,"Sub-basin 2"
3219,300,5.0035,3000,3300,"Sub-basin 2"
3220,900,17,10600,11500,"Sub-basin 2"
3221,200,4.0054,3700,3900,"Sub-basin 2"
3222,100,1,2400,2500,"Sub-basin 2"
3223,300,3,2000,2300,"Sub-basin 2"
3224,100,2.0006,1300,1400,"Sub-basin 2"
3225,100,1,1200,1300,"Sub-basin 2"
3226,100,1,900,1000,"Sub-basin 2"
3227,100,1,2100,2200,"Sub-basin 2"
3228,100,1,1400,1500,"Sub-basin 2"
3229,1600,222,1700,3300,"Sub-basin 2"
3230,200,2,2200,2400,"Sub-basin 2"
3231,100,1,1700,1800,"Sub-basin 2"
3232,1300,102,8000,9300,"Sub-basin 2"
3233,100,2.0008,2000,2100,"Sub-basin 2"
3234,200,7,2500,2700,"Sub-basin 2"
3235,100,2,700,800,"Sub-basin 2"
3236,100,1,1000,1100,"Sub-basin 2"
3237,100,2,3000,3100,"Sub-basin 2"
3238,100,1,2000,2100,"Sub-basin 2"
3239,10700,1591,19400,30100,"Sub-basin 2"
3240,2200,328,3400,5600,"Sub-basin 2"
3241,1000,24.0399,10700,11700,"Sub-basin 2"
3242,500,15,4300,4800,"Sub-basin 2"
3243,100,1,1800,1900,"Sub-basin 2"
3244,400,20,2300,2700,"Sub-basin 2"
3245,100,4,1400,1500,"Sub-basin 2"
3246,100,1,1000,1100,"Sub-basin 2"
3247,300,3,5600,5900,"Sub-basin 2"
3248,15900,1255,42900,58800,"Sub-basin 2"
3249,1000,132,6200,7200,"Sub-basin 2"
3250,300,14,3700,4000,"Sub-basin 2"
3251,200,2,2300,2500,"Sub-basin 2"
3252,100,2,2000,2100,"Sub-basin 2"
3253,100,1,900,1000,"Sub-basin 2"
3254,400,11,7600,8000,"Sub-basin 2"
3255,400,85,3800,4200,"Sub-basin 2"
3256,300,8,4500,4800,"Sub-basin 2"
3257,600,43,3400,4000,"Sub-basin 2"
3258,600,134,4000,4600,"Sub-basin 2"
3259,200,4.0019,3000,3200,"Sub-basin 2"
3260,200,7,3000,3200,"Sub-basin 2"
3261,5900,302,17600,23500,"Sub-basin 2"
3262,1800,155,9600,11400,"Sub-basin 2"
3263,100,2,600,700,"Sub-basin 2"
3264,5100,319.1493,17000,22100,"Sub-basin 2"
3265,700,10,5900,6600,"Sub-basin 2"
3266,2800,283,15300,18100,"Sub-basin 2"
3267,1100,140,8700,9800,"Sub-basin 2"
3268,100,1.0004,1100,1200,"Sub-basin 2"
3269,100,2,1600,1700,"Sub-basin 2"
3270,500,23,7300,7800,"Sub-basin 2"
3271,600,61,1800,2400,"Sub-basin 2"
3272,200,4,1400,1600,"Sub-basin 2"
3273,100,2,1800,1900,"Sub-basin 2"
3274,100,3,1400,1500,"Sub-basin 2"
3275,300,7,2400,2700,"Sub-basin 2"
3276,800,95,3700,4500,"Sub-basin 2"
3277,200,4.006,2700,2900,"Sub-basin 2"
3278,100,1,1500,1600,"Sub-basin 2"
3279,400,4,5500,5900,"Sub-basin 2"
3280,100,3,1400,1500,"Sub-basin 2"
3281,300,11,2700,3000,"Sub-basin 2"
3282,1300,148,5200,6500,"Sub-basin 2"
3283,100,6,1700,1800,"Sub-basin 2"
3284,100,2,600,700,"Sub-basin 2"
3285,4200,184,10000,14200,"Sub-basin 2"
3286,100,3,800,900,"Sub-basin 2"
3287,100,1,1300,1400,"Sub-basin 2"
3288,4400,1504,7800,12200,"Sub-basin 2"
3289,100,5,1800,1900,"Sub-basin 2"
3290,1700,104,8800,10500,"Sub-basin 2"
3291,1700,45,10600,12300,"Sub-basin 2"
3292,1300,31,6400,7700,"Sub-basin 2"
3293,100,1,1000,1100,"Sub-basin 2"
3294,100,1,1900,2000,"Sub-basin 2"
3295,100,2,400,500,"Sub-basin 2"
3296,100,1,1000,1100,"Sub-basin 2"
3297,300,5,2200,2500,"Sub-basin 2"
3298,100,4,600,700,"Sub-basin 2"
3299,300,4,5200,5500,"Sub-basin 2"
3300,100,1,2300,2400,"Sub-basin 2"
3301,100,1,1300,1400,"Sub-basin 2"
3302,1900,207,18900,20800,"Sub-basin 2"
3303,100,1,1600,1700,"Sub-basin 2"
3304,100,1,1000,1100,"Sub-basin 2"
3305,300,8,2700,3000,"Sub-basin 2"
3306,100,1,1000,1100,"Sub-basin 2"
3307,100,3,1600,1700,"Sub-basin 2"
3308,1300,97,12500,13800,"Sub-basin 2"
3309,100,1.0028,1100,1200,"Sub-basin 2"
3310,100,1,1500,1600,"Sub-basin 2"
3311,200,2,2500,2700,"Sub-basin 2"
3312,100,3,1100,1200,"Sub-basin 2"
3313,300,25,1300,1600,"Sub-basin 2"
3314,800,60,7700,8500,"Sub-basin 2"
3315,100,2,1500,1600,"Sub-basin 2"
3316,1000,87,3900,4900,"Sub-basin 2"
3317,1400,158,5300,6700,"Sub-basin 2"
3318,2300,124,22000,24300,"Sub-basin 2"
3319,700,19.0147,9100,9800,"Sub-basin 2"
3320,400,12,2500,2900,"Sub-basin 2"
3321,600,58,5500,6100,"Sub-basin 2"
3322,300,12.0053,3500,3800,"Sub-basin 2"
3323,100,1,1600,1700,"Sub-basin 2"
3324,100,4,1300,1400,"Sub-basin 2"
3325,100,2,1200,1300,"Sub-basin 2"
3326,400,40,1800,2200,"Sub-basin 2"
3327,3600,128.2427,28800,32400,"Sub-basin 2"
3328,900,141,3800,4700,"Sub-basin 2"
3329,400,24,3500,3900,"Sub-basin 2"
3330,600,62,3700,4300,"Sub-basin 2"
3331,1800,319.66,3800,5600,"Sub-basin 2"
3332,100,2,2100,2200,"Sub-basin 2"
3333,700,56,2900,3600,"Sub-basin 2"
3334,200,2,2400,2600,"Sub-basin 2"
3335,1800,79,4800,6600,"Sub-basin 2"
3336,6100,291,12700,18800,"Sub-basin 2"
3337,100,3,1300,1400,"Sub-basin 2"
3338,2700,456,10100,12800,"Sub-basin 2"
3339,100,2,2500,2600,"Sub-basin 2"
3340,100,5,1100,1200,"Sub-basin 2"
3341,3200,447,18000,21200,"Sub-basin 2"
3342,6400,2594,7600,14000,"Sub-basin 2"
3343,100,1,1400,1500,"Sub-basin 2"
3344,100,1,1500,1600,"Sub-basin 2"
3345,100,1,1200,1300,"Sub-basin 2"
3346,200,11,1500,1700,"Sub-basin 2"
3347,700,25,4300,5000,"Sub-basin 2"
3348,200,4,2100,2300,"Sub-basin 2"
3349,100,1,1600,1700,"Sub-basin 2"
3350,100,1,1000,1100,"Sub-basin 2"
3351,200,7,1600,1800,"Sub-basin 2"
3352,4700,192,12600,17300,"Sub-basin 2"
3353,100,2,1400,1500,"Sub-basin 2"
3354,800,30,5700,6500,"Sub-basin 2"
3355,100,2,1200,1300,"Sub-basin 2"
3356,500,12,7800,8300,"Sub-basin 2"
3357,500,57,1700,2200,"Sub-basin 2"
3358,100,1,1500,1600,"Sub-basin 2"
3359,900,47,9000,9900,"Sub-basin 2"
3360,1100,21,8600,9700,"Sub-basin 2"
3361,800,72,7200,8000,"Sub-basin 2"
3362,100,2.0032,1900,2000,"Sub-basin 2"
3363,100,3,1200,1300,"Sub-basin 2"
3364,2100,237,9300,11400,"Sub-basin 2"
3365,100,2.0032,1800,1900,"Sub-basin 2"
3366,900,68,7200,8100,"Sub-basin 2"
3367,200,3,3000,3200,"Sub-basin 2"
3368,400,12,3100,3500,"Sub-basin 2"
3369,300,3,4700,5000,"Sub-basin 2"
3370,3100,117,12900,16000,"Sub-basin 2"
3371,100,5.003,2200,2300,"Sub-basin 2"
3372,3000,242,9200,12200,"Sub-basin 2"
3373,400,21,2200,2600,"Sub-basin 2"
3374,500,8,4700,5200,"Sub-basin 2"
3375,300,14,4900,5200,"Sub-basin 2"
3376,100,2,2400,2500,"Sub-basin 2"
3377,2900,117,8800,11700,"Sub-basin 2"
3378,100,4,1200,1300,"Sub-basin 2"
3379,300,6,2800,3100,"Sub-basin 2"
3380,600,33,2500,3100,"Sub-basin 2"
3381,400,7,2100,2500,"Sub-basin 2"
3382,300,7,2600,2900,"Sub-basin 2"
3383,2000,74,4100,6100,"Sub-basin 2"
3384,200,11.0031,3200,3400,"Sub-basin 2"
3385,3700,246,16500,20200,"Sub-basin 2"
3386,700,67,7200,7900,"Sub-basin 2"
3387,400,11.6885,5800,6200,"Sub-basin 2"
3388,200,5,4200,4400,"Sub-basin 2"
3389,100,1,900,1000,"Sub-basin 2"
3390,100,5,1800,1900,"Sub-basin 2"
3391,1200,170,4900,6100,"Sub-basin 2"
3392,100,3,1900,2000,"Sub-basin 2"
3393,300,7.0135,5600,5900,"Sub-basin 2"
3394,200,4,3600,3800,"Sub-basin 2"
3395,100,5,1100,1200,"Sub-basin 2"
3396,600,9,6800,7400,"Sub-basin 2"
3397,500,23,2000,2500,"Sub-basin 2"
3398,200,2,2600,2800,"Sub-basin 2"
3399,400,9,5500,5900,"Sub-basin 2"
3400,2700,150,12800,15500,"Sub-basin 2"
3401,500,14,6000,6500,"Sub-basin 2"
3402,200,3,3200,3400,"Sub-basin 2"
3403,1000,46.0469,7900,8900,"Sub-basin 2"
3404,100,1,900,1000,"Sub-basin 2"
3405,200,11,3000,3200,"Sub-basin 2"
3406,500,60,3800,4300,"Sub-basin 2"
3407,100,3,1200,1300,"Sub-basin 2"
3408,100,1,600,700,"Sub-basin 2"
3409,2200,74,14800,17000,"Sub-basin 2"
3410,100,4,1800,1900,"Sub-basin 2"
3411,100,2,500,600,"Sub-basin 2"
3412,300,8,5200,5500,"Sub-basin 2"
3413,200,5,2600,2800,"Sub-basin 2"
3414,100,1,2800,2900,"Sub-basin 2"
3415,900,94,1500,2400,"Sub-basin 2"
3416,2200,76.0512,9000,11200,"Sub-basin 2"
3417,300,12,3500,3800,"Sub-basin 2"
3418,2000,161,8700,10700,"Sub-basin 2"
3419,100,2,1700,1800,"Sub-basin 2"
3420,700,36,5700,6400,"Sub-basin 2"
3421,200,13,1000,1200,"Sub-basin 2"
3422,1400,57,11900,13300,"Sub-basin 2"
3423,1700,174,8000,9700,"Sub-basin 2"
3424,700,108,4400,5100,"Sub-basin 2"
3425,200,3,2800,3000,"Sub-basin 2"
3426,100,1,800,900,"Sub-basin 2"
3427,600,14,6400,7000,"Sub-basin 2"
3428,100,4.0056,1200,1300,"Sub-basin 2"
3429,100,2,900,1000,"Sub-basin 2"
3430,400,28,4700,5100,"Sub-basin 2"
3431,1000,64,4300,5300,"Sub-basin 2"
3432,100,1.0032,800,900,"Sub-basin 2"
3433,1100,220,2700,3800,"Sub-basin 2"
3434,1500,170,5200,6700,"Sub-basin 2"
3435,300,8,3100,3400,"Sub-basin 2"
3436,100,2,1900,2000,"Sub-basin 2"
3437,2300,67.0363,12200,14500,"Sub-basin 2"
3438,1100,95,4500,5600,"Sub-basin 2"
3439,8100,359,36000,44100,"Sub-basin 2"
3440,100,1,900,1000,"Sub-basin 2"
3441,1500,123,7600,9100,"Sub-basin 2"
3442,100,1,1300,1400,"Sub-basin 2"
3443,100,2,1900,2000,"Sub-basin 2"
3444,100,2.0012,1800,1900,"Sub-basin 2"
3445,100,4,1700,1800,"Sub-basin 2"
3446,100,2,1900,2000,"Sub-basin 2"
3447,1000,37,5000,6000,"Sub-basin 2"
3448,400,8.0012,3200,3600,"Sub-basin 2"
3449,300,11.008,2200,2500,"Sub-basin 2"
3450,200,3.0018,1100,1300,"Sub-basin 2"
3451,100,11,1700,1800,"Sub-basin 2"
3452,10000,349,40400,50400,"Sub-basin 2"
3453,800,14.0302,5600,6400,"Sub-basin 2"
3454,1100,29,4700,5800,"Sub-basin 2"
3455,100,2,1600,1700,"Sub-basin 2"
3456,500,9,6400,6900,"Sub-basin 2"
3457,100,1,1200,1300,"Sub-basin 2"
3458,900,37,6600,7500,"Sub-basin 2"
3459,100,1,1000,1100,"Sub-basin 2"
3460,100,2,2900,3000,"Sub-basin 2"
3461,200,3.0048,2400,2600,"Sub-basin 2"
3462,100,3.0028,1300,1400,"Sub-basin 2"
3463,300,7,3600,3900,"Sub-basin 2"
3464,100,1.0025,1600,1700,"Sub-basin 2"
3465,600,19.01,6500,7100,"Sub-basin 2"
3466,2800,120,11800,14600,"Sub-basin 2"
3467,100,2,1100,1200,"Sub-basin 2"
3468,100,3,900,1000,"Sub-basin 2"
3469,1100,40,4000,5100,"Sub-basin 2"
3470,200,6,1600,1800,"Sub-basin 2"
3471,100,3,1600,1700,"Sub-basin 2"
3472,200,7,3100,3300,"Sub-basin 2"
3473,400,22.0056,5800,6200,"Sub-basin 2"
3474,100,6.0032,1600,1700,"Sub-basin 2"
3475,700,62,2800,3500,"Sub-basin 2"
3476,3100,211.1291,22700,25800,"Sub-basin 2"
3477,300,4.0166,3000,3300,"Sub-basin 2"
3478,4700,433,7100,11800,"Sub-basin 2"
3479,900,48,5200,6100,"Sub-basin 2"
3480,100,3,1100,1200,"Sub-basin 2"
3481,100,2,2300,2400,"Sub-basin 2"
3482,100,2,1000,1100,"Sub-basin 2"
3483,400,18,3900,4300,"Sub-basin 2"
3484,300,7,1600,1900,"Sub-basin 2"
3485,100,3,800,900,"Sub-basin 2"
3486,100,13,1200,1300,"Sub-basin 2"
3487,100,4,1500,1600,"Sub-basin 2"
3488,4300,187,14500,18800,"Sub-basin 2"
3489,100,2,1200,1300,"Sub-basin 2"
3490,200,6,1700,1900,"Sub-basin 2"
3491,100,1,600,700,"Sub-basin 2"
3492,1000,59,3200,4200,"Sub-basin 2"
3493,300,9,2300,2600,"Sub-basin 2"
3494,500,17,8000,8500,"Sub-basin 2"
3495,5700,247,14500,20200,"Sub-basin 2"
3496,100,1,500,600,"Sub-basin 2"
3497,200,7,900,1100,"Sub-basin 2"
3498,100,2,400,500,"Sub-basin 2"
3499,3000,157,15700,18700,"Sub-basin 2"
3500,1200,84.0321,11600,12800,"Sub-basin 2"
3501,500,17,7400,7900,"Sub-basin 2"
3502,8800,769.3836,31100,39900,"Sub-basin 2"
3503,2700,118,16400,19100,"Sub-basin 2"
3504,1600,83,5200,6800,"Sub-basin 2"
3505,100,1,800,900,"Sub-basin 2"
3506,100,1,1100,1200,"Sub-basin 2"
3507,900,31,2600,3500,"Sub-basin 2"
3508,100,1,500,600,"Sub-basin 2"
3509,200,7,2500,2700,"Sub-basin 2"
3510,500,78,1600,2100,"Sub-basin 2"
3511,300,3,1200,1500,"Sub-basin 2"
3512,100,2,1300,1400,"Sub-basin 2"
3513,100,1,1900,2000,"Sub-basin 2"
3514,1300,189,2100,3400,"Sub-basin 2"
3515,100,2,1900,2000,"Sub-basin 2"
3516,500,36,2200,2700,"Sub-basin 2"
3517,400,14,4700,5100,"Sub-basin 2"
3518,400,22,4300,4700,"Sub-basin 2"
3519,200,6,500,700,"Sub-basin 2"
3520,600,20,8500,9100,"Sub-basin 2"
3521,200,4,700,900,"Sub-basin 2"
3522,300,17,400,700,"Sub-basin 2"
3523,500,32,4400,4900,"Sub-basin 2"
3524,200,4.008,700,900,"Sub-basin 2"
3525,1700,110,13800,15500,"Sub-basin 2"
3526,100,1,1400,1500,"Sub-basin 2"
3527,100,3.0017,500,600,"Sub-basin 2"
3528,500,31,8200,8700,"Sub-basin 2"
3529,400,37,2200,2600,"Sub-basin 2"
3530,200,6,1500,1700,"Sub-basin 2"
3531,100,2,1500,1600,"Sub-basin 2"
3532,800,40,4700,5500,"Sub-basin 2"
3533,100,3,1200,1300,"Sub-basin 2"
3534,200,7,2000,2200,"Sub-basin 2"
3535,600,38,2300,2900,"Sub-basin 2"
3536,1000,29,4000,5000,"Sub-basin 2"
3537,100,1,700,800,"Sub-basin 2"
3538,400,11,1800,2200,"Sub-basin 2"
1,5800,266,11800,17600,"Sub-basin 3"
2,6800,214,29500,36300,"Sub-basin 3"
3,700,28,3200,3900,"Sub-basin 3"
4,800,37,2500,3300,"Sub-basin 3"
5,300,3,1900,2200,"Sub-basin 3"
6,100,1,500,600,"Sub-basin 3"
7,100,3,1800,1900,"Sub-basin 3"
8,100,3,500,600,"Sub-basin 3"
9,300,5,3400,3700,"Sub-basin 3"
10,1200,43,4500,5700,"Sub-basin 3"
11,100,2,2200,2300,"Sub-basin 3"
12,1200,83.67,5300,6500,"Sub-basin 3"
13,1400,48,8200,9600,"Sub-basin 3"
14,8000,232,43000,51000,"Sub-basin 3"
15,1000,42,4800,5800,"Sub-basin 3"
16,300,10.33,2500,2800,"Sub-basin 3"
17,100,1,1400,1500,"Sub-basin 3"
18,100,3,1000,1100,"Sub-basin 3"
19,400,9,2600,3000,"Sub-basin 3"
20,1500,482,2200,3700,"Sub-basin 3"
21,100,1,300,400,"Sub-basin 3"
22,100,1,1200,1300,"Sub-basin 3"
23,1200,62,2600,3800,"Sub-basin 3"
24,2400,75,14800,17200,"Sub-basin 3"
25,200,3,2800,3000,"Sub-basin 3"
26,800,15,6200,7000,"Sub-basin 3"
27,4700,301,17100,21800,"Sub-basin 3"
28,1000,103,2500,3500,"Sub-basin 3"
29,2400,402,3400,5800,"Sub-basin 3"
30,2200,39,8800,11000,"Sub-basin 3"
31,100,1,900,1000,"Sub-basin 3"
32,21500,701.33,45600,67100,"Sub-basin 3"
33,12400,613,24200,36600,"Sub-basin 3"
34,800,32,3300,4100,"Sub-basin 3"
35,300,12,3500,3800,"Sub-basin 3"
36,100,2,1300,1400,"Sub-basin 3"
37,62900,2380,99700,162600,"Sub-basin 3"
38,800,158,2300,3100,"Sub-basin 3"
39,400,10,1500,1900,"Sub-basin 3"
40,200,4,900,1100,"Sub-basin 3"
41,600,10,5200,5800,"Sub-basin 3"
42,200,5,600,800,"Sub-basin 3"
43,2000,242,5800,7800,"Sub-basin 3"
44,3500,180.66,15400,18900,"Sub-basin 3"
45,200,5,2100,2300,"Sub-basin 3"
46,600,71,2500,3100,"Sub-basin 3"
47,4300,232,17600,21900,"Sub-basin 3"
48,100,1,1000,1100,"Sub-basin 3"
49,3100,480,9300,12400,"Sub-basin 3"
50,200,3,2200,2400,"Sub-basin 3"
51,200,2,1400,1600,"Sub-basin 3"
52,1300,116,7500,8800,"Sub-basin 3"
53,1000,22,8200,9200,"Sub-basin 3"
54,400,41,3000,3400,"Sub-basin 3"
55,200,4,4100,4300,"Sub-basin 3"
56,200,2,1600,1800,"Sub-basin 3"
57,1200,30,6200,7400,"Sub-basin 3"
58,100,2,1300,1400,"Sub-basin 3"
59,700,61,2700,3400,"Sub-basin 3"
60,600,24,1500,2100,"Sub-basin 3"
61,3900,164,13300,17200,"Sub-basin 3"
62,100,1,300,400,"Sub-basin 3"
63,900,52,8000,8900,"Sub-basin 3"
64,1600,40,4400,6000,"Sub-basin 3"
65,200,3,1700,1900,"Sub-basin 3"
66,100,1,700,800,"Sub-basin 3"
67,6100,568,30200,36300,"Sub-basin 3"
68,3200,160,10200,13400,"Sub-basin 3"
69,100,2,600,700,"Sub-basin 3"
70,100,1,1900,2000,"Sub-basin 3"
71,300,5,2100,2400,"Sub-basin 3"
72,500,8,2700,3200,"Sub-basin 3"
73,200,7,1700,1900,"Sub-basin 3"
74,700,98,7000,7700,"Sub-basin 3"
75,100,1,900,1000,"Sub-basin 3"
76,200,2,1100,1300,"Sub-basin 3"
77,6300,242,20800,27100,"Sub-basin 3"
78,100,1,1000,1100,"Sub-basin 3"
79,200,2,1300,1500,"Sub-basin 3"
80,100,36,2200,2300,"Sub-basin 3"
81,7100,264.34,26900,34000,"Sub-basin 3"
82,500,21,5900,6400,"Sub-basin 3"
83,100,4,700,800,"Sub-basin 3"
84,100,4,1200,1300,"Sub-basin 3"
85,100,3,1400,1500,"Sub-basin 3"
86,300,9,600,900,"Sub-basin 3"
87,1100,32,4200,5300,"Sub-basin 3"
88,1200,212,3800,5000,"Sub-basin 3"
89,500,12,5000,5500,"Sub-basin 3"
90,100,1,1900,2000,"Sub-basin 3"
91,200,2,2400,2600,"Sub-basin 3"
92,600,132,4200,4800,"Sub-basin 3"
93,400,38,1700,2100,"Sub-basin 3"
94,700,11,6700,7400,"Sub-basin 3"
95,100,2,2100,2200,"Sub-basin 3"
96,500,37,400,900,"Sub-basin 3"
97,8200,521,25200,33400,"Sub-basin 3"
98,100,2,1800,1900,"Sub-basin 3"
99,200,3,2500,2700,"Sub-basin 3"
100,400,13,2900,3300,"Sub-basin 3"
101,8800,793,29100,37900,"Sub-basin 3"
102,6600,242,15900,22500,"Sub-basin 3"
103,200,4,3700,3900,"Sub-basin 3"
104,800,30,10400,11200,"Sub-basin 3"
105,5600,146,20600,26200,"Sub-basin 3"
106,500,21,3300,3800,"Sub-basin 3"
107,100,1,2600,2700,"Sub-basin 3"
108,300,25,1600,1900,"Sub-basin 3"
109,800,14,5700,6500,"Sub-basin 3"
110,100,1,600,700,"Sub-basin 3"
111,200,8,1200,1400,"Sub-basin 3"
112,100,2,1700,1800,"Sub-basin 3"
113,900,21,7500,8400,"Sub-basin 3"
114,100,1,1400,1500,"Sub-basin 3"
115,36900,7880,123200,160100,"Sub-basin 3"
116,1100,349,3200,4300,"Sub-basin 3"
117,200,3,1700,1900,"Sub-basin 3"
118,100,2,1700,1800,"Sub-basin 3"
119,1400,103,4900,6300,"Sub-basin 3"
120,300,10,1400,1700,"Sub-basin 3"
121,100,2,1200,1300,"Sub-basin 3"
122,200,4,2200,2400,"Sub-basin 3"
123,200,4,2000,2200,"Sub-basin 3"
124,200,4,6000,6200,"Sub-basin 3"
125,100,4,2800,2900,"Sub-basin 3"
126,2300,89,9800,12100,"Sub-basin 3"
127,800,23,4900,5700,"Sub-basin 3"
128,100,1,1100,1200,"Sub-basin 3"
129,100,1,3600,3700,"Sub-basin 3"
130,2000,60,11500,13500,"Sub-basin 3"
131,300,4,1900,2200,"Sub-basin 3"
132,100,1,800,900,"Sub-basin 3"
133,200,3,1800,2000,"Sub-basin 3"
134,100,1,1400,1500,"Sub-basin 3"
135,2000,403,2300,4300,"Sub-basin 3"
136,100,2,3500,3600,"Sub-basin 3"
137,300,4,3400,3700,"Sub-basin 3"
138,1900,87,6200,8100,"Sub-basin 3"
139,1900,68,11400,13300,"Sub-basin 3"
140,100,1,1000,1100,"Sub-basin 3"
141,400,16,900,1300,"Sub-basin 3"
142,900,20,3600,4500,"Sub-basin 3"
143,400,24,3300,3700,"Sub-basin 3"
144,200,5,2100,2300,"Sub-basin 3"
145,100,1,800,900,"Sub-basin 3"
146,100,2,800,900,"Sub-basin 3"
147,1000,28,5400,6400,"Sub-basin 3"
148,1100,50,5500,6600,"Sub-basin 3"
149,600,10,3900,4500,"Sub-basin 3"
150,200,4,2400,2600,"Sub-basin 3"
151,200,6,1800,2000,"Sub-basin 3"
152,100,2,1400,1500,"Sub-basin 3"
153,2400,36,11800,14200,"Sub-basin 3"
154,1000,31,5500,6500,"Sub-basin 3"
155,300,7,2400,2700,"Sub-basin 3"
156,300,7,200,500,"Sub-basin 3"
157,100,1,200,300,"Sub-basin 3"
158,3400,129,15300,18700,"Sub-basin 3"
159,400,6,2000,2400,"Sub-basin 3"
160,200,3,1400,1600,"Sub-basin 3"
161,200,10,1500,1700,"Sub-basin 3"
162,100,2,1400,1500,"Sub-basin 3"
163,500,39,2700,3200,"Sub-basin 3"
164,200,3,2400,2600,"Sub-basin 3"
165,1000,18,5600,6600,"Sub-basin 3"
166,400,9,1600,2000,"Sub-basin 3"
167,1700,35,8400,10100,"Sub-basin 3"
168,800,34,1900,2700,"Sub-basin 3"
169,100,1,1700,1800,"Sub-basin 3"
170,100,3,2200,2300,"Sub-basin 3"
171,1000,32,9900,10900,"Sub-basin 3"
172,100,3,1200,1300,"Sub-basin 3"
173,200,3,1500,1700,"Sub-basin 3"
174,300,4.5,1800,2100,"Sub-basin 3"
175,3600,258.5,14200,17800,"Sub-basin 3"
176,1900,81,4100,6000,"Sub-basin 3"
177,200,5,1200,1400,"Sub-basin 3"
178,100,1,1400,1500,"Sub-basin 3"
179,800,46,3700,4500,"Sub-basin 3"
180,500,9,4300,4800,"Sub-basin 3"
181,200,5,4800,5000,"Sub-basin 3"
182,2600,233,7200,9800,"Sub-basin 3"
183,500,9,2600,3100,"Sub-basin 3"
184,700,17,2900,3600,"Sub-basin 3"
185,100,2,1100,1200,"Sub-basin 3"
186,200,2,1500,1700,"Sub-basin 3"
187,100,1,1000,1100,"Sub-basin 3"
188,100,3,1500,1600,"Sub-basin 3"
189,16400,1088,101900,118300,"Sub-basin 3"
190,600,33,3900,4500,"Sub-basin 3"
191,11500,300,19800,31300,"Sub-basin 3"
192,100,1,1500,1600,"Sub-basin 3"
193,300,5,1700,2000,"Sub-basin 3"
194,1300,43,10200,11500,"Sub-basin 3"
195,600,18,5700,6300,"Sub-basin 3"
196,300,29,1100,1400,"Sub-basin 3"
197,300,5,4300,4600,"Sub-basin 3"
198,200,3,2000,2200,"Sub-basin 3"
199,100,1,300,400,"Sub-basin 3"
200,100,3,1400,1500,"Sub-basin 3"
201,32200,1422,65300,97500,"Sub-basin 3"
202,100,5,1700,1800,"Sub-basin 3"
203,300,4,2500,2800,"Sub-basin 3"
204,200,7,2200,2400,"Sub-basin 3"
205,800,116,1700,2500,"Sub-basin 3"
206,100,3,1100,1200,"Sub-basin 3"
207,200,3,1700,1900,"Sub-basin 3"
208,200,2,1300,1500,"Sub-basin 3"
209,100,1,1000,1100,"Sub-basin 3"
210,3500,534,12000,15500,"Sub-basin 3"
211,1200,29,13700,14900,"Sub-basin 3"
212,1400,128,1800,3200,"Sub-basin 3"
213,100,2,1600,1700,"Sub-basin 3"
214,14800,579,38000,52800,"Sub-basin 3"
215,800,17,1800,2600,"Sub-basin 3"
216,200,2,2100,2300,"Sub-basin 3"
217,200,2,2600,2800,"Sub-basin 3"
218,2000,101,9800,11800,"Sub-basin 3"
219,200,3,1100,1300,"Sub-basin 3"
220,400,34,2400,2800,"Sub-basin 3"
221,100,1,1100,1200,"Sub-basin 3"
222,100,1,700,800,"Sub-basin 3"
223,600,9,2200,2800,"Sub-basin 3"
224,600,17,5300,5900,"Sub-basin 3"
225,100,3,1200,1300,"Sub-basin 3"
226,500,25,3200,3700,"Sub-basin 3"
227,13600,1710,38900,52500,"Sub-basin 3"
228,200,5,2600,2800,"Sub-basin 3"
229,300,12,2900,3200,"Sub-basin 3"
230,100,2,700,800,"Sub-basin 3"
231,100,2,200,300,"Sub-basin 3"
232,100,1,1400,1500,"Sub-basin 3"
233,22300,10835,35900,58200,"Sub-basin 3"
234,1900,53,9700,11600,"Sub-basin 3"
235,400,9,700,1100,"Sub-basin 3"
236,200,19,1800,2000,"Sub-basin 3"
237,2500,118,9200,11700,"Sub-basin 3"
238,57100,2351,92200,149300,"Sub-basin 3"
239,100,1,800,900,"Sub-basin 3"
240,1200,52,16900,18100,"Sub-basin 3"
241,100,1,1500,1600,"Sub-basin 3"
242,1300,136,9600,10900,"Sub-basin 3"
243,100,1,600,700,"Sub-basin 3"
244,2700,224,9900,12600,"Sub-basin 3"
245,300,7,5300,5600,"Sub-basin 3"
246,100,1,1700,1800,"Sub-basin 3"
247,500,39,2400,2900,"Sub-basin 3"
248,1000,212,3000,4000,"Sub-basin 3"
249,1600,160.17,6500,8100,"Sub-basin 3"
250,100,2,1200,1300,"Sub-basin 3"
251,100,1,1100,1200,"Sub-basin 3"
252,20200,638,73600,93800,"Sub-basin 3"
253,100,1,1000,1100,"Sub-basin 3"
254,1200,169,4400,5600,"Sub-basin 3"
255,700,25,5900,6600,"Sub-basin 3"
256,4300,1486,6600,10900,"Sub-basin 3"
257,100,3,500,600,"Sub-basin 3"
258,800,17,1800,2600,"Sub-basin 3"
259,100,2,1300,1400,"Sub-basin 3"
260,1100,168,2300,3400,"Sub-basin 3"
261,5100,1453,10500,15600,"Sub-basin 3"
262,100,3,1100,1200,"Sub-basin 3"
263,100,4,1100,1200,"Sub-basin 3"
264,5100,108,21600,26700,"Sub-basin 3"
265,300,6,1900,2200,"Sub-basin 3"
266,500,19,2700,3200,"Sub-basin 3"
267,100,2,400,500,"Sub-basin 3"
268,300,6,3000,3300,"Sub-basin 3"
269,200,5,2700,2900,"Sub-basin 3"
270,800,107,5800,6600,"Sub-basin 3"
271,100,2,1500,1600,"Sub-basin 3"
272,300,27,1400,1700,"Sub-basin 3"
273,100,4,1200,1300,"Sub-basin 3"
274,100,1,400,500,"Sub-basin 3"
275,100,3,1000,1100,"Sub-basin 3"
276,100,1,1600,1700,"Sub-basin 3"
277,900,21,1400,2300,"Sub-basin 3"
278,800,186,2000,2800,"Sub-basin 3"
279,200,4,2000,2200,"Sub-basin 3"
280,800,32,4400,5200,"Sub-basin 3"
281,3000,121,14300,17300,"Sub-basin 3"
282,100,1,900,1000,"Sub-basin 3"
283,100,2,600,700,"Sub-basin 3"
284,200,4,2000,2200,"Sub-basin 3"
285,4500,156,19900,24400,"Sub-basin 3"
286,300,7,3800,4100,"Sub-basin 3"
287,300,6,4200,4500,"Sub-basin 3"
288,200,4,1600,1800,"Sub-basin 3"
289,400,4,1400,1800,"Sub-basin 3"
290,700,11,4800,5500,"Sub-basin 3"
291,100,2,400,500,"Sub-basin 3"
292,600,41,5300,5900,"Sub-basin 3"
293,1100,114,3200,4300,"Sub-basin 3"
294,100,3,1400,1500,"Sub-basin 3"
295,100,1,800,900,"Sub-basin 3"
296,100,4,1200,1300,"Sub-basin 3"
297,2500,107,13800,16300,"Sub-basin 3"
298,2000,244,7000,9000,"Sub-basin 3"
299,100,1,1300,1400,"Sub-basin 3"
300,100,1,300,400,"Sub-basin 3"
301,11000,320,34200,45200,"Sub-basin 3"
302,100,1,300,400,"Sub-basin 3"
303,800,25,10800,11600,"Sub-basin 3"
304,200,3,2400,2600,"Sub-basin 3"
305,100,4,600,700,"Sub-basin 3"
306,300,13,3700,4000,"Sub-basin 3"
307,600,84,5200,5800,"Sub-basin 3"
308,14200,806,46700,60900,"Sub-basin 3"
309,900,83,9100,10000,"Sub-basin 3"
310,4300,223,13000,17300,"Sub-basin 3"
311,500,24,1000,1500,"Sub-basin 3"
312,100,1,0,100,"Sub-basin 3"
313,300,7,700,1000,"Sub-basin 3"
314,100,3,900,1000,"Sub-basin 3"
315,1200,93,4300,5500,"Sub-basin 3"
316,500,72,3600,4100,"Sub-basin 3"
317,300,6,2600,2900,"Sub-basin 3"
318,100,2,3000,3100,"Sub-basin 3"
319,100,2,0,100,"Sub-basin 3"
320,300,48,600,900,"Sub-basin 3"
321,2900,118,19500,22400,"Sub-basin 3"
322,2000,176,10000,12000,"Sub-basin 3"
323,100,3,800,900,"Sub-basin 3"
324,100,3,600,700,"Sub-basin 3"
325,200,3,4100,4300,"Sub-basin 3"
326,100,4,3100,3200,"Sub-basin 3"
327,1600,90,18000,19600,"Sub-basin 3"
328,100,2,2800,2900,"Sub-basin 3"
329,600,37,1500,2100,"Sub-basin 3"
330,100,6,400,500,"Sub-basin 3"
331,1100,199,4300,5400,"Sub-basin 3"
332,100,1,1000,1100,"Sub-basin 3"
333,1200,35,8500,9700,"Sub-basin 3"
334,800,53,6800,7600,"Sub-basin 3"
335,400,9,6000,6400,"Sub-basin 3"
336,800,19,11500,12300,"Sub-basin 3"
337,100,2,600,700,"Sub-basin 3"
338,200,3,1600,1800,"Sub-basin 3"
339,200,3,600,800,"Sub-basin 3"
340,200,5,2000,2200,"Sub-basin 3"
341,200,4,1400,1600,"Sub-basin 3"
342,200,8,1600,1800,"Sub-basin 3"
343,100,4,1500,1600,"Sub-basin 3"
344,100,5,2800,2900,"Sub-basin 3"
345,1300,104,11900,13200,"Sub-basin 3"
346,1000,110,4400,5400,"Sub-basin 3"
347,100,1,1300,1400,"Sub-basin 3"
348,100,2,1300,1400,"Sub-basin 3"
349,400,10,3400,3800,"Sub-basin 3"
350,100,6,2100,2200,"Sub-basin 3"
351,500,18,7000,7500,"Sub-basin 3"
352,300,7,3400,3700,"Sub-basin 3"
353,400,33,3300,3700,"Sub-basin 3"
354,800,105,3100,3900,"Sub-basin 3"
355,1300,122,10400,11700,"Sub-basin 3"
356,8100,277,21100,29200,"Sub-basin 3"
357,600,95,5800,6400,"Sub-basin 3"
358,400,8,1600,2000,"Sub-basin 3"
359,3300,101,16700,20000,"Sub-basin 3"
360,107600,4894.69,176900,284500,"Sub-basin 3"
361,300,7,2700,3000,"Sub-basin 3"
362,100,1,400,500,"Sub-basin 3"
363,12000,573,64600,76600,"Sub-basin 3"
364,700,76,14500,15200,"Sub-basin 3"
365,200,4,600,800,"Sub-basin 3"
366,10200,2038,22700,32900,"Sub-basin 3"
367,2700,64,18500,21200,"Sub-basin 3"
368,4500,278,23800,28300,"Sub-basin 3"
369,100,4,2000,2100,"Sub-basin 3"
370,200,11,2500,2700,"Sub-basin 3"
371,100,1,1700,1800,"Sub-basin 3"
372,100,2,2700,2800,"Sub-basin 3"
373,100,5,1700,1800,"Sub-basin 3"
374,7800,433,32800,40600,"Sub-basin 3"
375,300,5,3300,3600,"Sub-basin 3"
376,1500,153,7500,9000,"Sub-basin 3"
377,5900,445,47300,53200,"Sub-basin 3"
378,500,10,8000,8500,"Sub-basin 3"
379,600,23,5900,6500,"Sub-basin 3"
380,1100,88,4700,5800,"Sub-basin 3"
381,300,4,2400,2700,"Sub-basin 3"
382,200,4,3500,3700,"Sub-basin 3"
383,100,1,1300,1400,"Sub-basin 3"
384,200,3,2700,2900,"Sub-basin 3"
385,7800,335,26800,34600,"Sub-basin 3"
386,7800,851,23500,31300,"Sub-basin 3"
387,100,2,600,700,"Sub-basin 3"
388,1400,284,5200,6600,"Sub-basin 3"
389,800,21,4500,5300,"Sub-basin 3"
390,600,10,3500,4100,"Sub-basin 3"
391,100,6,2600,2700,"Sub-basin 3"
392,400,28,7000,7400,"Sub-basin 3"
393,100,2,1800,1900,"Sub-basin 3"
394,100,1,1400,1500,"Sub-basin 3"
395,300,5,2000,2300,"Sub-basin 3"
396,300,11,4800,5100,"Sub-basin 3"
397,100,1,2600,2700,"Sub-basin 3"
398,100,2,200,300,"Sub-basin 3"
399,400,52,1100,1500,"Sub-basin 3"
400,1100,86,5400,6500,"Sub-basin 3"
401,100,1,400,500,"Sub-basin 3"
402,300,5,5600,5900,"Sub-basin 3"
403,100,2,1500,1600,"Sub-basin 3"
404,200,7,3500,3700,"Sub-basin 3"
405,200,5,500,700,"Sub-basin 3"
406,600,33,4500,5100,"Sub-basin 3"
407,700,22,1900,2600,"Sub-basin 3"
408,200,2,1200,1400,"Sub-basin 3"
409,1100,37,6000,7100,"Sub-basin 3"
410,100,3,800,900,"Sub-basin 3"
411,200,8,2200,2400,"Sub-basin 3"
412,100,1,1500,1600,"Sub-basin 3"
413,100,1,1900,2000,"Sub-basin 3"
414,100,4,1000,1100,"Sub-basin 3"
415,400,6,2000,2400,"Sub-basin 3"
416,100,5,3100,3200,"Sub-basin 3"
417,1000,46,15000,16000,"Sub-basin 3"
418,200,7,3400,3600,"Sub-basin 3"
419,200,2,1600,1800,"Sub-basin 3"
420,200,3,1300,1500,"Sub-basin 3"
421,4700,909,8800,13500,"Sub-basin 3"
422,3700,219,30500,34200,"Sub-basin 3"
423,100,4,2100,2200,"Sub-basin 3"
424,100,4,2300,2400,"Sub-basin 3"
425,1400,83,12600,14000,"Sub-basin 3"
426,200,2,100,300,"Sub-basin 3"
427,200,4,900,1100,"Sub-basin 3"
428,100,2,900,1000,"Sub-basin 3"
429,100,4,2200,2300,"Sub-basin 3"
430,200,4,2700,2900,"Sub-basin 3"
431,100,1,1200,1300,"Sub-basin 3"
432,3000,81,14400,17400,"Sub-basin 3"
433,6900,383,24300,31200,"Sub-basin 3"
434,1300,89,6700,8000,"Sub-basin 3"
435,100,1,400,500,"Sub-basin 3"
436,200,11,1700,1900,"Sub-basin 3"
437,100,2,600,700,"Sub-basin 3"
438,200,4,4400,4600,"Sub-basin 3"
439,3800,124,25100,28900,"Sub-basin 3"
440,100,1,1300,1400,"Sub-basin 3"
441,200,9,1100,1300,"Sub-basin 3"
442,1500,135,5000,6500,"Sub-basin 3"
443,200,6,3600,3800,"Sub-basin 3"
444,100,1,2200,2300,"Sub-basin 3"
445,6800,621,33400,40200,"Sub-basin 3"
446,4400,330,22800,27200,"Sub-basin 3"
447,19700,2358.84,64900,84600,"Sub-basin 3"
448,1000,41,11000,12000,"Sub-basin 3"
449,400,23,2400,2800,"Sub-basin 3"
450,2500,85.17,19800,22300,"Sub-basin 3"
451,1100,133,2500,3600,"Sub-basin 3"
452,400,10,2500,2900,"Sub-basin 3"
453,600,15,2400,3000,"Sub-basin 3"
454,1700,65,12700,14400,"Sub-basin 3"
455,100,3,1600,1700,"Sub-basin 3"
456,400,10,9700,10100,"Sub-basin 3"
457,2900,259,16400,19300,"Sub-basin 3"
458,600,28,2800,3400,"Sub-basin 3"
459,400,22,6800,7200,"Sub-basin 3"
460,400,16,6900,7300,"Sub-basin 3"
461,200,4,1400,1600,"Sub-basin 3"
462,400,33,3200,3600,"Sub-basin 3"
463,200,8,2700,2900,"Sub-basin 3"
464,100,2,300,400,"Sub-basin 3"
465,100,1,1800,1900,"Sub-basin 3"
466,5300,211,22900,28200,"Sub-basin 3"
467,300,5,3500,3800,"Sub-basin 3"
468,8700,506,78500,87200,"Sub-basin 3"
469,400,27,1000,1400,"Sub-basin 3"
470,100,1,1500,1600,"Sub-basin 3"
471,4500,496,24000,28500,"Sub-basin 3"
472,500,15,3800,4300,"Sub-basin 3"
473,1100,134,7200,8300,"Sub-basin 3"
474,1200,109,11900,13100,"Sub-basin 3"
475,300,8,4000,4300,"Sub-basin 3"
476,2900,144,17600,20500,"Sub-basin 3"
477,100,4,1700,1800,"Sub-basin 3"
478,133500,26303.16,127400,260900,"Sub-basin 3"
479,500,12,4900,5400,"Sub-basin 3"
480,3100,75,13700,16800,"Sub-basin 3"
481,600,64,2800,3400,"Sub-basin 3"
482,1300,108,6200,7500,"Sub-basin 3"
483,200,4,2800,3000,"Sub-basin 3"
484,200,2,1700,1900,"Sub-basin 3"
485,100,1,1100,1200,"Sub-basin 3"
486,500,20,7300,7800,"Sub-basin 3"
487,200,5,2900,3100,"Sub-basin 3"
488,200,7,1300,1500,"Sub-basin 3"
489,2000,104,13900,15900,"Sub-basin 3"
490,300,14,2400,2700,"Sub-basin 3"
491,10000,1193,11900,21900,"Sub-basin 3"
492,700,45,5000,5700,"Sub-basin 3"
493,500,78,6100,6600,"Sub-basin 3"
494,800,27,3800,4600,"Sub-basin 3"
495,100,2,1300,1400,"Sub-basin 3"
496,200,2,400,600,"Sub-basin 3"
497,100,2,1800,1900,"Sub-basin 3"
498,2900,1047,10600,13500,"Sub-basin 3"
499,400,12,1900,2300,"Sub-basin 3"
500,17400,1867,61200,78600,"Sub-basin 3"
501,300,5,2600,2900,"Sub-basin 3"
502,2000,177,12800,14800,"Sub-basin 3"
503,200,5,2700,2900,"Sub-basin 3"
504,100,1,1100,1200,"Sub-basin 3"
505,100,3,1300,1400,"Sub-basin 3"
506,900,205,3600,4500,"Sub-basin 3"
507,100,4,800,900,"Sub-basin 3"
508,100,1,2100,2200,"Sub-basin 3"
509,5600,226,21800,27400,"Sub-basin 3"
510,7300,220,27500,34800,"Sub-basin 3"
511,400,15,4400,4800,"Sub-basin 3"
512,100,5,2700,2800,"Sub-basin 3"
513,300,18,4000,4300,"Sub-basin 3"
514,300,6,5600,5900,"Sub-basin 3"
515,25600,1864,53400,79000,"Sub-basin 3"
516,100,1,800,900,"Sub-basin 3"
517,5500,196,26600,32100,"Sub-basin 3"
518,200,6,2100,2300,"Sub-basin 3"
519,500,48,4100,4600,"Sub-basin 3"
520,100,1,1800,1900,"Sub-basin 3"
521,200,4,3900,4100,"Sub-basin 3"
522,100,2,1400,1500,"Sub-basin 3"
523,600,11,8100,8700,"Sub-basin 3"
524,500,35,4600,5100,"Sub-basin 3"
525,200,10,4100,4300,"Sub-basin 3"
526,1300,39,10300,11600,"Sub-basin 3"
527,600,13,5800,6400,"Sub-basin 3"
528,1500,163,8700,10200,"Sub-basin 3"
529,200,4,1000,1200,"Sub-basin 3"
530,800,88,3800,4600,"Sub-basin 3"
531,6700,517,31600,38300,"Sub-basin 3"
532,200,2,3000,3200,"Sub-basin 3"
533,1500,165,7800,9300,"Sub-basin 3"
534,9500,285,50400,59900,"Sub-basin 3"
535,500,13,2200,2700,"Sub-basin 3"
536,2200,165,6500,8700,"Sub-basin 3"
537,1600,327,7500,9100,"Sub-basin 3"
538,200,7,4200,4400,"Sub-basin 3"
539,32900,9957.84,24800,57700,"Sub-basin 3"
540,600,41,7000,7600,"Sub-basin 3"
541,100,1,2100,2200,"Sub-basin 3"
542,100,1,500,600,"Sub-basin 3"
543,200,3,1900,2100,"Sub-basin 3"
544,100,2,100,200,"Sub-basin 3"
545,6700,3038,12100,18800,"Sub-basin 3"
546,500,14,4100,4600,"Sub-basin 3"
547,600,124,2600,3200,"Sub-basin 3"
548,100,2,2300,2400,"Sub-basin 3"
549,200,3,1900,2100,"Sub-basin 3"
550,300,12,2100,2400,"Sub-basin 3"
551,100,1,300,400,"Sub-basin 3"
552,300,6,3200,3500,"Sub-basin 3"
553,3000,440.84,5900,8900,"Sub-basin 3"
554,100,3,1800,1900,"Sub-basin 3"
555,200,3,2800,3000,"Sub-basin 3"
556,300,7,1200,1500,"Sub-basin 3"
557,100,1,2400,2500,"Sub-basin 3"
558,600,27,4700,5300,"Sub-basin 3"
559,300,17,2800,3100,"Sub-basin 3"
560,100,1,1500,1600,"Sub-basin 3"
561,100,2,700,800,"Sub-basin 3"
562,600,25,4200,4800,"Sub-basin 3"
563,400,11,2500,2900,"Sub-basin 3"
564,800,32,6100,6900,"Sub-basin 3"
565,400,12,4400,4800,"Sub-basin 3"
566,500,38,2400,2900,"Sub-basin 3"
567,400,14,2800,3200,"Sub-basin 3"
568,200,4,1400,1600,"Sub-basin 3"
569,200,6,2200,2400,"Sub-basin 3"
570,400,41,2900,3300,"Sub-basin 3"
571,200,31,2200,2400,"Sub-basin 3"
572,3800,718.33,13200,17000,"Sub-basin 3"
573,100,2,1700,1800,"Sub-basin 3"
574,100,1,1600,1700,"Sub-basin 3"
575,300,6,3100,3400,"Sub-basin 3"
576,200,4,1500,1700,"Sub-basin 3"
577,1900,92,9300,11200,"Sub-basin 3"
578,100,1,700,800,"Sub-basin 3"
579,800,26,4400,5200,"Sub-basin 3"
580,100,1,2300,2400,"Sub-basin 3"
581,100,1,2300,2400,"Sub-basin 3"
582,200,3,3800,4000,"Sub-basin 3"
583,200,4,2300,2500,"Sub-basin 3"
584,1000,49,5300,6300,"Sub-basin 3"
585,900,28,6800,7700,"Sub-basin 3"
586,1000,214,3600,4600,"Sub-basin 3"
587,2300,98,15400,17700,"Sub-basin 3"
588,49600,3326,163200,212800,"Sub-basin 3"
589,20200,2047,30500,50700,"Sub-basin 3"
590,500,14,5600,6100,"Sub-basin 3"
591,2400,193.17,14700,17100,"Sub-basin 3"
592,200,5,1600,1800,"Sub-basin 3"
593,100,3,1300,1400,"Sub-basin 3"
594,700,34,4700,5400,"Sub-basin 3"
595,4500,205,26600,31100,"Sub-basin 3"
596,100,3,1600,1700,"Sub-basin 3"
597,200,2,1700,1900,"Sub-basin 3"
598,300,16,1700,2000,"Sub-basin 3"
599,100,3,2300,2400,"Sub-basin 3"
600,1000,61,14000,15000,"Sub-basin 3"
601,100,1,2800,2900,"Sub-basin 3"
602,1000,13,11500,12500,"Sub-basin 3"
603,100,7,1400,1500,"Sub-basin 3"
604,100,3,1500,1600,"Sub-basin 3"
605,100,2,1700,1800,"Sub-basin 3"
606,100,2,700,800,"Sub-basin 3"
607,200,6,1400,1600,"Sub-basin 3"
608,100,3,1200,1300,"Sub-basin 3"
609,1400,47,10000,11400,"Sub-basin 3"
610,2400,98,12900,15300,"Sub-basin 3"
611,7000,335,22300,29300,"Sub-basin 3"
612,1000,42,5700,6700,"Sub-basin 3"
613,4800,332,27700,32500,"Sub-basin 3"
614,100,0.34,1900,2000,"Sub-basin 3"
615,200,5,2600,2800,"Sub-basin 3"
616,400,12,2400,2800,"Sub-basin 3"
617,600,14,5700,6300,"Sub-basin 3"
618,200,5,2000,2200,"Sub-basin 3"
619,200,3,3600,3800,"Sub-basin 3"
620,300,6,2700,3000,"Sub-basin 3"
621,100,3,1100,1200,"Sub-basin 3"
622,100,1,1400,1500,"Sub-basin 3"
623,100,2,2300,2400,"Sub-basin 3"
624,500,12,4800,5300,"Sub-basin 3"
625,400,19,4200,4600,"Sub-basin 3"
626,200,2,300,500,"Sub-basin 3"
627,300,6,2400,2700,"Sub-basin 3"
628,100,4,1100,1200,"Sub-basin 3"
629,200,4,1500,1700,"Sub-basin 3"
630,400,6,4000,4400,"Sub-basin 3"
631,4700,404,32100,36800,"Sub-basin 3"
632,1500,54,5000,6500,"Sub-basin 3"
633,200,12,3200,3400,"Sub-basin 3"
634,100,5,800,900,"Sub-basin 3"
635,200,3,2700,2900,"Sub-basin 3"
636,400,7,5200,5600,"Sub-basin 3"
637,2400,248,14400,16800,"Sub-basin 3"
638,200,4,1300,1500,"Sub-basin 3"
639,1000,42,7100,8100,"Sub-basin 3"
640,49700,1908.33,227100,276800,"Sub-basin 3"
641,100,7,1100,1200,"Sub-basin 3"
642,100,2,2200,2300,"Sub-basin 3"
643,100,1,400,500,"Sub-basin 3"
644,100,2,1100,1200,"Sub-basin 3"
645,100,3,2700,2800,"Sub-basin 3"
646,700,92,6000,6700,"Sub-basin 3"
647,500,18,3900,4400,"Sub-basin 3"
648,200,10,3400,3600,"Sub-basin 3"
649,100,3,800,900,"Sub-basin 3"
650,400,6,6600,7000,"Sub-basin 3"
651,200,4,1000,1200,"Sub-basin 3"
652,300,16,4400,4700,"Sub-basin 3"
653,1600,190,9700,11300,"Sub-basin 3"
654,100,2,1700,1800,"Sub-basin 3"
655,800,26,5200,6000,"Sub-basin 3"
656,7800,233,19500,27300,"Sub-basin 3"
657,900,44,7300,8200,"Sub-basin 3"
658,300,8,4900,5200,"Sub-basin 3"
659,200,6,2600,2800,"Sub-basin 3"
660,300,9,4800,5100,"Sub-basin 3"
661,100,1,1900,2000,"Sub-basin 3"
662,4700,434,22400,27100,"Sub-basin 3"
663,100,4,900,1000,"Sub-basin 3"
664,100,4,2000,2100,"Sub-basin 3"
665,1600,360,6800,8400,"Sub-basin 3"
666,800,61,5100,5900,"Sub-basin 3"
667,200,4,1700,1900,"Sub-basin 3"
668,800,75,3800,4600,"Sub-basin 3"
669,1400,22,16700,18100,"Sub-basin 3"
670,200,3,700,900,"Sub-basin 3"
671,100,1,500,600,"Sub-basin 3"
672,200,7,3900,4100,"Sub-basin 3"
673,200,5,2600,2800,"Sub-basin 3"
674,100,1,1200,1300,"Sub-basin 3"
675,6300,538,34400,40700,"Sub-basin 3"
676,400,13,5300,5700,"Sub-basin 3"
677,500,8,9000,9500,"Sub-basin 3"
678,1700,101,17100,18800,"Sub-basin 3"
679,100,1,2400,2500,"Sub-basin 3"
680,100,5,2300,2400,"Sub-basin 3"
681,4000,237,36800,40800,"Sub-basin 3"
682,100,1,1700,1800,"Sub-basin 3"
683,100,2,500,600,"Sub-basin 3"
684,200,16,1200,1400,"Sub-basin 3"
685,100,7,900,1000,"Sub-basin 3"
686,300,8,3700,4000,"Sub-basin 3"
687,300,16,3300,3600,"Sub-basin 3"
688,300,5,2400,2700,"Sub-basin 3"
689,2800,61,12000,14800,"Sub-basin 3"
690,100,1,300,400,"Sub-basin 3"
691,200,12,3100,3300,"Sub-basin 3"
692,1200,75,12800,14000,"Sub-basin 3"
693,200,2,2400,2600,"Sub-basin 3"
694,400,6,3700,4100,"Sub-basin 3"
695,4800,383,15600,20400,"Sub-basin 3"
696,200,2,3700,3900,"Sub-basin 3"
697,1300,358,2200,3500,"Sub-basin 3"
698,1300,30,5200,6500,"Sub-basin 3"
699,400,11,4400,4800,"Sub-basin 3"
700,100,1,1400,1500,"Sub-basin 3"
701,15800,1086,61100,76900,"Sub-basin 3"
702,400,16,4800,5200,"Sub-basin 3"
703,1400,90,10500,11900,"Sub-basin 3"
704,200,6,3000,3200,"Sub-basin 3"
705,500,42,2800,3300,"Sub-basin 3"
706,2800,164,26200,29000,"Sub-basin 3"
707,200,5,3000,3200,"Sub-basin 3"
708,100,2,700,800,"Sub-basin 3"
709,7800,1869,9700,17500,"Sub-basin 3"
710,100,2,2100,2200,"Sub-basin 3"
711,100,3,1800,1900,"Sub-basin 3"
712,1000,67,7700,8700,"Sub-basin 3"
713,400,101,3700,4100,"Sub-basin 3"
714,3900,204,16700,20600,"Sub-basin 3"
715,100,2,400,500,"Sub-basin 3"
716,300,11,5000,5300,"Sub-basin 3"
717,100,3,2000,2100,"Sub-basin 3"
718,200,6,2900,3100,"Sub-basin 3"
719,100,1,2600,2700,"Sub-basin 3"
720,102100,31851.16,71300,173400,"Sub-basin 3"
721,300,7,1900,2200,"Sub-basin 3"
722,100,1,800,900,"Sub-basin 3"
723,4200,654,7600,11800,"Sub-basin 3"
724,300,12,3800,4100,"Sub-basin 3"
725,300,6,4000,4300,"Sub-basin 3"
726,200,6,2700,2900,"Sub-basin 3"
727,100,5,1400,1500,"Sub-basin 3"
728,100,2,2100,2200,"Sub-basin 3"
729,400,16,2700,3100,"Sub-basin 3"
730,1900,102,6300,8200,"Sub-basin 3"
731,200,5,600,800,"Sub-basin 3"
732,300,8,3600,3900,"Sub-basin 3"
733,200,5,2400,2600,"Sub-basin 3"
734,100,4,1400,1500,"Sub-basin 3"
735,100,1,2300,2400,"Sub-basin 3"
736,200,8,2100,2300,"Sub-basin 3"
737,500,23,1300,1800,"Sub-basin 3"
738,7900,370,17200,25100,"Sub-basin 3"
739,1700,47,16500,18200,"Sub-basin 3"
740,400,13,5700,6100,"Sub-basin 3"
741,100,3,900,1000,"Sub-basin 3"
742,800,39,10700,11500,"Sub-basin 3"
743,100,3,600,700,"Sub-basin 3"
744,100,1,2300,2400,"Sub-basin 3"
745,100,6,1300,1400,"Sub-basin 3"
746,800,104,6600,7400,"Sub-basin 3"
747,200,4,1600,1800,"Sub-basin 3"
748,500,15,2100,2600,"Sub-basin 3"
749,100,1,1200,1300,"Sub-basin 3"
750,100,4,1300,1400,"Sub-basin 3"
751,1300,56,14900,16200,"Sub-basin 3"
752,400,13,2800,3200,"Sub-basin 3"
753,13800,2423,22400,36200,"Sub-basin 3"
754,2500,161,7000,9500,"Sub-basin 3"
755,300,12,4600,4900,"Sub-basin 3"
756,200,4,1900,2100,"Sub-basin 3"
757,500,20,6100,6600,"Sub-basin 3"
758,200,3,3400,3600,"Sub-basin 3"
759,700,25,8400,9100,"Sub-basin 3"
760,800,75,3900,4700,"Sub-basin 3"
761,100,8,1800,1900,"Sub-basin 3"
762,2500,97,19800,22300,"Sub-basin 3"
763,100,3,800,900,"Sub-basin 3"
764,100,1,1100,1200,"Sub-basin 3"
765,300,5,4000,4300,"Sub-basin 3"
766,200,3,3000,3200,"Sub-basin 3"
767,200,4,2100,2300,"Sub-basin 3"
768,100,2,600,700,"Sub-basin 3"
769,300,8,4600,4900,"Sub-basin 3"
770,2400,161,11300,13700,"Sub-basin 3"
771,100,1,1200,1300,"Sub-basin 3"
772,1200,60,9000,10200,"Sub-basin 3"
773,400,13,2400,2800,"Sub-basin 3"
774,100,1,1500,1600,"Sub-basin 3"
775,200,3,3300,3500,"Sub-basin 3"
776,300,6,1800,2100,"Sub-basin 3"
777,100,5,1400,1500,"Sub-basin 3"
778,500,24,5800,6300,"Sub-basin 3"
779,300,10,3300,3600,"Sub-basin 3"
780,1800,117,5500,7300,"Sub-basin 3"
781,800,192,2700,3500,"Sub-basin 3"
782,2400,224,17200,19600,"Sub-basin 3"
783,100,2,1100,1200,"Sub-basin 3"
784,3800,412,14000,17800,"Sub-basin 3"
785,100,1,700,800,"Sub-basin 3"
786,100,3,1000,1100,"Sub-basin 3"
787,700,9,4600,5300,"Sub-basin 3"
788,100,1,1300,1400,"Sub-basin 3"
789,400,10,5400,5800,"Sub-basin 3"
790,100,3,900,1000,"Sub-basin 3"
791,2000,124,18700,20700,"Sub-basin 3"
792,100,2,1400,1500,"Sub-basin 3"
793,100,2,1400,1500,"Sub-basin 3"
794,4300,245,17200,21500,"Sub-basin 3"
795,500,24,5700,6200,"Sub-basin 3"
796,400,37,4100,4500,"Sub-basin 3"
797,2000,140,18900,20900,"Sub-basin 3"
798,700,17,9100,9800,"Sub-basin 3"
799,100,1,1600,1700,"Sub-basin 3"
800,400,12,5200,5600,"Sub-basin 3"
801,300,23,4900,5200,"Sub-basin 3"
802,3300,196,13800,17100,"Sub-basin 3"
803,100,3,500,600,"Sub-basin 3"
804,700,29,4000,4700,"Sub-basin 3"
805,400,7,3200,3600,"Sub-basin 3"
806,300,13,1500,1800,"Sub-basin 3"
807,1100,96,10400,11500,"Sub-basin 3"
808,300,17,3100,3400,"Sub-basin 3"
809,4900,223,50300,55200,"Sub-basin 3"
810,100,1,1600,1700,"Sub-basin 3"
811,7800,3492,9000,16800,"Sub-basin 3"
812,100,1,1100,1200,"Sub-basin 3"
813,1000,49,12500,13500,"Sub-basin 3"
814,600,29,5100,5700,"Sub-basin 3"
815,100,1,800,900,"Sub-basin 3"
816,100,1,1700,1800,"Sub-basin 3"
817,300,5,6100,6400,"Sub-basin 3"
818,5300,438,45800,51100,"Sub-basin 3"
819,53500,13675,45100,98600,"Sub-basin 3"
820,1000,97,3600,4600,"Sub-basin 3"
821,249000,87486.99,143300,392300,"Sub-basin 3"
822,800,18,4000,4800,"Sub-basin 3"
823,100,3,1200,1300,"Sub-basin 3"
824,1100,98,10300,11400,"Sub-basin 3"
825,400,16,3900,4300,"Sub-basin 3"
826,1100,94,4700,5800,"Sub-basin 3"
827,2600,169,7400,10000,"Sub-basin 3"
828,200,2,100,300,"Sub-basin 3"
829,500,12,3100,3600,"Sub-basin 3"
830,400,9,1300,1700,"Sub-basin 3"
831,200,5,1100,1300,"Sub-basin 3"
832,200,3,4200,4400,"Sub-basin 3"
833,100,3,1400,1500,"Sub-basin 3"
834,200,3,1600,1800,"Sub-basin 3"
835,100,5,1400,1500,"Sub-basin 3"
836,200,4,1900,2100,"Sub-basin 3"
837,100,3,100,200,"Sub-basin 3"
838,1200,120.82,7600,8800,"Sub-basin 3"
839,700,32,7600,8300,"Sub-basin 3"
840,8200,607,43100,51300,"Sub-basin 3"
841,100,1,600,700,"Sub-basin 3"
842,100,4,600,700,"Sub-basin 3"
843,1000,44,12400,13400,"Sub-basin 3"
844,3000,179,24700,27700,"Sub-basin 3"
845,200,4,1000,1200,"Sub-basin 3"
846,400,10,7600,8000,"Sub-basin 3"
847,100,3,900,1000,"Sub-basin 3"
848,600,17,4600,5200,"Sub-basin 3"
849,1900,75,6700,8600,"Sub-basin 3"
850,12000,817,51600,63600,"Sub-basin 3"
851,100,1,1600,1700,"Sub-basin 3"
852,200,5,3200,3400,"Sub-basin 3"
853,1900,140,14600,16500,"Sub-basin 3"
854,100,3,1800,1900,"Sub-basin 3"
855,100,1,200,300,"Sub-basin 3"
856,300,10,1300,1600,"Sub-basin 3"
857,700,16,1900,2600,"Sub-basin 3"
858,200,3,3300,3500,"Sub-basin 3"
859,100,2,1000,1100,"Sub-basin 3"
860,200,11,1300,1500,"Sub-basin 3"
861,100,2,400,500,"Sub-basin 3"
862,100,1,1900,2000,"Sub-basin 3"
863,100,2,600,700,"Sub-basin 3"
864,200,6,1600,1800,"Sub-basin 3"
865,400,7,1500,1900,"Sub-basin 3"
866,100,2,1400,1500,"Sub-basin 3"
867,100,2,1800,1900,"Sub-basin 3"
868,400,9,3500,3900,"Sub-basin 3"
869,400,9,4200,4600,"Sub-basin 3"
870,500,40,6200,6700,"Sub-basin 3"
871,100,2,5100,5200,"Sub-basin 3"
872,400,10,5700,6100,"Sub-basin 3"
873,200,7,2500,2700,"Sub-basin 3"
874,200,4,4700,4900,"Sub-basin 3"
875,100,1,1800,1900,"Sub-basin 3"
876,157000,47475.17,121300,278300,"Sub-basin 3"
877,200,3,1500,1700,"Sub-basin 3"
878,100,2,2100,2200,"Sub-basin 3"
879,100,7,2200,2300,"Sub-basin 3"
880,400,15,1600,2000,"Sub-basin 3"
881,16700,513,26300,43000,"Sub-basin 3"
882,200,4,1300,1500,"Sub-basin 3"
883,300,4,2200,2500,"Sub-basin 3"
884,500,33,5400,5900,"Sub-basin 3"
885,100,5,2100,2200,"Sub-basin 3"
886,100,1,1200,1300,"Sub-basin 3"
887,300,4,4600,4900,"Sub-basin 3"
888,100,1,1000,1100,"Sub-basin 3"
889,300,7,2900,3200,"Sub-basin 3"
890,100,4,1300,1400,"Sub-basin 3"
891,200,7,3300,3500,"Sub-basin 3"
892,200,7,900,1100,"Sub-basin 3"
893,200,18,2400,2600,"Sub-basin 3"
894,100,1,1400,1500,"Sub-basin 3"
895,600,24,8500,9100,"Sub-basin 3"
896,600,30,9100,9700,"Sub-basin 3"
897,300,5,1700,2000,"Sub-basin 3"
898,100,1,900,1000,"Sub-basin 3"
899,100,4,300,400,"Sub-basin 3"
900,200,3,2200,2400,"Sub-basin 3"
901,200,6,800,1000,"Sub-basin 3"
902,2300,196,17800,20100,"Sub-basin 3"
903,200,8,4100,4300,"Sub-basin 3"
904,300,8,2300,2600,"Sub-basin 3"
905,100,1,600,700,"Sub-basin 3"
906,100,1,1100,1200,"Sub-basin 3"
907,5600,745,26900,32500,"Sub-basin 3"
908,100,2,800,900,"Sub-basin 3"
909,200,7,4400,4600,"Sub-basin 3"
910,8100,412,41000,49100,"Sub-basin 3"
911,800,46,3900,4700,"Sub-basin 3"
912,5200,580,20900,26100,"Sub-basin 3"
913,100,1,1700,1800,"Sub-basin 3"
914,100,1,2600,2700,"Sub-basin 3"
915,47200,1543,75900,123100,"Sub-basin 3"
916,100,1,400,500,"Sub-basin 3"
917,700,32,3100,3800,"Sub-basin 3"
918,100,3,2100,2200,"Sub-basin 3"
919,3500,334,25400,28900,"Sub-basin 3"
920,100,2,2400,2500,"Sub-basin 3"
921,3900,448,7800,11700,"Sub-basin 3"
922,100,1,700,800,"Sub-basin 3"
923,200,5,1000,1200,"Sub-basin 3"
924,5300,388,42700,48000,"Sub-basin 3"
925,500,15,7200,7700,"Sub-basin 3"
926,100,1,3100,3200,"Sub-basin 3"
927,200,5,4800,5000,"Sub-basin 3"
928,1200,46,13300,14500,"Sub-basin 3"
929,100,1,700,800,"Sub-basin 3"
930,100,2,800,900,"Sub-basin 3"
931,34100,3107,58400,92500,"Sub-basin 3"
932,100,2,900,1000,"Sub-basin 3"
933,200,4,2100,2300,"Sub-basin 3"
934,100,2,600,700,"Sub-basin 3"
935,100,3,1000,1100,"Sub-basin 3"
936,200,7,600,800,"Sub-basin 3"
937,200,4,2600,2800,"Sub-basin 3"
938,300,4,5200,5500,"Sub-basin 3"
939,100,5,1400,1500,"Sub-basin 3"
940,600,21,3500,4100,"Sub-basin 3"
941,400,18,1200,1600,"Sub-basin 3"
942,6600,637,27900,34500,"Sub-basin 3"
943,700,57,4000,4700,"Sub-basin 3"
944,400,20,5600,6000,"Sub-basin 3"
945,200,5,1200,1400,"Sub-basin 3"
946,200,7,1900,2100,"Sub-basin 3"
947,8700,246,20000,28700,"Sub-basin 3"
948,200,2,6800,7000,"Sub-basin 3"
949,300,4,5800,6100,"Sub-basin 3"
950,6300,1090,9100,15400,"Sub-basin 3"
951,1200,32,5200,6400,"Sub-basin 3"
952,1000,61,7800,8800,"Sub-basin 3"
953,600,49,6700,7300,"Sub-basin 3"
954,3400,215,17700,21100,"Sub-basin 3"
955,500,17,4000,4500,"Sub-basin 3"
956,700,104,2800,3500,"Sub-basin 3"
957,1900,260,7800,9700,"Sub-basin 3"
958,26200,5244.34,53700,79900,"Sub-basin 3"
959,200,2,3100,3300,"Sub-basin 3"
960,300,5,4600,4900,"Sub-basin 3"
961,200,4,6400,6600,"Sub-basin 3"
962,1200,47,6200,7400,"Sub-basin 3"
963,100,3,400,500,"Sub-basin 3"
964,100,1,900,1000,"Sub-basin 3"
965,5400,437,13900,19300,"Sub-basin 3"
966,1800,68,17000,18800,"Sub-basin 3"
967,5000,630,13300,18300,"Sub-basin 3"
968,4200,461,11500,15700,"Sub-basin 3"
969,200,2,3700,3900,"Sub-basin 3"
970,600,17.04,9300,9900,"Sub-basin 3"
971,400,21,6100,6500,"Sub-basin 3"
972,300,9,2400,2700,"Sub-basin 3"
973,100,6,300,400,"Sub-basin 3"
974,600,35,4300,4900,"Sub-basin 3"
975,100,2,2400,2500,"Sub-basin 3"
976,400,8,6400,6800,"Sub-basin 3"
977,300,11,6500,6800,"Sub-basin 3"
978,100,3,1200,1300,"Sub-basin 3"
979,4100,287,15600,19700,"Sub-basin 3"
980,800,30,9300,10100,"Sub-basin 3"
981,3100,366,11400,14500,"Sub-basin 3"
982,200,3,2200,2400,"Sub-basin 3"
983,100,1,1500,1600,"Sub-basin 3"
984,1200,298,2400,3600,"Sub-basin 3"
985,1500,170,5800,7300,"Sub-basin 3"
986,2200,97,9800,12000,"Sub-basin 3"
987,100,2,2000,2100,"Sub-basin 3"
988,800,94,9600,10400,"Sub-basin 3"
989,400,11,1400,1800,"Sub-basin 3"
990,1000,38,4700,5700,"Sub-basin 3"
991,200,9,700,900,"Sub-basin 3"
992,100,1,2900,3000,"Sub-basin 3"
993,600,14,9100,9700,"Sub-basin 3"
994,500,38,8700,9200,"Sub-basin 3"
995,200,4,3300,3500,"Sub-basin 3"
996,100,7,400,500,"Sub-basin 3"
997,300,9,700,1000,"Sub-basin 3"
998,300,15,10100,10400,"Sub-basin 3"
999,100,6,2500,2600,"Sub-basin 3"
1000,100,8,1900,2000,"Sub-basin 3"
1001,200,4,2700,2900,"Sub-basin 3"
1002,300,6,1700,2000,"Sub-basin 3"
1003,200,7,3500,3700,"Sub-basin 3"
1004,200,2,2400,2600,"Sub-basin 3"
1005,100,2,4400,4500,"Sub-basin 3"
1006,400,28,1300,1700,"Sub-basin 3"
1007,100,1,800,900,"Sub-basin 3"
1008,600,69,3400,4000,"Sub-basin 3"
1009,200,5,2300,2500,"Sub-basin 3"
1010,6600,1355,16700,23300,"Sub-basin 3"
1011,100,4,1500,1600,"Sub-basin 3"
1012,500,29,5800,6300,"Sub-basin 3"
1013,200,2,2200,2400,"Sub-basin 3"
1014,53800,14232,75900,129700,"Sub-basin 3"
1015,200,5,2000,2200,"Sub-basin 3"
1016,600,26,3400,4000,"Sub-basin 3"
1017,100,3,1000,1100,"Sub-basin 3"
1018,900,26,6400,7300,"Sub-basin 3"
1019,100,6,600,700,"Sub-basin 3"
1020,100,2,600,700,"Sub-basin 3"
1021,600,31,9300,9900,"Sub-basin 3"
1022,300,20,3300,3600,"Sub-basin 3"
1023,100,3,2500,2600,"Sub-basin 3"
1024,1100,279,5700,6800,"Sub-basin 3"
1025,2100,322,4000,6100,"Sub-basin 3"
1026,400,9,2000,2400,"Sub-basin 3"
1027,2100,56,10700,12800,"Sub-basin 3"
1028,100,3,1400,1500,"Sub-basin 3"
1029,100,1,800,900,"Sub-basin 3"
1030,900,22,6600,7500,"Sub-basin 3"
1031,100,3,900,1000,"Sub-basin 3"
1032,400,6,3700,4100,"Sub-basin 3"
1033,9400,400,50600,60000,"Sub-basin 3"
1034,149700,48043.84,126400,276100,"Sub-basin 3"
1035,2800,224,7800,10600,"Sub-basin 3"
1036,2600,244,6900,9500,"Sub-basin 3"
1037,500,10,2500,3000,"Sub-basin 3"
1038,100,1,1000,1100,"Sub-basin 3"
1039,300,21,500,800,"Sub-basin 3"
1040,500,14,1800,2300,"Sub-basin 3"
1041,12400,1320,64300,76700,"Sub-basin 3"
1042,100,6,1300,1400,"Sub-basin 3"
1043,5200,331,18900,24100,"Sub-basin 3"
1044,100,1,700,800,"Sub-basin 3"
1045,200,3,700,900,"Sub-basin 3"
1046,12000,366,20600,32600,"Sub-basin 3"
1047,200,5,3300,3500,"Sub-basin 3"
1048,100,10,1200,1300,"Sub-basin 3"
1049,600,29,2300,2900,"Sub-basin 3"
1050,100,3,1100,1200,"Sub-basin 3"
1051,600,35,6600,7200,"Sub-basin 3"
1052,100,3,2100,2200,"Sub-basin 3"
1053,100,1,400,500,"Sub-basin 3"
1054,100,1,500,600,"Sub-basin 3"
1055,400,8,2900,3300,"Sub-basin 3"
1056,1800,216,6500,8300,"Sub-basin 3"
1057,500,12,6800,7300,"Sub-basin 3"
1058,900,48,5600,6500,"Sub-basin 3"
1059,334100,71594.51,273300,607400,"Sub-basin 3"
1060,200,7,1200,1400,"Sub-basin 3"
1061,500,10,1700,2200,"Sub-basin 3"
1062,3200,93,19200,22400,"Sub-basin 3"
1063,200,6,2500,2700,"Sub-basin 3"
1064,300,15,3300,3600,"Sub-basin 3"
1065,100,1,1600,1700,"Sub-basin 3"
1066,600,36,7700,8300,"Sub-basin 3"
1067,500,63,5300,5800,"Sub-basin 3"
1068,17200,1971,70700,87900,"Sub-basin 3"
1069,100,2,500,600,"Sub-basin 3"
1070,100,2,1500,1600,"Sub-basin 3"
1071,100,5,1600,1700,"Sub-basin 3"
1072,500,48,7700,8200,"Sub-basin 3"
1073,700,26,6300,7000,"Sub-basin 3"
1074,500,12,10300,10800,"Sub-basin 3"
1075,200,7,2300,2500,"Sub-basin 3"
1076,200,7,3300,3500,"Sub-basin 3"
1077,3100,176,9300,12400,"Sub-basin 3"
1078,100,1,700,800,"Sub-basin 3"
1079,100,2,800,900,"Sub-basin 3"
1080,100,5,600,700,"Sub-basin 3"
1081,3900,91,21300,25200,"Sub-basin 3"
1082,400,15,7200,7600,"Sub-basin 3"
1083,700,38,13600,14300,"Sub-basin 3"
1084,100,1,2400,2500,"Sub-basin 3"
1085,100,2,1800,1900,"Sub-basin 3"
1086,2300,89,15500,17800,"Sub-basin 3"
1087,200,6,200,400,"Sub-basin 3"
1088,400,6,1100,1500,"Sub-basin 3"
1089,2300,89,8700,11000,"Sub-basin 3"
1090,200,16,3600,3800,"Sub-basin 3"
1091,100,1,300,400,"Sub-basin 3"
1092,200,4,2700,2900,"Sub-basin 3"
1093,1100,119,7800,8900,"Sub-basin 3"
1094,200,5,2500,2700,"Sub-basin 3"
1095,100,1,1800,1900,"Sub-basin 3"
1096,100,1,1400,1500,"Sub-basin 3"
1097,300,7,1600,1900,"Sub-basin 3"
1098,100,2,700,800,"Sub-basin 3"
1099,6200,2458,12800,19000,"Sub-basin 3"
1100,100,2,400,500,"Sub-basin 3"
1101,200,14,4500,4700,"Sub-basin 3"
1102,100,2,1800,1900,"Sub-basin 3"
1103,200,3,2600,2800,"Sub-basin 3"
1104,200,9,2200,2400,"Sub-basin 3"
1105,200,3,1300,1500,"Sub-basin 3"
1106,1100,64,7400,8500,"Sub-basin 3"
1107,100,2,1800,1900,"Sub-basin 3"
1108,400,17,1600,2000,"Sub-basin 3"
1109,400,14,4500,4900,"Sub-basin 3"
1110,1000,63,1600,2600,"Sub-basin 3"
1111,3800,222,13100,16900,"Sub-basin 3"
1112,700,20,2500,3200,"Sub-basin 3"
1113,100,2,1000,1100,"Sub-basin 3"
1114,400,38,3600,4000,"Sub-basin 3"
1115,2800,165,29200,32000,"Sub-basin 3"
1116,100,1,1300,1400,"Sub-basin 3"
1117,100,2,300,400,"Sub-basin 3"
1118,100,2,1000,1100,"Sub-basin 3"
1119,200,2,1100,1300,"Sub-basin 3"
1120,200,3,3500,3700,"Sub-basin 3"
1121,100,1,1100,1200,"Sub-basin 3"
1122,200,5,1900,2100,"Sub-basin 3"
1123,200,19,1400,1600,"Sub-basin 3"
1124,300,7,2000,2300,"Sub-basin 3"
1125,300,9,4400,4700,"Sub-basin 3"
1126,100,2,1200,1300,"Sub-basin 3"
1127,1000,90,3800,4800,"Sub-basin 3"
1128,300,30,1700,2000,"Sub-basin 3"
1129,600,25.5,5900,6500,"Sub-basin 3"
1130,14900,2516,35100,50000,"Sub-basin 3"
1131,200,6,3300,3500,"Sub-basin 3"
1132,2300,133,11600,13900,"Sub-basin 3"
1133,400,9,800,1200,"Sub-basin 3"
1134,100,1,300,400,"Sub-basin 3"
1135,100,4,400,500,"Sub-basin 3"
1136,300,8,800,1100,"Sub-basin 3"
1137,200,5,1200,1400,"Sub-basin 3"
1138,100,1,1300,1400,"Sub-basin 3"
1139,2400,157,33100,35500,"Sub-basin 3"
1140,300,12,3900,4200,"Sub-basin 3"
1141,400,39,2800,3200,"Sub-basin 3"
1142,4500,482,10000,14500,"Sub-basin 3"
1143,6500,661,15000,21500,"Sub-basin 3"
1144,700,112,5600,6300,"Sub-basin 3"
1145,300,10,1400,1700,"Sub-basin 3"
1146,400,7,2500,2900,"Sub-basin 3"
1147,100,1,700,800,"Sub-basin 3"
1148,100,1,2700,2800,"Sub-basin 3"
1149,100,1,1900,2000,"Sub-basin 3"
1150,400,16,3800,4200,"Sub-basin 3"
1151,100,1,1600,1700,"Sub-basin 3"
1152,700,49,7300,8000,"Sub-basin 3"
1153,100,1,800,900,"Sub-basin 3"
1154,1000,70,5100,6100,"Sub-basin 3"
1155,2400,72,9300,11700,"Sub-basin 3"
1156,2000,152,5500,7500,"Sub-basin 3"
1157,100,2,1400,1500,"Sub-basin 3"
1158,100,3,1700,1800,"Sub-basin 3"
1159,100,2,1600,1700,"Sub-basin 3"
1160,1600,975,6400,8000,"Sub-basin 3"
1161,400,4,3800,4200,"Sub-basin 3"
1162,100,2,1100,1200,"Sub-basin 3"
1163,1100,74,13100,14200,"Sub-basin 3"
1164,200,7,1400,1600,"Sub-basin 3"
1165,100,1,4000,4100,"Sub-basin 3"
1166,100,2,1900,2000,"Sub-basin 3"
1167,100,3,1900,2000,"Sub-basin 3"
1168,3700,159,38100,41800,"Sub-basin 3"
1169,3000,230,29700,32700,"Sub-basin 3"
1170,100,1,800,900,"Sub-basin 3"
1171,400,7,4400,4800,"Sub-basin 3"
1172,100,5,1000,1100,"Sub-basin 3"
1173,6300,469,13600,19900,"Sub-basin 3"
1174,400,8,700,1100,"Sub-basin 3"
1175,100,4,2700,2800,"Sub-basin 3"
1176,100,1,1300,1400,"Sub-basin 3"
1177,1500,98,18300,19800,"Sub-basin 3"
1178,100,1,2400,2500,"Sub-basin 3"
1179,100,2,1200,1300,"Sub-basin 3"
1180,100,2,800,900,"Sub-basin 3"
1181,200,7,3100,3300,"Sub-basin 3"
1182,100,2,2100,2200,"Sub-basin 3"
1183,400,45,8000,8400,"Sub-basin 3"
1184,200,7,3500,3700,"Sub-basin 3"
1185,1200,121,3500,4700,"Sub-basin 3"
1186,200,5,2900,3100,"Sub-basin 3"
1187,100,2,800,900,"Sub-basin 3"
1188,500,34,2300,2800,"Sub-basin 3"
1189,3200,286,10500,13700,"Sub-basin 3"
1190,1100,105,9800,10900,"Sub-basin 3"
1191,1400,43,15800,17200,"Sub-basin 3"
1192,100,23,2000,2100,"Sub-basin 3"
1193,100,8,4500,4600,"Sub-basin 3"
1194,100,1,300,400,"Sub-basin 3"
1195,300,6,4100,4400,"Sub-basin 3"
1196,100,1,2100,2200,"Sub-basin 3"
1197,100,1,1400,1500,"Sub-basin 3"
1198,2700,204,8100,10800,"Sub-basin 3"
1199,100,1,1900,2000,"Sub-basin 3"
1200,200,13,3400,3600,"Sub-basin 3"
1201,200,9,1600,1800,"Sub-basin 3"
1202,600,113,2300,2900,"Sub-basin 3"
1203,300,13,900,1200,"Sub-basin 3"
1204,1000,216,9400,10400,"Sub-basin 3"
1205,100,4,800,900,"Sub-basin 3"
1206,300,33,2400,2700,"Sub-basin 3"
1207,600,32,7700,8300,"Sub-basin 3"
1208,300,4,3100,3400,"Sub-basin 3"
1209,1200,150.84,12200,13400,"Sub-basin 3"
1210,500,57,5700,6200,"Sub-basin 3"
1211,3800,308,40600,44400,"Sub-basin 3"
1212,200,3,600,800,"Sub-basin 3"
1213,600,36,4600,5200,"Sub-basin 3"
1214,400,17,3500,3900,"Sub-basin 3"
1215,2000,49,18800,20800,"Sub-basin 3"
1216,4000,246,37400,41400,"Sub-basin 3"
1217,200,6,2700,2900,"Sub-basin 3"
1218,5700,906,7400,13100,"Sub-basin 3"
1219,100,1,500,600,"Sub-basin 3"
1220,100,1,3900,4000,"Sub-basin 3"
1221,100,1,1600,1700,"Sub-basin 3"
1222,300,5,5900,6200,"Sub-basin 3"
1223,100,4,900,1000,"Sub-basin 3"
1224,400,27,4000,4400,"Sub-basin 3"
1225,100,2,1000,1100,"Sub-basin 3"
1226,100,2,2600,2700,"Sub-basin 3"
1227,1900,34,12500,14400,"Sub-basin 3"
1228,1500,97,5800,7300,"Sub-basin 3"
1229,400,23,2400,2800,"Sub-basin 3"
1230,300,15,3600,3900,"Sub-basin 3"
1231,1100,52,5900,7000,"Sub-basin 3"
1232,100,2,2100,2200,"Sub-basin 3"
1233,100,3,3600,3700,"Sub-basin 3"
1234,100,4,1000,1100,"Sub-basin 3"
1235,100,2,3200,3300,"Sub-basin 3"
1236,500,11,12800,13300,"Sub-basin 3"
1237,300,3,8000,8300,"Sub-basin 3"
1238,500,10,4600,5100,"Sub-basin 3"
1239,100,1,1500,1600,"Sub-basin 3"
1240,200,2,4400,4600,"Sub-basin 3"
1241,200,4,1000,1200,"Sub-basin 3"
1242,200,3,2100,2300,"Sub-basin 3"
1243,200,3,7100,7300,"Sub-basin 3"
1244,800,22,8700,9500,"Sub-basin 3"
1245,6300,1005,10000,16300,"Sub-basin 3"
1246,1300,182,2100,3400,"Sub-basin 3"
1247,200,3,600,800,"Sub-basin 3"
1248,281400,45965.84,314000,595400,"Sub-basin 3"
1249,13000,6013,31700,44700,"Sub-basin 3"
1250,600,62,4300,4900,"Sub-basin 3"
1251,5100,231,52200,57300,"Sub-basin 3"
1252,500,12,6400,6900,"Sub-basin 3"
1253,700,21,11700,12400,"Sub-basin 3"
1254,300,4,2900,3200,"Sub-basin 3"
1255,1300,174,13400,14700,"Sub-basin 3"
1256,100,2,5200,5300,"Sub-basin 3"
1257,100,1,1100,1200,"Sub-basin 3"
1258,6700,1027,29200,35900,"Sub-basin 3"
1259,100,5,500,600,"Sub-basin 3"
1260,200,8,1800,2000,"Sub-basin 3"
1261,300,12,2700,3000,"Sub-basin 3"
1262,100,1,600,700,"Sub-basin 3"
1263,300,16,400,700,"Sub-basin 3"
1264,100,1,1300,1400,"Sub-basin 3"
1265,100,1,400,500,"Sub-basin 3"
1266,100,1,3400,3500,"Sub-basin 3"
1267,200,2,2800,3000,"Sub-basin 3"
1268,100,5,1500,1600,"Sub-basin 3"
1269,200,3,5900,6100,"Sub-basin 3"
1270,100,1,1800,1900,"Sub-basin 3"
1271,1100,86,3900,5000,"Sub-basin 3"
1272,100,5,700,800,"Sub-basin 3"
1273,1000,109,4800,5800,"Sub-basin 3"
1274,800,70,5500,6300,"Sub-basin 3"
1275,100,4,2400,2500,"Sub-basin 3"
1276,200,2,1100,1300,"Sub-basin 3"
1277,5200,393,25700,30900,"Sub-basin 3"
1278,200,2,4300,4500,"Sub-basin 3"
1279,400,14,5800,6200,"Sub-basin 3"
1280,24400,4901,45500,69900,"Sub-basin 3"
1281,100,1,3800,3900,"Sub-basin 3"
1282,100,2,1700,1800,"Sub-basin 3"
1283,2500,243,21800,24300,"Sub-basin 3"
1284,200,4,2900,3100,"Sub-basin 3"
1285,100,1,2000,2100,"Sub-basin 3"
1286,100,2,1800,1900,"Sub-basin 3"
1287,700,46,7600,8300,"Sub-basin 3"
1288,23200,6440,29000,52200,"Sub-basin 3"
1289,300,11,1800,2100,"Sub-basin 3"
1290,400,17,6900,7300,"Sub-basin 3"
1291,100,1,700,800,"Sub-basin 3"
1292,600,32,2600,3200,"Sub-basin 3"
1293,600,108,3000,3600,"Sub-basin 3"
1294,100,1,700,800,"Sub-basin 3"
1295,5200,980.66,6700,11900,"Sub-basin 3"
1296,400,17,5900,6300,"Sub-basin 3"
1297,100,2,1800,1900,"Sub-basin 3"
1298,600,10,20900,21500,"Sub-basin 3"
1299,200,5,3000,3200,"Sub-basin 3"
1300,600,10,11600,12200,"Sub-basin 3"
1301,100,1,2800,2900,"Sub-basin 3"
1302,1000,16,16200,17200,"Sub-basin 3"
1303,100,1,600,700,"Sub-basin 3"
1304,500,48,3200,3700,"Sub-basin 3"
1305,19700,7277,17400,37100,"Sub-basin 3"
1306,800,46,10200,11000,"Sub-basin 3"
1307,4900,575,27500,32400,"Sub-basin 3"
1308,100,1,1800,1900,"Sub-basin 3"
1309,800,21,18600,19400,"Sub-basin 3"
1310,100,4,2600,2700,"Sub-basin 3"
1311,100,3,2400,2500,"Sub-basin 3"
1312,200,2,4600,4800,"Sub-basin 3"
1313,100,1,2800,2900,"Sub-basin 3"
1314,200,2,4000,4200,"Sub-basin 3"
1315,100,1,1600,1700,"Sub-basin 3"
1316,100,1,1000,1100,"Sub-basin 3"
1317,1100,40,6600,7700,"Sub-basin 3"
1318,300,8,4200,4500,"Sub-basin 3"
1319,4100,231,17700,21800,"Sub-basin 3"
1320,300,5,3800,4100,"Sub-basin 3"
1321,400,10,8100,8500,"Sub-basin 3"
1322,300,7,4400,4700,"Sub-basin 3"
1323,400,7,5800,6200,"Sub-basin 3"
1324,100,3,4200,4300,"Sub-basin 3"
1325,700,22,6700,7400,"Sub-basin 3"
1326,100,2,500,600,"Sub-basin 3"
1327,2700,413,7000,9700,"Sub-basin 3"
1328,5100,1012,10600,15700,"Sub-basin 3"
1329,500,36,2700,3200,"Sub-basin 3"
1330,200,6,2500,2700,"Sub-basin 3"
1331,300,5,3900,4200,"Sub-basin 3"
1332,100,1,1100,1200,"Sub-basin 3"
1333,100,1,3000,3100,"Sub-basin 3"
1334,700,128,14200,14900,"Sub-basin 3"
1335,1500,167,11200,12700,"Sub-basin 3"
1336,400,21,4000,4400,"Sub-basin 3"
1337,100,1,2400,2500,"Sub-basin 3"
1338,2900,311,20100,23000,"Sub-basin 3"
1339,700,22,3900,4600,"Sub-basin 3"
1340,1200,27,8200,9400,"Sub-basin 3"
1341,500,37,3500,4000,"Sub-basin 3"
1342,300,4,1500,1800,"Sub-basin 3"
1343,2500,227,6100,8600,"Sub-basin 3"
1344,700,117,3500,4200,"Sub-basin 3"
1345,100,1,1900,2000,"Sub-basin 3"
1346,1300,848,7800,9100,"Sub-basin 3"
1347,100,1,1000,1100,"Sub-basin 3"
1348,100,1,2900,3000,"Sub-basin 3"
1349,100,1,2400,2500,"Sub-basin 3"
1350,700,71,5500,6200,"Sub-basin 3"
1351,5700,879,28900,34600,"Sub-basin 3"
1352,100,1,4500,4600,"Sub-basin 3"
1353,100,3,1300,1400,"Sub-basin 3"
1354,100,13,1200,1300,"Sub-basin 3"
1355,200,4,1900,2100,"Sub-basin 3"
1356,600,33,2900,3500,"Sub-basin 3"
1357,100,2,1400,1500,"Sub-basin 3"
1358,100,3,3100,3200,"Sub-basin 3"
1359,100,1,1700,1800,"Sub-basin 3"
1360,100,1,1600,1700,"Sub-basin 3"
1361,100,4,1400,1500,"Sub-basin 3"
1362,900,49,3600,4500,"Sub-basin 3"
1363,400,18,500,900,"Sub-basin 3"
1364,4700,492.5,23200,27900,"Sub-basin 3"
1365,79800,13019.67,340900,420700,"Sub-basin 3"
1366,100,2,1900,2000,"Sub-basin 3"
1367,4900,462,21700,26600,"Sub-basin 3"
1368,2900,317,10000,12900,"Sub-basin 3"
1369,100,2,300,400,"Sub-basin 3"
1370,100,3,500,600,"Sub-basin 3"
1371,600,49,3700,4300,"Sub-basin 3"
1372,100,2,900,1000,"Sub-basin 3"
1373,100,3,1700,1800,"Sub-basin 3"
1374,100,6,1100,1200,"Sub-basin 3"
1375,19000,858.17,87000,106000,"Sub-basin 3"
1376,400,30,2500,2900,"Sub-basin 3"
1377,200,2,4600,4800,"Sub-basin 3"
1378,200,2,7300,7500,"Sub-basin 3"
1379,200,4,5400,5600,"Sub-basin 3"
1380,300,5,3800,4100,"Sub-basin 3"
1381,400,10,4600,5000,"Sub-basin 3"
1382,300,11,1700,2000,"Sub-basin 3"
1383,100,1,600,700,"Sub-basin 3"
1384,100,1,1300,1400,"Sub-basin 3"
1385,100,5,2500,2600,"Sub-basin 3"
1386,200,7,3800,4000,"Sub-basin 3"
1387,3200,359,25700,28900,"Sub-basin 3"
1388,100,2,1000,1100,"Sub-basin 3"
1389,300,5,4800,5100,"Sub-basin 3"
1390,100,1,2400,2500,"Sub-basin 3"
1391,100,1,2600,2700,"Sub-basin 3"
1392,100,1,1300,1400,"Sub-basin 3"
1393,1000,245,4200,5200,"Sub-basin 3"
1394,1100,111,2900,4000,"Sub-basin 3"
1395,100,1,500,600,"Sub-basin 3"
1396,700,86,2900,3600,"Sub-basin 3"
1397,2700,771,7300,10000,"Sub-basin 3"
1398,100,1,1900,2000,"Sub-basin 3"
1399,300,4,3800,4100,"Sub-basin 3"
1400,300,13,5000,5300,"Sub-basin 3"
1401,2100,47,33300,35400,"Sub-basin 3"
1402,1800,227,13800,15600,"Sub-basin 3"
1403,1200,56,10900,12100,"Sub-basin 3"
1404,500,19,4000,4500,"Sub-basin 3"
1405,200,2,2000,2200,"Sub-basin 3"
1406,100,1,1500,1600,"Sub-basin 3"
1407,300,6,7300,7600,"Sub-basin 3"
1408,100,2,1700,1800,"Sub-basin 3"
1409,900,81,8000,8900,"Sub-basin 3"
1410,100,1,500,600,"Sub-basin 3"
1411,300,6,5700,6000,"Sub-basin 3"
1412,100,3,3900,4000,"Sub-basin 3"
1413,200,3,3700,3900,"Sub-basin 3"
1414,4000,263,33600,37600,"Sub-basin 3"
1415,100,1,2000,2100,"Sub-basin 3"
1416,100,2,900,1000,"Sub-basin 3"
1417,100,2,1500,1600,"Sub-basin 3"
1418,100,2,1300,1400,"Sub-basin 3"
1419,600,39,7300,7900,"Sub-basin 3"
1420,100,2,800,900,"Sub-basin 3"
1421,200,4,2900,3100,"Sub-basin 3"
1422,700,43,3400,4100,"Sub-basin 3"
1423,2400,355.33,10500,12900,"Sub-basin 3"
1424,100,1,3400,3500,"Sub-basin 3"
1425,300,4,5000,5300,"Sub-basin 3"
1426,1500,57,11200,12700,"Sub-basin 3"
1427,100,1,600,700,"Sub-basin 3"
1428,100,1,900,1000,"Sub-basin 3"
1429,100,2,1300,1400,"Sub-basin 3"
1430,1300,111,7300,8600,"Sub-basin 3"
1431,100,1,500,600,"Sub-basin 3"
1432,1000,35,11200,12200,"Sub-basin 3"
1433,100,1,900,1000,"Sub-basin 3"
1434,500,60,5100,5600,"Sub-basin 3"
1435,500,29,4000,4500,"Sub-basin 3"
1436,100,3,2400,2500,"Sub-basin 3"
1437,600,6,13200,13800,"Sub-basin 3"
1438,200,5,5400,5600,"Sub-basin 3"
1439,800,18,10100,10900,"Sub-basin 3"
1440,200,17,2800,3000,"Sub-basin 3"
1441,4400,1065,9200,13600,"Sub-basin 3"
1442,100,1,700,800,"Sub-basin 3"
1443,100,2,600,700,"Sub-basin 3"
1444,300,10,2900,3200,"Sub-basin 3"
1445,100,2,900,1000,"Sub-basin 3"
1446,100,1,1000,1100,"Sub-basin 3"
1447,500,20,4600,5100,"Sub-basin 3"
1448,100,1,700,800,"Sub-basin 3"
1449,400,17,8500,8900,"Sub-basin 3"
1450,1800,94,34500,36300,"Sub-basin 3"
1451,100,1,2100,2200,"Sub-basin 3"
1452,100,1,1800,1900,"Sub-basin 3"
1453,100,4,2900,3000,"Sub-basin 3"
1454,500,26,3400,3900,"Sub-basin 3"
1455,1400,246,5300,6700,"Sub-basin 3"
1456,100,1,600,700,"Sub-basin 3"
1457,900,82,3600,4500,"Sub-basin 3"
1458,200,5,1700,1900,"Sub-basin 3"
1459,500,59,3900,4400,"Sub-basin 3"
1460,100,3,1100,1200,"Sub-basin 3"
1461,100,2,100,200,"Sub-basin 3"
1462,100,1,200,300,"Sub-basin 3"
1463,38500,8988,71000,109500,"Sub-basin 3"
1464,200,6,3200,3400,"Sub-basin 3"
1465,200,2,1900,2100,"Sub-basin 3"
1466,100,2,1400,1500,"Sub-basin 3"
1467,100,3,1300,1400,"Sub-basin 3"
1468,2000,79,18200,20200,"Sub-basin 3"
1469,700,13,14500,15200,"Sub-basin 3"
1470,6100,236,18600,24700,"Sub-basin 3"
1471,100,3,1700,1800,"Sub-basin 3"
1472,9100,1373.33,13400,22500,"Sub-basin 3"
1473,500,47,5600,6100,"Sub-basin 3"
1474,200,3,2200,2400,"Sub-basin 3"
1475,1100,43,14900,16000,"Sub-basin 3"
1476,1000,45,8400,9400,"Sub-basin 3"
1477,200,4,1500,1700,"Sub-basin 3"
1478,100,2,1200,1300,"Sub-basin 3"
1479,100,2,1300,1400,"Sub-basin 3"
1480,4000,164,26800,30800,"Sub-basin 3"
1481,2500,54,35200,37700,"Sub-basin 3"
1482,100,2,3300,3400,"Sub-basin 3"
1483,600,23,8800,9400,"Sub-basin 3"
1484,700,103,2500,3200,"Sub-basin 3"
1485,900,203,4500,5400,"Sub-basin 3"
1486,100,4,2000,2100,"Sub-basin 3"
1487,100,3,1800,1900,"Sub-basin 3"
1488,600,44,2000,2600,"Sub-basin 3"
1489,100,1,600,700,"Sub-basin 3"
1490,300,16,3800,4100,"Sub-basin 3"
1491,300,21,3100,3400,"Sub-basin 3"
1492,100,1,2200,2300,"Sub-basin 3"
1493,700,99,3500,4200,"Sub-basin 3"
1494,2400,89,2700,5100,"Sub-basin 3"
1495,1300,26.16,10400,11700,"Sub-basin 3"
1496,200,6,2700,2900,"Sub-basin 3"
1497,100,2,5100,5200,"Sub-basin 3"
1498,100,1,2200,2300,"Sub-basin 3"
1499,200,8,3800,4000,"Sub-basin 3"
1500,900,70,5300,6200,"Sub-basin 3"
1501,25500,1515,42500,68000,"Sub-basin 3"
1502,100,1,1300,1400,"Sub-basin 3"
1503,200,2,3200,3400,"Sub-basin 3"
1504,300,18,5600,5900,"Sub-basin 3"
1505,2000,132,23400,25400,"Sub-basin 3"
1506,300,18,6600,6900,"Sub-basin 3"
1507,500,68.67,4200,4700,"Sub-basin 3"
1508,3200,1456.5,1800,5000,"Sub-basin 3"
1509,1900,58,14700,16600,"Sub-basin 3"
1510,128200,7349.97,353500,481700,"Sub-basin 3"
1511,600,52,4800,5400,"Sub-basin 3"
1512,200,2,1900,2100,"Sub-basin 3"
1513,300,9,1300,1600,"Sub-basin 3"
1514,1000,106,11100,12100,"Sub-basin 3"
1515,200,2,1900,2100,"Sub-basin 3"
1516,300,10,7600,7900,"Sub-basin 3"
1517,1300,29,35000,36300,"Sub-basin 3"
1518,100,2,3200,3300,"Sub-basin 3"
1519,100,1,900,1000,"Sub-basin 3"
1520,6800,2343,7500,14300,"Sub-basin 3"
1521,14700,774,31900,46600,"Sub-basin 3"
1522,4000,513,12400,16400,"Sub-basin 3"
1523,10300,1206,17900,28200,"Sub-basin 3"
1524,200,4,7700,7900,"Sub-basin 3"
1525,9100,558,31600,40700,"Sub-basin 3"
1526,400,30,3400,3800,"Sub-basin 3"
1527,4300,642,9400,13700,"Sub-basin 3"
1528,11100,455,32600,43700,"Sub-basin 3"
1529,31400,18704.1714,20900,52700,"Sub-basin 3"
1530,800,114,6500,7300,"Sub-basin 3"
1531,500,22,2800,3300,"Sub-basin 3"
1532,300,9,3500,3800,"Sub-basin 3"
1533,200,4,1800,2000,"Sub-basin 3"
1534,800,58,5000,5800,"Sub-basin 3"
1535,200,2,2300,2500,"Sub-basin 3"
1536,200,2,5300,5500,"Sub-basin 3"
1537,300,5,4000,4300,"Sub-basin 3"
1538,300,18,1800,2100,"Sub-basin 3"
1539,400,17,2900,3300,"Sub-basin 3"
1540,200,7,1800,2000,"Sub-basin 3"
1541,100,8,1000,1100,"Sub-basin 3"
1542,300,19,2500,2800,"Sub-basin 3"
1543,600,43,2700,3300,"Sub-basin 3"
1544,4900,1343,5700,10600,"Sub-basin 3"
1545,6500,2425,10700,17200,"Sub-basin 3"
1546,7800,2288,15200,23000,"Sub-basin 3"
1547,300,12,4100,4400,"Sub-basin 3"
1548,2800,93,28600,31400,"Sub-basin 3"
1549,200,2,2800,3000,"Sub-basin 3"
1550,200,4,3700,3900,"Sub-basin 3"
1551,100,2,2900,3000,"Sub-basin 3"
1552,300,4,5100,5400,"Sub-basin 3"
1553,100,3,2400,2500,"Sub-basin 3"
1554,1600,43,10000,11600,"Sub-basin 3"
1555,5900,310,12500,18400,"Sub-basin 3"
1556,100,1,1200,1300,"Sub-basin 3"
1557,300,10,3600,3900,"Sub-basin 3"
1558,1300,55,14200,15500,"Sub-basin 3"
1559,100,1,2400,2500,"Sub-basin 3"
1560,400,15,7500,7900,"Sub-basin 3"
1561,600,27,4300,4900,"Sub-basin 3"
1562,100,1,1500,1600,"Sub-basin 3"
1563,1200,145,2700,3900,"Sub-basin 3"
1564,100,1,1800,1900,"Sub-basin 3"
1565,100,6,1300,1400,"Sub-basin 3"
1566,900,77,3800,4700,"Sub-basin 3"
1567,1000,93,5800,6800,"Sub-basin 3"
1568,500,54,3900,4400,"Sub-basin 3"
1569,400,27,1100,1500,"Sub-basin 3"
1570,3300,224.01,16600,19900,"Sub-basin 3"
1571,400,12,10900,11300,"Sub-basin 3"
1572,100,3,500,600,"Sub-basin 3"
1573,1700,50,11500,13200,"Sub-basin 3"
1574,100,1,1100,1200,"Sub-basin 3"
1575,1100,145,4200,5300,"Sub-basin 3"
1576,500,46,1900,2400,"Sub-basin 3"
1577,4200,245,39700,43900,"Sub-basin 3"
1578,400,29,800,1200,"Sub-basin 3"
1579,100,1,2900,3000,"Sub-basin 3"
1580,500,12,4800,5300,"Sub-basin 3"
1581,100,2,3300,3400,"Sub-basin 3"
1582,300,12,3600,3900,"Sub-basin 3"
1583,200,13,1400,1600,"Sub-basin 3"
1584,600,51,3700,4300,"Sub-basin 3"
1585,400,69,2800,3200,"Sub-basin 3"
1586,500,36,1100,1600,"Sub-basin 3"
1587,3100,326,15000,18100,"Sub-basin 3"
1588,200,2,2100,2300,"Sub-basin 3"
1589,400,19,2800,3200,"Sub-basin 3"
1590,100,2,2300,2400,"Sub-basin 3"
1591,800,52,3500,4300,"Sub-basin 3"
1592,21300,8126,32900,54200,"Sub-basin 3"
1593,100,6,800,900,"Sub-basin 3"
1594,17000,2090,25200,42200,"Sub-basin 3"
1595,1100,187,7500,8600,"Sub-basin 3"
1596,4400,695,31200,35600,"Sub-basin 3"
1597,100,1,900,1000,"Sub-basin 3"
1598,400,15,5500,5900,"Sub-basin 3"
1599,61600,28490,70200,131800,"Sub-basin 3"
1600,1800,73,9100,10900,"Sub-basin 3"
1601,40100,10550.66,45800,85900,"Sub-basin 3"
1602,500,20,3200,3700,"Sub-basin 3"
1603,800,87.5,4300,5100,"Sub-basin 3"
1604,4300,275,17100,21400,"Sub-basin 3"
1605,1800,268,14400,16200,"Sub-basin 3"
1606,100,2,1700,1800,"Sub-basin 3"
1607,300,15,5000,5300,"Sub-basin 3"
1608,100,1,3500,3600,"Sub-basin 3"
1609,1500,33,22000,23500,"Sub-basin 3"
1610,800,45,4600,5400,"Sub-basin 3"
1611,4300,199,11700,16000,"Sub-basin 3"
1612,200,2,2200,2400,"Sub-basin 3"
1613,10700,627,24700,35400,"Sub-basin 3"
1614,100,2,400,500,"Sub-basin 3"
1615,100,1,2000,2100,"Sub-basin 3"
1616,1500,61,16700,18200,"Sub-basin 3"
1617,200,2,2500,2700,"Sub-basin 3"
1618,400,13,4700,5100,"Sub-basin 3"
1619,100,4,1700,1800,"Sub-basin 3"
1620,100,2,600,700,"Sub-basin 3"
1621,1300,161,3500,4800,"Sub-basin 3"
1622,200,4,2500,2700,"Sub-basin 3"
1623,200,4,2800,3000,"Sub-basin 3"
1624,100,1,1800,1900,"Sub-basin 3"
1625,6000,173,23100,29100,"Sub-basin 3"
1626,1000,166,3000,4000,"Sub-basin 3"
1627,4700,535,8500,13200,"Sub-basin 3"
1628,1600,278,5200,6800,"Sub-basin 3"
1629,5300,501,9700,15000,"Sub-basin 3"
1630,600,101,1700,2300,"Sub-basin 3"
1631,2200,453,7100,9300,"Sub-basin 3"
1632,2900,718,12200,15100,"Sub-basin 3"
1633,600,12,5100,5700,"Sub-basin 3"
1634,100,1,2100,2200,"Sub-basin 3"
1635,1000,24,15100,16100,"Sub-basin 3"
1636,200,7,3200,3400,"Sub-basin 3"
1637,100,1,1500,1600,"Sub-basin 3"
1638,9300,487,107000,116300,"Sub-basin 3"
1639,100,1,700,800,"Sub-basin 3"
1640,100,4,500,600,"Sub-basin 3"
1641,2000,48,10200,12200,"Sub-basin 3"
1642,67800,6408,131100,198900,"Sub-basin 3"
1643,1400,63,7500,8900,"Sub-basin 3"
1644,1300,360,1900,3200,"Sub-basin 3"
1645,1700,374,6500,8200,"Sub-basin 3"
1646,4700,176,41100,45800,"Sub-basin 3"
1647,200,2,3000,3200,"Sub-basin 3"
1648,200,5,3100,3300,"Sub-basin 3"
1649,500,7,10400,10900,"Sub-basin 3"
1650,100,1,1900,2000,"Sub-basin 3"
1651,100,2,700,800,"Sub-basin 3"
1652,200,6,1500,1700,"Sub-basin 3"
1653,100,1,1900,2000,"Sub-basin 3"
1654,1400,130,5600,7000,"Sub-basin 3"
1655,600,27,8200,8800,"Sub-basin 3"
1656,200,20,2100,2300,"Sub-basin 3"
1657,100,1,3000,3100,"Sub-basin 3"
1658,200,2,5600,5800,"Sub-basin 3"
1659,100,2,2800,2900,"Sub-basin 3"
1660,200,6,3800,4000,"Sub-basin 3"
1661,100,1,3400,3500,"Sub-basin 3"
1662,100,3,3400,3500,"Sub-basin 3"
1663,300,5,4300,4600,"Sub-basin 3"
1664,300,4,9600,9900,"Sub-basin 3"
1665,100,2,1000,1100,"Sub-basin 3"
1666,1100,48,12600,13700,"Sub-basin 3"
1667,8700,707,42100,50800,"Sub-basin 3"
1668,100,6,1200,1300,"Sub-basin 3"
1669,1800,105,20300,22100,"Sub-basin 3"
1670,100,2,1200,1300,"Sub-basin 3"
1671,100,1,400,500,"Sub-basin 3"
1672,100,2,1200,1300,"Sub-basin 3"
1673,1900,100,6100,8000,"Sub-basin 3"
1674,100,1,1500,1600,"Sub-basin 3"
1675,100,1,1000,1100,"Sub-basin 3"
1676,7500,4247,26400,33900,"Sub-basin 3"
1677,500,25,1500,2000,"Sub-basin 3"
1678,100,1,800,900,"Sub-basin 3"
1679,200,4,3800,4000,"Sub-basin 3"
1680,2700,198,32200,34900,"Sub-basin 3"
1681,400,9,5800,6200,"Sub-basin 3"
1682,100,1,2400,2500,"Sub-basin 3"
1683,100,2,3000,3100,"Sub-basin 3"
1684,100,8,1500,1600,"Sub-basin 3"
1685,100,2,2800,2900,"Sub-basin 3"
1686,100,2,1000,1100,"Sub-basin 3"
1687,100,1,2200,2300,"Sub-basin 3"
1688,200,2,200,400,"Sub-basin 3"
1689,1300,127.83,5500,6800,"Sub-basin 3"
1690,200,11,2900,3100,"Sub-basin 3"
1691,600,46,7400,8000,"Sub-basin 3"
1692,100,1,1400,1500,"Sub-basin 3"
1693,800,180,6100,6900,"Sub-basin 3"
1694,800,58,3800,4600,"Sub-basin 3"
1695,100,1,2300,2400,"Sub-basin 3"
1696,300,16,1300,1600,"Sub-basin 3"
1697,2900,197,5000,7900,"Sub-basin 3"
1698,200,44,1700,1900,"Sub-basin 3"
1699,100,1,1300,1400,"Sub-basin 3"
1700,100,1,3300,3400,"Sub-basin 3"
1701,1000,68,10400,11400,"Sub-basin 3"
1702,400,6,8600,9000,"Sub-basin 3"
1703,300,7,9800,10100,"Sub-basin 3"
1704,1200,208,4000,5200,"Sub-basin 3"
1705,2400,560,7400,9800,"Sub-basin 3"
1706,1000,31,5700,6700,"Sub-basin 3"
1707,100,9,2100,2200,"Sub-basin 3"
1708,5500,1282,12800,18300,"Sub-basin 3"
1709,100,1,2000,2100,"Sub-basin 3"
1710,100,5,2600,2700,"Sub-basin 3"
1711,600,15,3800,4400,"Sub-basin 3"
1712,600,31,7400,8000,"Sub-basin 3"
1713,100,1,2600,2700,"Sub-basin 3"
1714,400,7,1200,1600,"Sub-basin 3"
1715,2700,68,7800,10500,"Sub-basin 3"
1716,1300,134,7700,9000,"Sub-basin 3"
1717,200,4,500,700,"Sub-basin 3"
1718,600,26,8800,9400,"Sub-basin 3"
1719,1000,75,7700,8700,"Sub-basin 3"
1720,300,9,3400,3700,"Sub-basin 3"
1721,200,5,2000,2200,"Sub-basin 3"
1722,100,2,1700,1800,"Sub-basin 3"
1723,1000,64,8500,9500,"Sub-basin 3"
1724,300,14,1700,2000,"Sub-basin 3"
1725,100,1,1200,1300,"Sub-basin 3"
1726,100,1,1600,1700,"Sub-basin 3"
1727,200,19,2800,3000,"Sub-basin 3"
1728,1400,248,3400,4800,"Sub-basin 3"
1729,400,19,1900,2300,"Sub-basin 3"
1730,500,32,2200,2700,"Sub-basin 3"
1731,200,16,3300,3500,"Sub-basin 3"
1732,6700,2350,12800,19500,"Sub-basin 3"
1733,100,1,4200,4300,"Sub-basin 3"
1734,200,3,6900,7100,"Sub-basin 3"
1735,600,15,3400,4000,"Sub-basin 3"
1736,100,1,1100,1200,"Sub-basin 3"
1737,500,53,3900,4400,"Sub-basin 3"
1738,200,2,300,500,"Sub-basin 3"
1739,100,1,500,600,"Sub-basin 3"
1740,100,1,1700,1800,"Sub-basin 3"
1741,100,2,1100,1200,"Sub-basin 3"
1742,400,6,3800,4200,"Sub-basin 3"
1743,100,1,1700,1800,"Sub-basin 3"
1744,100,1,3200,3300,"Sub-basin 3"
1745,300,7,5500,5800,"Sub-basin 3"
1746,9100,508,27700,36800,"Sub-basin 3"
1747,100,2,1400,1500,"Sub-basin 3"
1748,800,123,2700,3500,"Sub-basin 3"
1749,1900,184,6500,8400,"Sub-basin 3"
1750,100,2,600,700,"Sub-basin 3"
1751,700,48,3700,4400,"Sub-basin 3"
1752,800,34,3900,4700,"Sub-basin 3"
1753,1500,49,7700,9200,"Sub-basin 3"
1754,100,1,1400,1500,"Sub-basin 3"
1755,100,1,1000,1100,"Sub-basin 3"
1756,600,24,6400,7000,"Sub-basin 3"
1757,400,30,3200,3600,"Sub-basin 3"
1758,200,3,4200,4400,"Sub-basin 3"
1759,100,1,3200,3300,"Sub-basin 3"
1760,100,2,1700,1800,"Sub-basin 3"
1761,500,9,3500,4000,"Sub-basin 3"
1762,3900,892,8200,12100,"Sub-basin 3"
1763,1700,45,3900,5600,"Sub-basin 3"
1764,800,19,2300,3100,"Sub-basin 3"
1765,2700,381,6000,8700,"Sub-basin 3"
1766,1500,292,5300,6800,"Sub-basin 3"
1767,500,45,3400,3900,"Sub-basin 3"
1768,100,1,1700,1800,"Sub-basin 3"
1769,2300,673,5100,7400,"Sub-basin 3"
1770,1100,58,10100,11200,"Sub-basin 3"
1771,400,7,5800,6200,"Sub-basin 3"
1772,200,3,1700,1900,"Sub-basin 3"
1773,900,21,14300,15200,"Sub-basin 3"
1774,100,2,1900,2000,"Sub-basin 3"
1775,100,1,2500,2600,"Sub-basin 3"
1776,1000,19,13000,14000,"Sub-basin 3"
1777,400,84,2900,3300,"Sub-basin 3"
1778,100,1,1100,1200,"Sub-basin 3"
1779,26200,2679,186700,212900,"Sub-basin 3"
1780,100,1,1000,1100,"Sub-basin 3"
1781,800,46,5500,6300,"Sub-basin 3"
1782,1900,293,8300,10200,"Sub-basin 3"
1783,4100,851,17100,21200,"Sub-basin 3"
1784,100,5,600,700,"Sub-basin 3"
1785,100,1,1300,1400,"Sub-basin 3"
1786,100,1,1400,1500,"Sub-basin 3"
1787,200,5,2700,2900,"Sub-basin 3"
1788,200,2,2100,2300,"Sub-basin 3"
1789,100,1,1500,1600,"Sub-basin 3"
1790,900,51,8800,9700,"Sub-basin 3"
1791,200,6,4500,4700,"Sub-basin 3"
1792,100,1,3700,3800,"Sub-basin 3"
1793,400,6,18600,19000,"Sub-basin 3"
1794,7200,1641,7800,15000,"Sub-basin 3"
1795,300,3,4000,4300,"Sub-basin 3"
1796,100,1,4700,4800,"Sub-basin 3"
1797,200,3,8600,8800,"Sub-basin 3"
1798,1900,215,16200,18100,"Sub-basin 3"
1799,9000,1562,28500,37500,"Sub-basin 3"
1800,200,2,200,400,"Sub-basin 3"
1801,5600,436,10100,15700,"Sub-basin 3"
1802,6100,3029,13100,19200,"Sub-basin 3"
1803,100,3,1100,1200,"Sub-basin 3"
1804,1000,102,6000,7000,"Sub-basin 3"
1805,1400,299,5400,6800,"Sub-basin 3"
1806,2000,257,11200,13200,"Sub-basin 3"
1807,200,8,1700,1900,"Sub-basin 3"
1808,300,7,1600,1900,"Sub-basin 3"
1809,300,5,7800,8100,"Sub-basin 3"
1810,2400,365,12600,15000,"Sub-basin 3"
1811,200,2,6800,7000,"Sub-basin 3"
1812,1100,20,28300,29400,"Sub-basin 3"
1813,100,2,6000,6100,"Sub-basin 3"
1814,200,2,10200,10400,"Sub-basin 3"
1815,800,56,6400,7200,"Sub-basin 3"
1816,100,4,2300,2400,"Sub-basin 3"
1817,300,5,2300,2600,"Sub-basin 3"
1818,400,63,1300,1700,"Sub-basin 3"
1819,200,7,1800,2000,"Sub-basin 3"
1820,200,2,1800,2000,"Sub-basin 3"
1821,100,2,2200,2300,"Sub-basin 3"
1822,200,7,3700,3900,"Sub-basin 3"
1823,1100,56,16500,17600,"Sub-basin 3"
1824,300,8,3800,4100,"Sub-basin 3"
1825,100,2,1900,2000,"Sub-basin 3"
1826,200,6,2600,2800,"Sub-basin 3"
1827,500,14,2200,2700,"Sub-basin 3"
1828,500,26,1200,1700,"Sub-basin 3"
1829,1900,491,3700,5600,"Sub-basin 3"
1830,100,5,3500,3600,"Sub-basin 3"
1831,100,1,1600,1700,"Sub-basin 3"
1832,1000,33,8400,9400,"Sub-basin 3"
1833,200,4,8000,8200,"Sub-basin 3"
1834,100,2,2400,2500,"Sub-basin 3"
1835,100,1,100,200,"Sub-basin 3"
1836,200,6,900,1100,"Sub-basin 3"
1837,17900,738,31200,49100,"Sub-basin 3"
1838,100,2,1100,1200,"Sub-basin 3"
1839,100,2,400,500,"Sub-basin 3"
1840,100,3,1100,1200,"Sub-basin 3"
1841,100,2,2800,2900,"Sub-basin 3"
1842,300,5,4300,4600,"Sub-basin 3"
1843,1300,74,18300,19600,"Sub-basin 3"
1844,600,45,5400,6000,"Sub-basin 3"
1845,500,8,7000,7500,"Sub-basin 3"
1846,500,28,5900,6400,"Sub-basin 3"
1847,100,1,500,600,"Sub-basin 3"
1848,100,1,600,700,"Sub-basin 3"
1849,3500,562,9000,12500,"Sub-basin 3"
1850,3100,249,14000,17100,"Sub-basin 3"
1851,25600,4997,70200,95800,"Sub-basin 3"
1852,500,36,2400,2900,"Sub-basin 3"
1853,100,1,1800,1900,"Sub-basin 3"
1854,100,1,2800,2900,"Sub-basin 3"
1855,100,1,2400,2500,"Sub-basin 3"
1856,4200,647,31000,35200,"Sub-basin 3"
1857,200,3,1800,2000,"Sub-basin 3"
1858,800,146,4300,5100,"Sub-basin 3"
1859,100,1,700,800,"Sub-basin 3"
1860,1500,31,29500,31000,"Sub-basin 3"
1861,200,4,6200,6400,"Sub-basin 3"
1862,6500,355,50700,57200,"Sub-basin 3"
1863,500,34,4800,5300,"Sub-basin 3"
1864,600,13,1300,1900,"Sub-basin 3"
1865,1600,328,4900,6500,"Sub-basin 3"
1866,200,4,2800,3000,"Sub-basin 3"
1867,100,1,1500,1600,"Sub-basin 3"
1868,600,16,5400,6000,"Sub-basin 3"
1869,800,101,6200,7000,"Sub-basin 3"
1870,2900,257,14300,17200,"Sub-basin 3"
1871,100,3,1700,1800,"Sub-basin 3"
1872,100,1,1000,1100,"Sub-basin 3"
1873,200,5,8200,8400,"Sub-basin 3"
1874,3600,221,21600,25200,"Sub-basin 3"
1875,3200,518,18100,21300,"Sub-basin 3"
1876,600,95,4600,5200,"Sub-basin 3"
1877,200,4,3400,3600,"Sub-basin 3"
1878,100,1,2600,2700,"Sub-basin 3"
1879,300,5,9300,9600,"Sub-basin 3"
1880,100,2,1000,1100,"Sub-basin 3"
1881,100,1,1400,1500,"Sub-basin 3"
1882,400,8,5500,5900,"Sub-basin 3"
1883,100,8,1400,1500,"Sub-basin 3"
1884,13900,2367,12900,26800,"Sub-basin 3"
1885,4100,1004.83,9100,13200,"Sub-basin 3"
1886,23800,1097,34700,58500,"Sub-basin 3"
1887,4800,500,16200,21000,"Sub-basin 3"
1888,100,3,1400,1500,"Sub-basin 3"
1889,600,39,11100,11700,"Sub-basin 3"
1890,200,6,1700,1900,"Sub-basin 3"
1891,400,13,4000,4400,"Sub-basin 3"
1892,100,1,800,900,"Sub-basin 3"
1893,100,3,3500,3600,"Sub-basin 3"
1894,100,2,2700,2800,"Sub-basin 3"
1895,100,1,2700,2800,"Sub-basin 3"
1896,100,5,2800,2900,"Sub-basin 3"
1897,400,8,8700,9100,"Sub-basin 3"
1898,900,20,6200,7100,"Sub-basin 3"
1899,4100,1058,16800,20900,"Sub-basin 3"
1900,100,2,500,600,"Sub-basin 3"
1901,2400,90,10700,13100,"Sub-basin 3"
1902,300,5,2700,3000,"Sub-basin 3"
1903,200,6,2700,2900,"Sub-basin 3"
1904,100,1,1700,1800,"Sub-basin 3"
1905,200,4,1000,1200,"Sub-basin 3"
1906,600,36,4000,4600,"Sub-basin 3"
1907,100,2,1300,1400,"Sub-basin 3"
1908,100,2,2300,2400,"Sub-basin 3"
1909,200,4,3300,3500,"Sub-basin 3"
1910,500,11,12300,12800,"Sub-basin 3"
1911,100,1,3000,3100,"Sub-basin 3"
1912,1000,34,6400,7400,"Sub-basin 3"
1913,300,9,2800,3100,"Sub-basin 3"
1914,100,1,2400,2500,"Sub-basin 3"
1915,400,12,4200,4600,"Sub-basin 3"
1916,200,16,4100,4300,"Sub-basin 3"
1917,100,1,700,800,"Sub-basin 3"
1918,1100,45,8400,9500,"Sub-basin 3"
1919,100,12,1100,1200,"Sub-basin 3"
1920,100,1,2600,2700,"Sub-basin 3"
1921,100,2,800,900,"Sub-basin 3"
1922,2100,216,10000,12100,"Sub-basin 3"
1923,1600,159,13000,14600,"Sub-basin 3"
1924,100,1,2600,2700,"Sub-basin 3"
1925,100,1,3200,3300,"Sub-basin 3"
1926,100,1,2200,2300,"Sub-basin 3"
1927,900,32,12500,13400,"Sub-basin 3"
1928,300,14,2400,2700,"Sub-basin 3"
1929,3100,256,5000,8100,"Sub-basin 3"
1930,1400,224,4400,5800,"Sub-basin 3"
1931,1300,50,11000,12300,"Sub-basin 3"
1932,1100,26,21100,22200,"Sub-basin 3"
1933,900,50,4500,5400,"Sub-basin 3"
1934,3000,86,37800,40800,"Sub-basin 3"
1935,100,1,3000,3100,"Sub-basin 3"
1936,3600,151,18500,22100,"Sub-basin 3"
1937,100,2,900,1000,"Sub-basin 3"
1938,300,14,3200,3500,"Sub-basin 3"
1939,3400,251,54600,58000,"Sub-basin 3"
1940,20300,1793,66300,86600,"Sub-basin 3"
1941,100,1,2500,2600,"Sub-basin 3"
1942,200,3,4800,5000,"Sub-basin 3"
1943,1900,93,22000,23900,"Sub-basin 3"
1944,100,3,1500,1600,"Sub-basin 3"
1945,100,5,1100,1200,"Sub-basin 3"
1946,100,1,1600,1700,"Sub-basin 3"
1947,400,13,5800,6200,"Sub-basin 3"
1948,100,2,900,1000,"Sub-basin 3"
1949,100,4,1300,1400,"Sub-basin 3"
1950,600,15,7700,8300,"Sub-basin 3"
1951,400,19,4200,4600,"Sub-basin 3"
1952,200,7,3700,3900,"Sub-basin 3"
1953,200,3,3600,3800,"Sub-basin 3"
1954,300,9,3800,4100,"Sub-basin 3"
1955,1500,145,12900,14400,"Sub-basin 3"
1956,200,8,3300,3500,"Sub-basin 3"
1957,600,29,3600,4200,"Sub-basin 3"
1958,600,60,1800,2400,"Sub-basin 3"
1959,200,4,6700,6900,"Sub-basin 3"
1960,100,2,4400,4500,"Sub-basin 3"
1961,900,33,6200,7100,"Sub-basin 3"
1962,100,1,2200,2300,"Sub-basin 3"
1963,400,59,2400,2800,"Sub-basin 3"
1964,2000,81,13700,15700,"Sub-basin 3"
1965,300,5,2500,2800,"Sub-basin 3"
1966,100,1,1000,1100,"Sub-basin 3"
1967,1400,195,19000,20400,"Sub-basin 3"
1968,400,9,3300,3700,"Sub-basin 3"
1969,200,4,2800,3000,"Sub-basin 3"
1970,2000,189,28300,30300,"Sub-basin 3"
1971,2400,248,11500,13900,"Sub-basin 3"
1972,66300,16470,88200,154500,"Sub-basin 3"
1973,500,5,15000,15500,"Sub-basin 3"
1974,200,3,5800,6000,"Sub-basin 3"
1975,300,4,8300,8600,"Sub-basin 3"
1976,100,2,1500,1600,"Sub-basin 3"
1977,200,11,4400,4600,"Sub-basin 3"
1978,100,3,3000,3100,"Sub-basin 3"
1979,100,4,1700,1800,"Sub-basin 3"
1980,100,2,300,400,"Sub-basin 3"
1981,200,2,1400,1600,"Sub-basin 3"
1982,200,5,1300,1500,"Sub-basin 3"
1983,900,55,4100,5000,"Sub-basin 3"
1984,500,24,5000,5500,"Sub-basin 3"
1985,500,13,5600,6100,"Sub-basin 3"
1986,100,3,1300,1400,"Sub-basin 3"
1987,100,1,900,1000,"Sub-basin 3"
1988,100,2,3100,3200,"Sub-basin 3"
1989,500,10,5000,5500,"Sub-basin 3"
1990,700,48,3900,4600,"Sub-basin 3"
1991,1000,55,7500,8500,"Sub-basin 3"
1992,600,30,6100,6700,"Sub-basin 3"
1993,400,38,2300,2700,"Sub-basin 3"
1994,800,32,6100,6900,"Sub-basin 3"
1995,1100,51,8900,10000,"Sub-basin 3"
1996,400,53,7700,8100,"Sub-basin 3"
1997,400,6,6900,7300,"Sub-basin 3"
1998,1000,63,9700,10700,"Sub-basin 3"
1999,100,1,3700,3800,"Sub-basin 3"
2000,200,2,7400,7600,"Sub-basin 3"
2001,300,4,5500,5800,"Sub-basin 3"
2002,600,55,9300,9900,"Sub-basin 3"
2003,200,5,2500,2700,"Sub-basin 3"
2004,200,4,2300,2500,"Sub-basin 3"
2005,38900,4207.51,62800,101700,"Sub-basin 3"
2006,400,11,500,900,"Sub-basin 3"
2007,100,2,400,500,"Sub-basin 3"
2008,2700,1228,6500,9200,"Sub-basin 3"
2009,3100,655,8900,12000,"Sub-basin 3"
2010,600,106,1900,2500,"Sub-basin 3"
2011,100,1,1700,1800,"Sub-basin 3"
2012,100,2,1200,1300,"Sub-basin 3"
2013,1100,78,16400,17500,"Sub-basin 3"
2014,300,10,3800,4100,"Sub-basin 3"
2015,200,9,3000,3200,"Sub-basin 3"
2016,200,6,700,900,"Sub-basin 3"
2017,1300,197,2400,3700,"Sub-basin 3"
2018,6300,264,14300,20600,"Sub-basin 3"
2019,400,22,3700,4100,"Sub-basin 3"
2020,200,5,2400,2600,"Sub-basin 3"
2021,200,16,2600,2800,"Sub-basin 3"
2022,200,23,2900,3100,"Sub-basin 3"
2023,100,2,3400,3500,"Sub-basin 3"
2024,200,2,1200,1400,"Sub-basin 3"
2025,100,2,1800,1900,"Sub-basin 3"
2026,100,1,4200,4300,"Sub-basin 3"
2027,500,35,8300,8800,"Sub-basin 3"
2028,300,14,4500,4800,"Sub-basin 3"
2029,7600,275,45600,53200,"Sub-basin 3"
2030,300,7,1500,1800,"Sub-basin 3"
2031,100,4,1600,1700,"Sub-basin 3"
2032,200,8,3000,3200,"Sub-basin 3"
2033,200,2,6900,7100,"Sub-basin 3"
2034,100,1,4300,4400,"Sub-basin 3"
2035,100,1,3200,3300,"Sub-basin 3"
2036,200,2,7700,7900,"Sub-basin 3"
2037,300,17,3500,3800,"Sub-basin 3"
2038,100,1,2900,3000,"Sub-basin 3"
2039,100,1,2500,2600,"Sub-basin 3"
2040,100,1,2300,2400,"Sub-basin 3"
2041,200,17,1600,1800,"Sub-basin 3"
2042,100,1,900,1000,"Sub-basin 3"
2043,2400,69.3192,11600,14000,"Sub-basin 3"
2044,100,4,1600,1700,"Sub-basin 3"
2045,300,6,3100,3400,"Sub-basin 3"
2046,200,2,3700,3900,"Sub-basin 3"
2047,100,1,1400,1500,"Sub-basin 3"
2048,1100,45,12900,14000,"Sub-basin 3"
2049,100,8,2300,2400,"Sub-basin 3"
2050,600,14,12900,13500,"Sub-basin 3"
2051,100,1,3100,3200,"Sub-basin 3"
2052,100,1,1600,1700,"Sub-basin 3"
2053,100,4,1000,1100,"Sub-basin 3"
2054,100,1,3800,3900,"Sub-basin 3"
2055,100,1,4000,4100,"Sub-basin 3"
2056,700,40,6900,7600,"Sub-basin 3"
2057,500,7,5300,5800,"Sub-basin 3"
2058,100,3,1600,1700,"Sub-basin 3"
2059,100,1,1700,1800,"Sub-basin 3"
2060,1800,422,10000,11800,"Sub-basin 3"
2061,800,68,4900,5700,"Sub-basin 3"
2062,100,1,1300,1400,"Sub-basin 3"
2063,100,2,1600,1700,"Sub-basin 3"
2064,100,2,700,800,"Sub-basin 3"
2065,100,1,1100,1200,"Sub-basin 3"
2066,100,2,2600,2700,"Sub-basin 3"
2067,400,10,6500,6900,"Sub-basin 3"
2068,1000,120,9800,10800,"Sub-basin 3"
2069,100,1,3200,3300,"Sub-basin 3"
2070,100,1,4900,5000,"Sub-basin 3"
2071,200,5,3800,4000,"Sub-basin 3"
2072,300,9,3800,4100,"Sub-basin 3"
2073,3500,224,10400,13900,"Sub-basin 3"
2074,1100,80,7700,8800,"Sub-basin 3"
2075,1000,49,3900,4900,"Sub-basin 3"
2076,200,2,2600,2800,"Sub-basin 3"
2077,700,81,3800,4500,"Sub-basin 3"
2078,100,4,1200,1300,"Sub-basin 3"
2079,100,2,2900,3000,"Sub-basin 3"
2080,2800,157,34900,37700,"Sub-basin 3"
2081,100,1,3100,3200,"Sub-basin 3"
2082,5400,657,48900,54300,"Sub-basin 3"
2083,100,1,3300,3400,"Sub-basin 3"
2084,100,5,1900,2000,"Sub-basin 3"
2085,1400,187,18200,19600,"Sub-basin 3"
2086,1000,100,8600,9600,"Sub-basin 3"
2087,200,4,1800,2000,"Sub-basin 3"
2088,22400,4651.5,37100,59500,"Sub-basin 3"
2089,100,1,900,1000,"Sub-basin 3"
2090,100,1,400,500,"Sub-basin 3"
2091,200,5,3300,3500,"Sub-basin 3"
2092,100,2,2400,2500,"Sub-basin 3"
2093,900,48,8100,9000,"Sub-basin 3"
2094,400,9,5900,6300,"Sub-basin 3"
2095,100,1,5000,5100,"Sub-basin 3"
2096,200,20,2400,2600,"Sub-basin 3"
2097,4700,212,36400,41100,"Sub-basin 3"
2098,100,4,1200,1300,"Sub-basin 3"
2099,100,1,400,500,"Sub-basin 3"
2100,200,4,1900,2100,"Sub-basin 3"
2101,1400,176,4800,6200,"Sub-basin 3"
2102,100,1,1100,1200,"Sub-basin 3"
2103,400,10,7400,7800,"Sub-basin 3"
2104,100,1,1400,1500,"Sub-basin 3"
2105,100,2,1700,1800,"Sub-basin 3"
2106,200,5,5000,5200,"Sub-basin 3"
2107,1200,33,26300,27500,"Sub-basin 3"
2108,200,2,6500,6700,"Sub-basin 3"
2109,100,1,3100,3200,"Sub-basin 3"
2110,100,2,2800,2900,"Sub-basin 3"
2111,200,3,1700,1900,"Sub-basin 3"
2112,100,5,1700,1800,"Sub-basin 3"
2113,300,6,1200,1500,"Sub-basin 3"
2114,600,71,2000,2600,"Sub-basin 3"
2115,100,1,1700,1800,"Sub-basin 3"
2116,800,46,7500,8300,"Sub-basin 3"
2117,200,8,2600,2800,"Sub-basin 3"
2118,100,4,900,1000,"Sub-basin 3"
2119,100,1,2400,2500,"Sub-basin 3"
2120,200,5,2800,3000,"Sub-basin 3"
2121,100,4,5900,6000,"Sub-basin 3"
2122,3200,390,5300,8500,"Sub-basin 3"
2123,200,16,1300,1500,"Sub-basin 3"
2124,100,1,1800,1900,"Sub-basin 3"
2125,400,14,3800,4200,"Sub-basin 3"
2126,300,5.67,4100,4400,"Sub-basin 3"
2127,4600,480.33,17100,21700,"Sub-basin 3"
2128,200,4,2700,2900,"Sub-basin 3"
2129,200,3,5200,5400,"Sub-basin 3"
2130,700,68,5900,6600,"Sub-basin 3"
2131,200,7,4300,4500,"Sub-basin 3"
2132,100,2,3600,3700,"Sub-basin 3"
2133,100,1,3300,3400,"Sub-basin 3"
2134,7900,373,78600,86500,"Sub-basin 3"
2135,800,28,4800,5600,"Sub-basin 3"
2136,100,1,300,400,"Sub-basin 3"
2137,19600,1031,36200,55800,"Sub-basin 3"
2138,4200,538,17200,21400,"Sub-basin 3"
2139,1000,37,10100,11100,"Sub-basin 3"
2140,200,4,3500,3700,"Sub-basin 3"
2141,1600,111,10200,11800,"Sub-basin 3"
2142,100,3,2400,2500,"Sub-basin 3"
2143,900,27,5500,6400,"Sub-basin 3"
2144,100,3,1800,1900,"Sub-basin 3"
2145,100,3,4700,4800,"Sub-basin 3"
2146,100,1,2000,2100,"Sub-basin 3"
2147,300,10,4300,4600,"Sub-basin 3"
2148,100,2,400,500,"Sub-basin 3"
2149,100,2,1000,1100,"Sub-basin 3"
2150,500,18,3300,3800,"Sub-basin 3"
2151,500,49,3600,4100,"Sub-basin 3"
2152,100,7,2200,2300,"Sub-basin 3"
2153,2700,1362,7100,9800,"Sub-basin 3"
2154,300,12,5300,5600,"Sub-basin 3"
2155,500,41,2000,2500,"Sub-basin 3"
2156,100,1,3000,3100,"Sub-basin 3"
2157,100,1,3300,3400,"Sub-basin 3"
2158,100,2,3700,3800,"Sub-basin 3"
2159,200,73,4300,4500,"Sub-basin 3"
2160,900,64,9300,10200,"Sub-basin 3"
2161,300,12,2900,3200,"Sub-basin 3"
2162,400,35,2100,2500,"Sub-basin 3"
2163,900,52,7600,8500,"Sub-basin 3"
2164,500,75,7500,8000,"Sub-basin 3"
2165,3000,158,29900,32900,"Sub-basin 3"
2166,200,9,1900,2100,"Sub-basin 3"
2167,200,4,4200,4400,"Sub-basin 3"
2168,100,1,3100,3200,"Sub-basin 3"
2169,100,1,4000,4100,"Sub-basin 3"
2170,300,5,6100,6400,"Sub-basin 3"
2171,400,11,6100,6500,"Sub-basin 3"
2172,200,3,2300,2500,"Sub-basin 3"
2173,100,1,1300,1400,"Sub-basin 3"
2174,2600,348,6000,8600,"Sub-basin 3"
2175,900,35,7100,8000,"Sub-basin 3"
2176,1100,58,5700,6800,"Sub-basin 3"
2177,10700,2894,26300,37000,"Sub-basin 3"
2178,200,4,1900,2100,"Sub-basin 3"
2179,100,1,2000,2100,"Sub-basin 3"
2180,100,2,1000,1100,"Sub-basin 3"
2181,1900,108,23500,25400,"Sub-basin 3"
2182,400,8,8800,9200,"Sub-basin 3"
2183,1200,191,900,2100,"Sub-basin 3"
2184,200,4,3000,3200,"Sub-basin 3"
2185,7500,2555,15900,23400,"Sub-basin 3"
2186,200,2,2500,2700,"Sub-basin 3"
2187,1300,76,20800,22100,"Sub-basin 3"
2188,100,1,2900,3000,"Sub-basin 3"
2189,100,14,2300,2400,"Sub-basin 3"
2190,200,5,2400,2600,"Sub-basin 3"
2191,100,1,1900,2000,"Sub-basin 3"
2192,100,2,800,900,"Sub-basin 3"
2193,5800,201,20300,26100,"Sub-basin 3"
2194,500,18,4400,4900,"Sub-basin 3"
2195,200,70,3000,3200,"Sub-basin 3"
2196,200,2,3200,3400,"Sub-basin 3"
2197,400,11,4300,4700,"Sub-basin 3"
2198,700,16,10700,11400,"Sub-basin 3"
2199,100,1,1900,2000,"Sub-basin 3"
2200,200,4,4200,4400,"Sub-basin 3"
2201,400,13,6900,7300,"Sub-basin 3"
2202,200,5,7300,7500,"Sub-basin 3"
2203,100,2,2000,2100,"Sub-basin 3"
2204,400,9,4000,4400,"Sub-basin 3"
2205,100,1,200,300,"Sub-basin 3"
2206,400,12,4200,4600,"Sub-basin 3"
2207,200,3,3300,3500,"Sub-basin 3"
2208,400,8,8900,9300,"Sub-basin 3"
2209,100,1,3500,3600,"Sub-basin 3"
2210,100,4,2300,2400,"Sub-basin 3"
2211,900,55,10600,11500,"Sub-basin 3"
2212,400,41,6200,6600,"Sub-basin 3"
2213,300,9,1100,1400,"Sub-basin 3"
2214,300,22,3300,3600,"Sub-basin 3"
2215,2900,118,16200,19100,"Sub-basin 3"
2216,100,1,1400,1500,"Sub-basin 3"
2217,4100,348,49500,53600,"Sub-basin 3"
2218,100,1,4200,4300,"Sub-basin 3"
2219,700,24,6300,7000,"Sub-basin 3"
2220,1500,109,9900,11400,"Sub-basin 3"
2221,100,1,700,800,"Sub-basin 3"
2222,100,5,1600,1700,"Sub-basin 3"
2223,100,1,900,1000,"Sub-basin 3"
2224,600,27,3700,4300,"Sub-basin 3"
2225,900,35,8500,9400,"Sub-basin 3"
2226,100,2,1000,1100,"Sub-basin 3"
2227,100,2,1800,1900,"Sub-basin 3"
2228,100,1,2200,2300,"Sub-basin 3"
2229,400,24,4700,5100,"Sub-basin 3"
2230,200,4,2200,2400,"Sub-basin 3"
2231,700,14,8200,8900,"Sub-basin 3"
2232,1700,48,25500,27200,"Sub-basin 3"
2233,300,55,2000,2300,"Sub-basin 3"
2234,1400,129,2900,4300,"Sub-basin 3"
2235,300,7,3400,3700,"Sub-basin 3"
2236,100,1,2500,2600,"Sub-basin 3"
2237,200,3,4900,5100,"Sub-basin 3"
2238,200,4,3200,3400,"Sub-basin 3"
2239,100,4,2500,2600,"Sub-basin 3"
2240,100,1,3400,3500,"Sub-basin 3"
2241,200,3,2100,2300,"Sub-basin 3"
2242,100,2,1400,1500,"Sub-basin 3"
2243,100,1,1000,1100,"Sub-basin 3"
2244,100,6,900,1000,"Sub-basin 3"
2245,1200,126,5900,7100,"Sub-basin 3"
2246,700,37,11700,12400,"Sub-basin 3"
2247,300,6,5400,5700,"Sub-basin 3"
2248,2400,238,23000,25400,"Sub-basin 3"
2249,900,61,10100,11000,"Sub-basin 3"
2250,300,7,10300,10600,"Sub-basin 3"
2251,100,2,2800,2900,"Sub-basin 3"
2252,400,6,9100,9500,"Sub-basin 3"
2253,400,21,2500,2900,"Sub-basin 3"
2254,800,52,5400,6200,"Sub-basin 3"
2255,13800,1034,49200,63000,"Sub-basin 3"
2256,300,9,4100,4400,"Sub-basin 3"
2257,600,40,10400,11000,"Sub-basin 3"
2258,2300,196,27500,29800,"Sub-basin 3"
2259,400,11,10500,10900,"Sub-basin 3"
2260,700,60,14000,14700,"Sub-basin 3"
2261,100,1,1500,1600,"Sub-basin 3"
2262,100,5,1100,1200,"Sub-basin 3"
2263,200,5,3200,3400,"Sub-basin 3"
2264,500,14,5800,6300,"Sub-basin 3"
2265,300,10,5000,5300,"Sub-basin 3"
2266,500,10,10500,11000,"Sub-basin 3"
2267,200,2,7100,7300,"Sub-basin 3"
2268,100,1,2100,2200,"Sub-basin 3"
2269,200,3,300,500,"Sub-basin 3"
2270,200,7,1700,1900,"Sub-basin 3"
2271,1600,33,9400,11000,"Sub-basin 3"
2272,100,1,1200,1300,"Sub-basin 3"
2273,10800,2743,22100,32900,"Sub-basin 3"
2274,5800,1960,11200,17000,"Sub-basin 3"
2275,100,3,1300,1400,"Sub-basin 3"
2276,300,5,5400,5700,"Sub-basin 3"
2277,100,3,1600,1700,"Sub-basin 3"
2278,300,4,3400,3700,"Sub-basin 3"
2279,600,12,8800,9400,"Sub-basin 3"
2280,100,1,4000,4100,"Sub-basin 3"
2281,400,9,10300,10700,"Sub-basin 3"
2282,100,1,1800,1900,"Sub-basin 3"
2283,300,9,4000,4300,"Sub-basin 3"
2284,1800,204,4000,5800,"Sub-basin 3"
2285,100,2,1400,1500,"Sub-basin 3"
2286,100,9,1400,1500,"Sub-basin 3"
2287,600,30,5200,5800,"Sub-basin 3"
2288,100,5,900,1000,"Sub-basin 3"
2289,100,1,1100,1200,"Sub-basin 3"
2290,1200,34,21100,22300,"Sub-basin 3"
2291,400,9,8400,8800,"Sub-basin 3"
2292,1700,230,13800,15500,"Sub-basin 3"
2293,300,11,3500,3800,"Sub-basin 3"
2294,100,1,800,900,"Sub-basin 3"
2295,400,17,2700,3100,"Sub-basin 3"
2296,100,1,1000,1100,"Sub-basin 3"
2297,100,1,1500,1600,"Sub-basin 3"
2298,1200,150,4700,5900,"Sub-basin 3"
2299,300,9,2700,3000,"Sub-basin 3"
2300,300,6,4800,5100,"Sub-basin 3"
2301,100,2,4700,4800,"Sub-basin 3"
2302,100,1,2400,2500,"Sub-basin 3"
2303,300,5,6800,7100,"Sub-basin 3"
2304,100,3,1500,1600,"Sub-basin 3"
2305,1200,30,11200,12400,"Sub-basin 3"
2306,12200,371,69000,81200,"Sub-basin 3"
2307,3200,329,9700,12900,"Sub-basin 3"
2308,400,24,5000,5400,"Sub-basin 3"
2309,30500,3013,58200,88700,"Sub-basin 3"
2310,5200,532,8500,13700,"Sub-basin 3"
2311,3200,90,11900,15100,"Sub-basin 3"
2312,100,3,2000,2100,"Sub-basin 3"
2313,6900,1696.68,19400,26300,"Sub-basin 3"
2314,800,40,12300,13100,"Sub-basin 3"
2315,100,1,1300,1400,"Sub-basin 3"
2316,400,8,8300,8700,"Sub-basin 3"
2317,300,4,4400,4700,"Sub-basin 3"
2318,300,8,6400,6700,"Sub-basin 3"
2319,200,14,4200,4400,"Sub-basin 3"
2320,3600,234,29000,32600,"Sub-basin 3"
2321,300,10,1200,1500,"Sub-basin 3"
2322,100,9,1600,1700,"Sub-basin 3"
2323,1100,172,4600,5700,"Sub-basin 3"
2324,200,2,2700,2900,"Sub-basin 3"
2325,100,1,2500,2600,"Sub-basin 3"
2326,100,3,2600,2700,"Sub-basin 3"
2327,200,3,4300,4500,"Sub-basin 3"
2328,100,1,3800,3900,"Sub-basin 3"
2329,100,1,4900,5000,"Sub-basin 3"
2330,400,15,6300,6700,"Sub-basin 3"
2331,200,3,4200,4400,"Sub-basin 3"
2332,300,14,4000,4300,"Sub-basin 3"
2333,6800,1155,12600,19400,"Sub-basin 3"
2334,900,128,7100,8000,"Sub-basin 3"
2335,400,15,3100,3500,"Sub-basin 3"
2336,100,1,1800,1900,"Sub-basin 3"
2337,700,59,7200,7900,"Sub-basin 3"
2338,100,2,1800,1900,"Sub-basin 3"
2339,400,9,3100,3500,"Sub-basin 3"
2340,100,1,1700,1800,"Sub-basin 3"
2341,400,23,1800,2200,"Sub-basin 3"
2342,300,7,4600,4900,"Sub-basin 3"
2343,100,2,1000,1100,"Sub-basin 3"
2344,4000,194,9000,13000,"Sub-basin 3"
2345,6100,1042,11000,17100,"Sub-basin 3"
2346,1200,170,5300,6500,"Sub-basin 3"
2347,4700,754,22400,27100,"Sub-basin 3"
2348,100,1,1600,1700,"Sub-basin 3"
2349,300,7,5900,6200,"Sub-basin 3"
2350,200,4,3400,3600,"Sub-basin 3"
2351,200,5,3100,3300,"Sub-basin 3"
2352,1300,60,16200,17500,"Sub-basin 3"
2353,300,10,7200,7500,"Sub-basin 3"
2354,100,1,4500,4600,"Sub-basin 3"
2355,100,1,2200,2300,"Sub-basin 3"
2356,800,49,4900,5700,"Sub-basin 3"
2357,100,2,1600,1700,"Sub-basin 3"
2358,200,3,6100,6300,"Sub-basin 3"
2359,100,1,2700,2800,"Sub-basin 3"
2360,400,6,9800,10200,"Sub-basin 3"
2361,100,1,2100,2200,"Sub-basin 3"
2362,200,7,3000,3200,"Sub-basin 3"
2363,1000,73,8100,9100,"Sub-basin 3"
2364,100,2,1200,1300,"Sub-basin 3"
2365,100,1,500,600,"Sub-basin 3"
2366,100,1,2500,2600,"Sub-basin 3"
2367,100,4,500,600,"Sub-basin 3"
2368,900,88.5,2900,3800,"Sub-basin 3"
2369,200,2,1000,1200,"Sub-basin 3"
2370,100,1,1500,1600,"Sub-basin 3"
2371,800,45,9400,10200,"Sub-basin 3"
2372,100,1,3300,3400,"Sub-basin 3"
2373,200,2,5800,6000,"Sub-basin 3"
2374,500,34,4600,5100,"Sub-basin 3"
2375,2000,172,23500,25500,"Sub-basin 3"
2376,200,3,5000,5200,"Sub-basin 3"
2377,400,10,3900,4300,"Sub-basin 3"
2378,5200,289,14800,20000,"Sub-basin 3"
2379,100,11,900,1000,"Sub-basin 3"
2380,1100,121,7500,8600,"Sub-basin 3"
2381,100,3,600,700,"Sub-basin 3"
2382,1300,65,11400,12700,"Sub-basin 3"
2383,200,4,3500,3700,"Sub-basin 3"
2384,6800,504.17,66700,73500,"Sub-basin 3"
2385,200,5,2600,2800,"Sub-basin 3"
2386,700,21,12300,13000,"Sub-basin 3"
2387,200,8,3800,4000,"Sub-basin 3"
2388,1600,469.17,1500,3100,"Sub-basin 3"
2389,800,68,1900,2700,"Sub-basin 3"
2390,2700,203,21400,24100,"Sub-basin 3"
2391,200,4,3100,3300,"Sub-basin 3"
2392,200,5,2200,2400,"Sub-basin 3"
2393,5200,277,30200,35400,"Sub-basin 3"
2394,100,2,2100,2200,"Sub-basin 3"
2395,200,2,6900,7100,"Sub-basin 3"
2396,100,2,2500,2600,"Sub-basin 3"
2397,1100,24,22200,23300,"Sub-basin 3"
2398,100,1,2200,2300,"Sub-basin 3"
2399,1000,44,12600,13600,"Sub-basin 3"
2400,400,21,3200,3600,"Sub-basin 3"
2401,200,4,600,800,"Sub-basin 3"
2402,300,9,2900,3200,"Sub-basin 3"
2403,100,2,1100,1200,"Sub-basin 3"
2404,100,1,800,900,"Sub-basin 3"
2405,2800,184,19800,22600,"Sub-basin 3"
2406,1600,107,7500,9100,"Sub-basin 3"
2407,100,3,1600,1700,"Sub-basin 3"
2408,100,1,2800,2900,"Sub-basin 3"
2409,100,1,1900,2000,"Sub-basin 3"
2410,2400,188,16100,18500,"Sub-basin 3"
2411,1100,157,5400,6500,"Sub-basin 3"
2412,100,2,700,800,"Sub-basin 3"
2413,100,1,1200,1300,"Sub-basin 3"
2414,400,26,6400,6800,"Sub-basin 3"
2415,300,9,4700,5000,"Sub-basin 3"
2416,100,2,1800,1900,"Sub-basin 3"
2417,100,2,1700,1800,"Sub-basin 3"
2418,200,4,4100,4300,"Sub-basin 3"
2419,100,1,1800,1900,"Sub-basin 3"
2420,100,2,3600,3700,"Sub-basin 3"
2421,100,2,2700,2800,"Sub-basin 3"
2422,500,7,13100,13600,"Sub-basin 3"
2423,200,14,3900,4100,"Sub-basin 3"
2424,4300,267,13200,17500,"Sub-basin 3"
2425,300,8,3300,3600,"Sub-basin 3"
2426,100,1,1200,1300,"Sub-basin 3"
2427,800,32,6100,6900,"Sub-basin 3"
2428,1900,63,40400,42300,"Sub-basin 3"
2429,500,13,12300,12800,"Sub-basin 3"
2430,12100,2443,31500,43600,"Sub-basin 3"
2431,100,1,1600,1700,"Sub-basin 3"
2432,100,5,1100,1200,"Sub-basin 3"
2433,400,59,2300,2700,"Sub-basin 3"
2434,100,1,1900,2000,"Sub-basin 3"
2435,100,2,1700,1800,"Sub-basin 3"
2436,100,2,1000,1100,"Sub-basin 3"
2437,700,29,4400,5100,"Sub-basin 3"
2438,300,16,5000,5300,"Sub-basin 3"
2439,1500,137,14200,15700,"Sub-basin 3"
2440,5300,491,34600,39900,"Sub-basin 3"
2441,200,8,1900,2100,"Sub-basin 3"
2442,900,62,5000,5900,"Sub-basin 3"
2443,100,1,900,1000,"Sub-basin 3"
2444,400,9,5700,6100,"Sub-basin 3"
2445,400,11,5900,6300,"Sub-basin 3"
2446,14500,5389,25100,39600,"Sub-basin 3"
2447,100,2,2900,3000,"Sub-basin 3"
2448,1700,218,15400,17100,"Sub-basin 3"
2449,300,6,6400,6700,"Sub-basin 3"
2450,300,5,8700,9000,"Sub-basin 3"
2451,100,3,3000,3100,"Sub-basin 3"
2452,100,1,3200,3300,"Sub-basin 3"
2453,400,45,2700,3100,"Sub-basin 3"
2454,5000,163,21500,26500,"Sub-basin 3"
2455,100,2,1100,1200,"Sub-basin 3"
2456,1100,78,7400,8500,"Sub-basin 3"
2457,16600,1400.17,81000,97600,"Sub-basin 3"
2458,100,1,2100,2200,"Sub-basin 3"
2459,100,1,2300,2400,"Sub-basin 3"
2460,200,2,1800,2000,"Sub-basin 3"
2461,400,17,3200,3600,"Sub-basin 3"
2462,200,3,4500,4700,"Sub-basin 3"
2463,500,15,7000,7500,"Sub-basin 3"
2464,1200,46,20100,21300,"Sub-basin 3"
2465,300,5,7800,8100,"Sub-basin 3"
2466,2300,217,4400,6700,"Sub-basin 3"
2467,100,1,600,700,"Sub-basin 3"
2468,800,85,5200,6000,"Sub-basin 3"
2469,14800,4943,28900,43700,"Sub-basin 3"
2470,400,48,1700,2100,"Sub-basin 3"
2471,300,4,3400,3700,"Sub-basin 3"
2472,9400,1010,40100,49500,"Sub-basin 3"
2473,100,1,2000,2100,"Sub-basin 3"
2474,100,3,2400,2500,"Sub-basin 3"
2475,1200,41,19800,21000,"Sub-basin 3"
2476,200,9,7300,7500,"Sub-basin 3"
2477,100,1,1100,1200,"Sub-basin 3"
2478,300,17,2500,2800,"Sub-basin 3"
2479,1400,245,4200,5600,"Sub-basin 3"
2480,300,5,2300,2600,"Sub-basin 3"
2481,200,7,3100,3300,"Sub-basin 3"
2482,1100,111,9200,10300,"Sub-basin 3"
2483,100,3,1000,1100,"Sub-basin 3"
2484,100,7,1800,1900,"Sub-basin 3"
2485,100,2,2300,2400,"Sub-basin 3"
2486,900,158,4100,5000,"Sub-basin 3"
2487,600,19,12800,13400,"Sub-basin 3"
2488,200,5,4900,5100,"Sub-basin 3"
2489,200,4,2200,2400,"Sub-basin 3"
2490,100,1,1700,1800,"Sub-basin 3"
2491,200,8,4200,4400,"Sub-basin 3"
2492,1300,74,13400,14700,"Sub-basin 3"
2493,400,7,13100,13500,"Sub-basin 3"
2494,200,2,4700,4900,"Sub-basin 3"
2495,100,1,2700,2800,"Sub-basin 3"
2496,600,21,7400,8000,"Sub-basin 3"
2497,200,3,8000,8200,"Sub-basin 3"
2498,100,1,2500,2600,"Sub-basin 3"
2499,200,4,4400,4600,"Sub-basin 3"
2500,200,6,3100,3300,"Sub-basin 3"
2501,100,1,2200,2300,"Sub-basin 3"
2502,100,4,1100,1200,"Sub-basin 3"
2503,700,74,3800,4500,"Sub-basin 3"
2504,500,147,1300,1800,"Sub-basin 3"
2505,500,14,2600,3100,"Sub-basin 3"
2506,100,1,1200,1300,"Sub-basin 3"
2507,100,5,3200,3300,"Sub-basin 3"
2508,100,1,2400,2500,"Sub-basin 3"
2509,200,8,3200,3400,"Sub-basin 3"
2510,1400,77,18600,20000,"Sub-basin 3"
2511,3900,226.84,31400,35300,"Sub-basin 3"
2512,100,3,1400,1500,"Sub-basin 3"
2513,100,4,1900,2000,"Sub-basin 3"
2514,100,2,1100,1200,"Sub-basin 3"
2515,11000,764,17300,28300,"Sub-basin 3"
2516,500,15,3800,4300,"Sub-basin 3"
2517,100,2,1600,1700,"Sub-basin 3"
2518,100,2,1100,1200,"Sub-basin 3"
2519,400,26,3400,3800,"Sub-basin 3"
2520,1500,347,10800,12300,"Sub-basin 3"
2521,1400,104,10100,11500,"Sub-basin 3"
2522,2200,437,16100,18300,"Sub-basin 3"
2523,300,11,3700,4000,"Sub-basin 3"
2524,800,46,5700,6500,"Sub-basin 3"
2525,200,2,1900,2100,"Sub-basin 3"
2526,500,16,4900,5400,"Sub-basin 3"
2527,100,3,3300,3400,"Sub-basin 3"
2528,100,3,2100,2200,"Sub-basin 3"
2529,100,6,3400,3500,"Sub-basin 3"
2530,100,2,3900,4000,"Sub-basin 3"
2531,3500,150,56000,59500,"Sub-basin 3"
2532,100,3,1600,1700,"Sub-basin 3"
2533,200,4,3400,3600,"Sub-basin 3"
2534,500,70,8200,8700,"Sub-basin 3"
2535,400,17,1700,2100,"Sub-basin 3"
2536,200,9,1600,1800,"Sub-basin 3"
2537,300,9,1700,2000,"Sub-basin 3"
2538,200,4,1500,1700,"Sub-basin 3"
2539,200,3,6500,6700,"Sub-basin 3"
2540,100,1,800,900,"Sub-basin 3"
2541,300,6,2800,3100,"Sub-basin 3"
2542,100,3,1000,1100,"Sub-basin 3"
2543,500,30,5300,5800,"Sub-basin 3"
2544,400,25,5000,5400,"Sub-basin 3"
2545,100,1,2400,2500,"Sub-basin 3"
2546,100,2,2400,2500,"Sub-basin 3"
2547,200,2,4200,4400,"Sub-basin 3"
2548,200,4,6800,7000,"Sub-basin 3"
2549,200,5,6200,6400,"Sub-basin 3"
2550,200,2,4800,5000,"Sub-basin 3"
2551,100,2,1100,1200,"Sub-basin 3"
2552,100,5,1200,1300,"Sub-basin 3"
2553,100,2,1600,1700,"Sub-basin 3"
2554,100,3,1200,1300,"Sub-basin 3"
2555,100,4,800,900,"Sub-basin 3"
2556,100,2,1600,1700,"Sub-basin 3"
2557,800,23,12800,13600,"Sub-basin 3"
2558,400,12,4600,5000,"Sub-basin 3"
2559,200,6,4100,4300,"Sub-basin 3"
2560,800,41,4600,5400,"Sub-basin 3"
2561,100,1,1000,1100,"Sub-basin 3"
2562,3900,414,26500,30400,"Sub-basin 3"
2563,1300,48,20200,21500,"Sub-basin 3"
2564,1700,157,17300,19000,"Sub-basin 3"
2565,100,1,2400,2500,"Sub-basin 3"
2566,100,2,3900,4000,"Sub-basin 3"
2567,100,1,1700,1800,"Sub-basin 3"
2568,100,2,1900,2000,"Sub-basin 3"
2569,100,3,1300,1400,"Sub-basin 3"
2570,100,3,1800,1900,"Sub-basin 3"
2571,3300,961,9100,12400,"Sub-basin 3"
2572,200,17,1400,1600,"Sub-basin 3"
2573,200,7,4300,4500,"Sub-basin 3"
2574,2100,124,20100,22200,"Sub-basin 3"
2575,400,14,5600,6000,"Sub-basin 3"
2576,1900,483,9900,11800,"Sub-basin 3"
2577,100,7,800,900,"Sub-basin 3"
2578,200,3,1800,2000,"Sub-basin 3"
2579,300,23,3500,3800,"Sub-basin 3"
2580,700,21,3700,4400,"Sub-basin 3"
2581,100,1,2300,2400,"Sub-basin 3"
2582,1600,226,8800,10400,"Sub-basin 3"
2583,200,3,4700,4900,"Sub-basin 3"
2584,100,5,900,1000,"Sub-basin 3"
2585,100,3,1900,2000,"Sub-basin 3"
2586,300,4,3200,3500,"Sub-basin 3"
2587,100,2,2000,2100,"Sub-basin 3"
2588,500,6,10700,11200,"Sub-basin 3"
2589,500,17,10900,11400,"Sub-basin 3"
2590,200,4,4100,4300,"Sub-basin 3"
2591,100,1,2300,2400,"Sub-basin 3"
2592,500,10,4800,5300,"Sub-basin 3"
2593,700,108,4500,5200,"Sub-basin 3"
2594,600,68,1300,1900,"Sub-basin 3"
2595,1100,55,8400,9500,"Sub-basin 3"
2596,400,25,5700,6100,"Sub-basin 3"
2597,100,1,800,900,"Sub-basin 3"
2598,100,1,3300,3400,"Sub-basin 3"
2599,400,9,9800,10200,"Sub-basin 3"
2600,100,3,3700,3800,"Sub-basin 3"
2601,300,10,4000,4300,"Sub-basin 3"
2602,300,8,3300,3600,"Sub-basin 3"
2603,100,2,1000,1100,"Sub-basin 3"
2604,800,16,6000,6800,"Sub-basin 3"
2605,1000,69,6900,7900,"Sub-basin 3"
2606,600,36,4900,5500,"Sub-basin 3"
2607,300,5,6400,6700,"Sub-basin 3"
2608,800,60,4900,5700,"Sub-basin 3"
2609,600,14,6900,7500,"Sub-basin 3"
2610,100,5,4400,4500,"Sub-basin 3"
2611,300,9,4100,4400,"Sub-basin 3"
2612,200,9,4600,4800,"Sub-basin 3"
2613,400,18,4600,5000,"Sub-basin 3"
2614,1200,86,17000,18200,"Sub-basin 3"
2615,3400,157,19600,23000,"Sub-basin 3"
2616,100,2,1300,1400,"Sub-basin 3"
2617,200,5,1100,1300,"Sub-basin 3"
2618,400,13,3200,3600,"Sub-basin 3"
2619,200,20,2900,3100,"Sub-basin 3"
2620,900,41,12400,13300,"Sub-basin 3"
2621,100,2,800,900,"Sub-basin 3"
2622,300,8,7500,7800,"Sub-basin 3"
2623,100,1,1700,1800,"Sub-basin 3"
2624,900,55,10100,11000,"Sub-basin 3"
2625,200,5,4300,4500,"Sub-basin 3"
2626,300,10,10600,10900,"Sub-basin 3"
2627,7500,480.67,21300,28800,"Sub-basin 3"
2628,3900,121,25300,29200,"Sub-basin 3"
2629,100,1,400,500,"Sub-basin 3"
2630,100,1,400,500,"Sub-basin 3"
2631,1900,123,11400,13300,"Sub-basin 3"
2632,100,1,1200,1300,"Sub-basin 3"
2633,400,10,3500,3900,"Sub-basin 3"
2634,100,2,1000,1100,"Sub-basin 3"
2635,100,2,1600,1700,"Sub-basin 3"
2636,100,2,4400,4500,"Sub-basin 3"
2637,200,6,4800,5000,"Sub-basin 3"
2638,400,19,7800,8200,"Sub-basin 3"
2639,100,3,800,900,"Sub-basin 3"
2640,100,4,600,700,"Sub-basin 3"
2641,700,46,3600,4300,"Sub-basin 3"
2642,1300,61,10400,11700,"Sub-basin 3"
2643,300,6,2400,2700,"Sub-basin 3"
2644,800,31,9200,10000,"Sub-basin 3"
2645,100,1,2200,2300,"Sub-basin 3"
2646,200,2,3600,3800,"Sub-basin 3"
2647,300,11,4600,4900,"Sub-basin 3"
2648,200,5,3900,4100,"Sub-basin 3"
2649,400,10,9900,10300,"Sub-basin 3"
2650,100,2,4400,4500,"Sub-basin 3"
2651,900,135,3900,4800,"Sub-basin 3"
2652,800,23,8100,8900,"Sub-basin 3"
2653,500,40,8600,9100,"Sub-basin 3"
2654,16700,4065.66,39600,56300,"Sub-basin 3"
2655,100,1,200,300,"Sub-basin 3"
2656,300,6,8400,8700,"Sub-basin 3"
2657,200,5,3900,4100,"Sub-basin 3"
2658,400,50,2500,2900,"Sub-basin 3"
2659,100,1,1300,1400,"Sub-basin 3"
2660,200,3,3800,4000,"Sub-basin 3"
2661,100,2,2500,2600,"Sub-basin 3"
2662,100,2,3700,3800,"Sub-basin 3"
2663,200,11,6800,7000,"Sub-basin 3"
2664,600,18,19100,19700,"Sub-basin 3"
2665,200,4,6000,6200,"Sub-basin 3"
2666,5000,416,34200,39200,"Sub-basin 3"
2667,300,4,6600,6900,"Sub-basin 3"
2668,100,1,2000,2100,"Sub-basin 3"
2669,400,10,7200,7600,"Sub-basin 3"
2670,27400,1450.17,158000,185400,"Sub-basin 3"
2671,300,8,5000,5300,"Sub-basin 3"
2672,3300,182,12300,15600,"Sub-basin 3"
2673,2100,100,10700,12800,"Sub-basin 3"
2674,100,4,1400,1500,"Sub-basin 3"
2675,200,12,900,1100,"Sub-basin 3"
2676,300,5,2200,2500,"Sub-basin 3"
2677,500,18,8600,9100,"Sub-basin 3"
2678,100,0.33,2700,2800,"Sub-basin 3"
2679,800,31.17,11900,12700,"Sub-basin 3"
2680,12400,748.67,104700,117100,"Sub-basin 3"
2681,300,8.51,4500,4800,"Sub-basin 3"
2682,300,11,2100,2400,"Sub-basin 3"
2683,400,54,3500,3900,"Sub-basin 3"
2684,300,9,3000,3300,"Sub-basin 3"
2685,100,1,600,700,"Sub-basin 3"
2686,100,1,800,900,"Sub-basin 3"
2687,7700,893.67,21300,29000,"Sub-basin 3"
2688,700,87,3500,4200,"Sub-basin 3"
2689,4200,801.67,13400,17600,"Sub-basin 3"
2690,600,359.67,5800,6400,"Sub-basin 3"
2691,700,143.16,6100,6800,"Sub-basin 3"
2692,100,2,1000,1100,"Sub-basin 3"
2693,500,17.33,5900,6400,"Sub-basin 3"
2694,1300,52,11600,12900,"Sub-basin 3"
2695,300,7,2400,2700,"Sub-basin 3"
2696,400,9,9000,9400,"Sub-basin 3"
2697,100,2,2200,2300,"Sub-basin 3"
2698,100,3,2100,2200,"Sub-basin 3"
2699,500,100.84,1100,1600,"Sub-basin 3"
2700,300,9,1900,2200,"Sub-basin 3"
2701,3000,538,9500,12500,"Sub-basin 3"
2702,100,1,500,600,"Sub-basin 3"
2703,5700,1558.49,14200,19900,"Sub-basin 3"
2704,800,109,4200,5000,"Sub-basin 3"
2705,100,2,1200,1300,"Sub-basin 3"
2706,400,19.35,1800,2200,"Sub-basin 3"
2707,700,43,5600,6300,"Sub-basin 3"
2708,800,41,7100,7900,"Sub-basin 3"
2709,300,7,4600,4900,"Sub-basin 3"
2710,100,3,2800,2900,"Sub-basin 3"
2711,100,2,400,500,"Sub-basin 3"
2712,900,32,6700,7600,"Sub-basin 3"
2713,200,4,3600,3800,"Sub-basin 3"
2714,400,36,5300,5700,"Sub-basin 3"
2715,400,9,6000,6400,"Sub-basin 3"
2716,900,34,8500,9400,"Sub-basin 3"
2717,100,1,1000,1100,"Sub-basin 3"
2718,300,5,4100,4400,"Sub-basin 3"
2719,200,5,2100,2300,"Sub-basin 3"
2720,100,1,3500,3600,"Sub-basin 3"
2721,200,3,4200,4400,"Sub-basin 3"
2722,600,12,10800,11400,"Sub-basin 3"
2723,100,1,1900,2000,"Sub-basin 3"
2724,100,1,1600,1700,"Sub-basin 3"
2725,500,19,4500,5000,"Sub-basin 3"
2726,2200,122,19000,21200,"Sub-basin 3"
2727,2300,81,13800,16100,"Sub-basin 3"
2728,100,64,900,1000,"Sub-basin 3"
2729,200,103,700,900,"Sub-basin 3"
2730,100,2,2500,2600,"Sub-basin 3"
2731,900,30,10100,11000,"Sub-basin 3"
2732,300,17,1000,1300,"Sub-basin 3"
2733,1900,83,14900,16800,"Sub-basin 3"
2734,100,1,3500,3600,"Sub-basin 3"
2735,100,1,2000,2100,"Sub-basin 3"
2736,100,4,900,1000,"Sub-basin 3"
2737,400,10,4100,4500,"Sub-basin 3"
2738,100,1,1100,1200,"Sub-basin 3"
2739,100,1,800,900,"Sub-basin 3"
2740,400,4,3400,3800,"Sub-basin 3"
2741,400,14,4400,4800,"Sub-basin 3"
2742,100,8,1700,1800,"Sub-basin 3"
2743,600,13,7200,7800,"Sub-basin 3"
2744,100,2,2500,2600,"Sub-basin 3"
2745,300,5,5300,5600,"Sub-basin 3"
2746,600,17,10700,11300,"Sub-basin 3"
2747,100,1,3300,3400,"Sub-basin 3"
2748,100,4,3300,3400,"Sub-basin 3"
2749,200,4,2300,2500,"Sub-basin 3"
2750,3600,717,10900,14500,"Sub-basin 3"
2751,100,2,1100,1200,"Sub-basin 3"
2752,800,59,4900,5700,"Sub-basin 3"
2753,200,4,4300,4500,"Sub-basin 3"
2754,2300,140,26500,28800,"Sub-basin 3"
2755,300,8,1300,1600,"Sub-basin 3"
2756,400,13,6200,6600,"Sub-basin 3"
2757,1400,132,7800,9200,"Sub-basin 3"
2758,100,2,2400,2500,"Sub-basin 3"
2759,100,1,2800,2900,"Sub-basin 3"
2760,100,2,2600,2700,"Sub-basin 3"
2761,400,9,5000,5400,"Sub-basin 3"
2762,100,1,2100,2200,"Sub-basin 3"
2763,500,16,6000,6500,"Sub-basin 3"
2764,300,3,3600,3900,"Sub-basin 3"
2765,200,10,1400,1600,"Sub-basin 3"
2766,200,48,2800,3000,"Sub-basin 3"
2767,100,2,1200,1300,"Sub-basin 3"
2768,100,4,1900,2000,"Sub-basin 3"
2769,200,3,1900,2100,"Sub-basin 3"
2770,400,8,4100,4500,"Sub-basin 3"
2771,100,1,2000,2100,"Sub-basin 3"
2772,100,1,4800,4900,"Sub-basin 3"
2773,100,1,1400,1500,"Sub-basin 3"
2774,100,1,2100,2200,"Sub-basin 3"
2775,400,13,3600,4000,"Sub-basin 3"
2776,200,21,1300,1500,"Sub-basin 3"
2777,100,2,100,200,"Sub-basin 3"
2778,1200,67,11500,12700,"Sub-basin 3"
2779,1200,33,13900,15100,"Sub-basin 3"
2780,100,2,1300,1400,"Sub-basin 3"
2781,100,2,1800,1900,"Sub-basin 3"
2782,100,3,1300,1400,"Sub-basin 3"
2783,100,2,2000,2100,"Sub-basin 3"
2784,200,3,1300,1500,"Sub-basin 3"
2785,800,75,5000,5800,"Sub-basin 3"
2786,500,15,4600,5100,"Sub-basin 3"
2787,300,11,3500,3800,"Sub-basin 3"
2788,200,2,2000,2200,"Sub-basin 3"
2789,500,30,4300,4800,"Sub-basin 3"
2790,600,29,7800,8400,"Sub-basin 3"
2791,100,2,3100,3200,"Sub-basin 3"
2792,100,1,2000,2100,"Sub-basin 3"
2793,1400,50,23900,25300,"Sub-basin 3"
2794,3800,117,31200,35000,"Sub-basin 3"
2795,400,12,1900,2300,"Sub-basin 3"
2796,200,9,2000,2200,"Sub-basin 3"
2797,100,2,1800,1900,"Sub-basin 3"
2798,400,11,3500,3900,"Sub-basin 3"
2799,100,4,1600,1700,"Sub-basin 3"
2800,200,6,2400,2600,"Sub-basin 3"
2801,200,6,2300,2500,"Sub-basin 3"
2802,100,1,2100,2200,"Sub-basin 3"
2803,8500,619,89500,98000,"Sub-basin 3"
2804,11600,1568,88100,99700,"Sub-basin 3"
2805,300,6,8700,9000,"Sub-basin 3"
2806,300,10,5400,5700,"Sub-basin 3"
2807,1300,72,11100,12400,"Sub-basin 3"
2808,100,1,700,800,"Sub-basin 3"
2809,200,9,1800,2000,"Sub-basin 3"
2810,100,2,700,800,"Sub-basin 3"
2811,1400,347,3900,5300,"Sub-basin 3"
2812,300,4,5700,6000,"Sub-basin 3"
2813,100,1,1100,1200,"Sub-basin 3"
2814,700,33,8000,8700,"Sub-basin 3"
2815,1100,105,5600,6700,"Sub-basin 3"
2816,300,6,2800,3100,"Sub-basin 3"
2817,600,14,12800,13400,"Sub-basin 3"
2818,300,6,8200,8500,"Sub-basin 3"
2819,200,3,7200,7400,"Sub-basin 3"
2820,1500,150,25900,27400,"Sub-basin 3"
2821,600,48,2800,3400,"Sub-basin 3"
2822,8200,548,41600,49800,"Sub-basin 3"
2823,100,1,1300,1400,"Sub-basin 3"
2824,24200,3040,107500,131700,"Sub-basin 3"
2825,100,1,1200,1300,"Sub-basin 3"
2826,100,1,1300,1400,"Sub-basin 3"
2827,100,24,800,900,"Sub-basin 3"
2828,100,16,1000,1100,"Sub-basin 3"
2829,100,6,1400,1500,"Sub-basin 3"
2830,5400,610,30200,35600,"Sub-basin 3"
2831,100,4,3700,3800,"Sub-basin 3"
2832,500,15,5400,5900,"Sub-basin 3"
2833,200,3,4700,4900,"Sub-basin 3"
2834,100,1,1800,1900,"Sub-basin 3"
2835,300,6,2800,3100,"Sub-basin 3"
2836,3100,360,31800,34900,"Sub-basin 3"
2837,200,4,900,1100,"Sub-basin 3"
2838,300,9,3600,3900,"Sub-basin 3"
2839,100,4,1400,1500,"Sub-basin 3"
2840,1800,191,18300,20100,"Sub-basin 3"
2841,100,2,3100,3200,"Sub-basin 3"
2842,100,1,500,600,"Sub-basin 3"
2843,200,4,2200,2400,"Sub-basin 3"
2844,600,29,8600,9200,"Sub-basin 3"
2845,100,2,6100,6200,"Sub-basin 3"
2846,200,4,4300,4500,"Sub-basin 3"
2847,100,1,1700,1800,"Sub-basin 3"
2848,1700,59,7700,9400,"Sub-basin 3"
2849,100,1,700,800,"Sub-basin 3"
2850,200,3.66,1700,1900,"Sub-basin 3"
2851,100,1,1100,1200,"Sub-basin 3"
2852,100,2,0,100,"Sub-basin 3"
2853,5800,675.33,24200,30000,"Sub-basin 3"
2854,100,2,1800,1900,"Sub-basin 3"
2855,100,1,1100,1200,"Sub-basin 3"
2856,900,90,5800,6700,"Sub-basin 3"
2857,200,2,2800,3000,"Sub-basin 3"
2858,200,3,3700,3900,"Sub-basin 3"
2859,100,3,2200,2300,"Sub-basin 3"
2860,3900,564,17200,21100,"Sub-basin 3"
2861,1100,66,7800,8900,"Sub-basin 3"
2862,1200,53,9800,11000,"Sub-basin 3"
2863,100,3,2800,2900,"Sub-basin 3"
2864,400,13,13000,13400,"Sub-basin 3"
2865,200,20,3300,3500,"Sub-basin 3"
2866,1600,77,11800,13400,"Sub-basin 3"
2867,100,1,900,1000,"Sub-basin 3"
2868,400,11,5700,6100,"Sub-basin 3"
2869,100,1,1300,1400,"Sub-basin 3"
2870,1300,44,8700,10000,"Sub-basin 3"
2871,700,61,3800,4500,"Sub-basin 3"
2872,300,8,1600,1900,"Sub-basin 3"
2873,500,59,5000,5500,"Sub-basin 3"
2874,1800,286,8200,10000,"Sub-basin 3"
2875,1400,153,7900,9300,"Sub-basin 3"
2876,200,5,1900,2100,"Sub-basin 3"
2877,100,1,1800,1900,"Sub-basin 3"
2878,200,9,4000,4200,"Sub-basin 3"
2879,400,9,3500,3900,"Sub-basin 3"
2880,1000,40.5,31800,32800,"Sub-basin 3"
2881,400,16,3300,3700,"Sub-basin 3"
2882,500,8,13500,14000,"Sub-basin 3"
2883,100,5,1100,1200,"Sub-basin 3"
2884,200,6,2500,2700,"Sub-basin 3"
2885,200,3,1800,2000,"Sub-basin 3"
2886,1000,38,7300,8300,"Sub-basin 3"
2887,700,53,3800,4500,"Sub-basin 3"
2888,1100,996,2900,4000,"Sub-basin 3"
2889,500,52,5800,6300,"Sub-basin 3"
2890,100,2,1000,1100,"Sub-basin 3"
2891,100,1,3000,3100,"Sub-basin 3"
2892,100,1,1900,2000,"Sub-basin 3"
2893,7600,752,27400,35000,"Sub-basin 3"
2894,200,11,2100,2300,"Sub-basin 3"
2895,3300,225,42300,45600,"Sub-basin 3"
2896,100,1,3400,3500,"Sub-basin 3"
2897,300,5,8600,8900,"Sub-basin 3"
2898,100,2,800,900,"Sub-basin 3"
2899,300,13,2800,3100,"Sub-basin 3"
2900,2900,1397,4800,7700,"Sub-basin 3"
2901,100,1,1700,1800,"Sub-basin 3"
2902,6700,551,23100,29800,"Sub-basin 3"
2903,200,12,1700,1900,"Sub-basin 3"
2904,1700,273,5600,7300,"Sub-basin 3"
2905,100,2,600,700,"Sub-basin 3"
2906,600,104,6200,6800,"Sub-basin 3"
2907,100,5,2000,2100,"Sub-basin 3"
2908,300,13,4000,4300,"Sub-basin 3"
2909,400,10,6500,6900,"Sub-basin 3"
2910,200,6,4400,4600,"Sub-basin 3"
2911,100,1,2300,2400,"Sub-basin 3"
2912,600,57,3400,4000,"Sub-basin 3"
2913,100,3,1700,1800,"Sub-basin 3"
2914,200,4,2100,2300,"Sub-basin 3"
2915,400,8,11400,11800,"Sub-basin 3"
2916,500,12,3600,4100,"Sub-basin 3"
2917,400,5,1600,2000,"Sub-basin 3"
2918,500,22,3000,3500,"Sub-basin 3"
2919,100,10,1700,1800,"Sub-basin 3"
2920,100,1,2300,2400,"Sub-basin 3"
2921,500,30,4000,4500,"Sub-basin 3"
2922,100,2,2700,2800,"Sub-basin 3"
2923,100,2,2000,2100,"Sub-basin 3"
2924,500,12,12000,12500,"Sub-basin 3"
2925,100,4,1500,1600,"Sub-basin 3"
2926,300,5,3200,3500,"Sub-basin 3"
2927,400,9,1600,2000,"Sub-basin 3"
2928,600,17,4500,5100,"Sub-basin 3"
2929,700,33,6200,6900,"Sub-basin 3"
2930,100,3,800,900,"Sub-basin 3"
2931,100,3,3100,3200,"Sub-basin 3"
2932,600,53,6700,7300,"Sub-basin 3"
2933,100,6,2100,2200,"Sub-basin 3"
2934,300,21,2600,2900,"Sub-basin 3"
2935,400,5,5700,6100,"Sub-basin 3"
2936,100,1,1800,1900,"Sub-basin 3"
2937,100,2,2100,2200,"Sub-basin 3"
2938,100,3,1700,1800,"Sub-basin 3"
2939,200,3,1900,2100,"Sub-basin 3"
2940,100,1,3100,3200,"Sub-basin 3"
2941,200,5,4700,4900,"Sub-basin 3"
2942,800,29,13300,14100,"Sub-basin 3"
2943,100,1,2600,2700,"Sub-basin 3"
2944,800,17,13100,13900,"Sub-basin 3"
2945,100,2,3400,3500,"Sub-basin 3"
2946,300,14,6700,7000,"Sub-basin 3"
2947,100,1,1700,1800,"Sub-basin 3"
2948,400,17,1000,1400,"Sub-basin 3"
2949,200,13,2800,3000,"Sub-basin 3"
2950,100,1,800,900,"Sub-basin 3"
2951,100,3,1100,1200,"Sub-basin 3"
2952,100,1,3600,3700,"Sub-basin 3"
2953,200,4,4500,4700,"Sub-basin 3"
2954,100,1,2200,2300,"Sub-basin 3"
2955,300,7,2200,2500,"Sub-basin 3"
2956,100,2,1600,1700,"Sub-basin 3"
2957,100,1,700,800,"Sub-basin 3"
2958,100,1,2000,2100,"Sub-basin 3"
2959,100,1,2300,2400,"Sub-basin 3"
2960,1300,76,25900,27200,"Sub-basin 3"
2961,1100,61,18900,20000,"Sub-basin 3"
2962,200,6,4700,4900,"Sub-basin 3"
2963,100,1,5700,5800,"Sub-basin 3"
2964,1000,48,11100,12100,"Sub-basin 3"
2965,200,2,2000,2200,"Sub-basin 3"
2966,200,6,3300,3500,"Sub-basin 3"
2967,400,10,7900,8300,"Sub-basin 3"
2968,500,40,7400,7900,"Sub-basin 3"
2969,500,20,9500,10000,"Sub-basin 3"
2970,1200,126,13700,14900,"Sub-basin 3"
2971,500,19,6400,6900,"Sub-basin 3"
2972,100,1,2300,2400,"Sub-basin 3"
2973,500,31,4700,5200,"Sub-basin 3"
2974,1200,212,5000,6200,"Sub-basin 3"
2975,400,9,3500,3900,"Sub-basin 3"
2976,200,4,1600,1800,"Sub-basin 3"
2977,2400,750,6600,9000,"Sub-basin 3"
2978,300,8,6300,6600,"Sub-basin 3"
2979,100,2,1500,1600,"Sub-basin 3"
2980,2100,319,7800,9900,"Sub-basin 3"
2981,800,65,2500,3300,"Sub-basin 3"
2982,600,18,11200,11800,"Sub-basin 3"
2983,100,3,1800,1900,"Sub-basin 3"
2984,400,10,10700,11100,"Sub-basin 3"
2985,100,1,2400,2500,"Sub-basin 3"
2986,900,31,10100,11000,"Sub-basin 3"
2987,200,11,800,1000,"Sub-basin 3"
2988,300,7,1500,1800,"Sub-basin 3"
2989,300,15,1500,1800,"Sub-basin 3"
2990,100,7,900,1000,"Sub-basin 3"
2991,200,3,3400,3600,"Sub-basin 3"
2992,500,25,4900,5400,"Sub-basin 3"
2993,100,1,2500,2600,"Sub-basin 3"
2994,100,2,1400,1500,"Sub-basin 3"
2995,100,3,1800,1900,"Sub-basin 3"
2996,100,1,1400,1500,"Sub-basin 3"
2997,100,3,2600,2700,"Sub-basin 3"
2998,500,18,5100,5600,"Sub-basin 3"
2999,100,1,1600,1700,"Sub-basin 3"
3000,100,1,4100,4200,"Sub-basin 3"
3001,400,37,7900,8300,"Sub-basin 3"
3002,100,3,3100,3200,"Sub-basin 3"
3003,600,39,4400,5000,"Sub-basin 3"
3004,200,5,1600,1800,"Sub-basin 3"
3005,8400,284.2941,74400,82800,"Sub-basin 3"
3006,100,3,1700,1800,"Sub-basin 3"
3007,100,2,2800,2900,"Sub-basin 3"
3008,100,3,1800,1900,"Sub-basin 3"
3009,1000,39,12300,13300,"Sub-basin 3"
3010,200,4,3500,3700,"Sub-basin 3"
3011,700,14,5600,6300,"Sub-basin 3"
3012,100,1,1300,1400,"Sub-basin 3"
3013,300,7,3200,3500,"Sub-basin 3"
3014,400,6,2200,2600,"Sub-basin 3"
3015,900,94,6100,7000,"Sub-basin 3"
3016,1000,36,22800,23800,"Sub-basin 3"
3017,200,4,2700,2900,"Sub-basin 3"
3018,300,10,8600,8900,"Sub-basin 3"
3019,800,32,24000,24800,"Sub-basin 3"
3020,600,28,8400,9000,"Sub-basin 3"
3021,400,9,6300,6700,"Sub-basin 3"
3022,100,1,1900,2000,"Sub-basin 3"
3023,400,11,5700,6100,"Sub-basin 3"
3024,1200,118,7000,8200,"Sub-basin 3"
3025,300,19,1700,2000,"Sub-basin 3"
3026,100,3,1400,1500,"Sub-basin 3"
3027,100,3,3000,3100,"Sub-basin 3"
3028,300,8,9800,10100,"Sub-basin 3"
3029,100,2,2800,2900,"Sub-basin 3"
3030,100,2,3800,3900,"Sub-basin 3"
3031,300,7,5500,5800,"Sub-basin 3"
3032,200,11,2900,3100,"Sub-basin 3"
3033,200,27,200,400,"Sub-basin 3"
3034,900,83,2300,3200,"Sub-basin 3"
3035,600,18,7200,7800,"Sub-basin 3"
3036,200,3,1200,1400,"Sub-basin 3"
3037,300,10,2400,2700,"Sub-basin 3"
3038,200,6,2700,2900,"Sub-basin 3"
3039,4600,281,45500,50100,"Sub-basin 3"
3040,300,98,3000,3300,"Sub-basin 3"
3041,100,4,800,900,"Sub-basin 3"
3042,300,10,3200,3500,"Sub-basin 3"
3043,100,1,1300,1400,"Sub-basin 3"
3044,200,11,1800,2000,"Sub-basin 3"
3045,100,2,1800,1900,"Sub-basin 3"
3046,100,1,2900,3000,"Sub-basin 3"
3047,200,10,4100,4300,"Sub-basin 3"
3048,100,2,1600,1700,"Sub-basin 3"
3049,100,1,1700,1800,"Sub-basin 3"
3050,400,35,600,1000,"Sub-basin 3"
3051,300,3,2200,2500,"Sub-basin 3"
3052,100,1,1500,1600,"Sub-basin 3"
3053,300,4,2200,2500,"Sub-basin 3"
3054,200,4,4600,4800,"Sub-basin 3"
3055,100,3,3300,3400,"Sub-basin 3"
3056,100,1,3000,3100,"Sub-basin 3"
3057,100,1,1700,1800,"Sub-basin 3"
3058,100,1,1400,1500,"Sub-basin 3"
3059,100,2,1300,1400,"Sub-basin 3"
3060,200,5,1900,2100,"Sub-basin 3"
3061,100,6,1500,1600,"Sub-basin 3"
3062,100,2,1100,1200,"Sub-basin 3"
3063,2500,312,34900,37400,"Sub-basin 3"
3064,200,15,3300,3500,"Sub-basin 3"
3065,400,28,4400,4800,"Sub-basin 3"
3066,200,3,1400,1600,"Sub-basin 3"
3067,500,26,4600,5100,"Sub-basin 3"
3068,200,4,5500,5700,"Sub-basin 3"
3069,200,2,2400,2600,"Sub-basin 3"
3070,100,1,2300,2400,"Sub-basin 3"
3071,100,2,2500,2600,"Sub-basin 3"
3072,300,82,1400,1700,"Sub-basin 3"
3073,200,4,1900,2100,"Sub-basin 3"
3074,200,7,2300,2500,"Sub-basin 3"
3075,500,36,3400,3900,"Sub-basin 3"
3076,1400,76,12600,14000,"Sub-basin 3"
3077,700,80,4600,5300,"Sub-basin 3"
3078,400,11,11100,11500,"Sub-basin 3"
3079,100,1,1800,1900,"Sub-basin 3"
3080,1400,203,7800,9200,"Sub-basin 3"
3081,500,14,4000,4500,"Sub-basin 3"
3082,100,1,1200,1300,"Sub-basin 3"
3083,300,7,3100,3400,"Sub-basin 3"
3084,200,15,1200,1400,"Sub-basin 3"
3085,100,1,1400,1500,"Sub-basin 3"
3086,200,3,1800,2000,"Sub-basin 3"
3087,100,1,2300,2400,"Sub-basin 3"
3088,11300,526,106600,117900,"Sub-basin 3"
3089,2600,83,38700,41300,"Sub-basin 3"
3090,700,18,6900,7600,"Sub-basin 3"
3091,500,12,5700,6200,"Sub-basin 3"
3092,400,11,2900,3300,"Sub-basin 3"
3093,100,3,1000,1100,"Sub-basin 3"
3094,100,2,1700,1800,"Sub-basin 3"
3095,800,26,8700,9500,"Sub-basin 3"
3096,700,33,12300,13000,"Sub-basin 3"
3097,1200,39,14700,15900,"Sub-basin 3"
3098,500,8,12700,13200,"Sub-basin 3"
3099,1400,74,10000,11400,"Sub-basin 3"
3100,900,66,7400,8300,"Sub-basin 3"
3101,200,2,3300,3500,"Sub-basin 3"
3102,6200,436,59000,65200,"Sub-basin 3"
3103,900,62,10300,11200,"Sub-basin 3"
3104,500,22,2100,2600,"Sub-basin 3"
3105,100,2,1000,1100,"Sub-basin 3"
3106,300,8,5500,5800,"Sub-basin 3"
3107,100,1,2200,2300,"Sub-basin 3"
3108,2400,130,27800,30200,"Sub-basin 3"
3109,100,1,1400,1500,"Sub-basin 3"
3110,400,7,2400,2800,"Sub-basin 3"
3111,500,16,4300,4800,"Sub-basin 3"
3112,100,2,1400,1500,"Sub-basin 3"
3113,600,18,5000,5600,"Sub-basin 3"
3114,100,1,1200,1300,"Sub-basin 3"
3115,200,2,2900,3100,"Sub-basin 3"
3116,200,8,2200,2400,"Sub-basin 3"
3117,100,2,1600,1700,"Sub-basin 3"
3118,1300,93,8900,10200,"Sub-basin 3"
3119,100,1,800,900,"Sub-basin 3"
3120,800,122,8600,9400,"Sub-basin 3"
3121,200,4,3400,3600,"Sub-basin 3"
3122,100,4,1700,1800,"Sub-basin 3"
3123,100,1,1000,1100,"Sub-basin 3"
3124,100,7,2300,2400,"Sub-basin 3"
3125,200,3,3600,3800,"Sub-basin 3"
3126,200,3,2400,2600,"Sub-basin 3"
3127,100,3,2300,2400,"Sub-basin 3"
3128,200,3,4700,4900,"Sub-basin 3"
3129,300,7,7100,7400,"Sub-basin 3"
3130,400,35,3500,3900,"Sub-basin 3"
3131,300,41,3400,3700,"Sub-basin 3"
3132,200,5,1700,1900,"Sub-basin 3"
3133,100,3,1700,1800,"Sub-basin 3"
3134,100,2,1700,1800,"Sub-basin 3"
3135,100,2,2000,2100,"Sub-basin 3"
3136,200,3,5200,5400,"Sub-basin 3"
3137,1300,115,18100,19400,"Sub-basin 3"
3138,100,1,3600,3700,"Sub-basin 3"
3139,200,6,3500,3700,"Sub-basin 3"
3140,200,3,3800,4000,"Sub-basin 3"
3141,100,4,2000,2100,"Sub-basin 3"
3142,100,3,1800,1900,"Sub-basin 3"
3143,300,18,400,700,"Sub-basin 3"
3144,200,2,2500,2700,"Sub-basin 3"
3145,100,1,2300,2400,"Sub-basin 3"
3146,400,46,2700,3100,"Sub-basin 3"
3147,100,4,1500,1600,"Sub-basin 3"
3148,200,4,3900,4100,"Sub-basin 3"
3149,100,4,3100,3200,"Sub-basin 3"
3150,200,7,6200,6400,"Sub-basin 3"
3151,100,1,3100,3200,"Sub-basin 3"
3152,100,1,3500,3600,"Sub-basin 3"
3153,600,34,3800,4400,"Sub-basin 3"
3154,100,4,1400,1500,"Sub-basin 3"
3155,100,1,2400,2500,"Sub-basin 3"
3156,100,5,2200,2300,"Sub-basin 3"
3157,100,1,2300,2400,"Sub-basin 3"
3158,100,6,2900,3000,"Sub-basin 3"
3159,100,1,2300,2400,"Sub-basin 3"
3160,800,23,11500,12300,"Sub-basin 3"
3161,600,25,7600,8200,"Sub-basin 3"
3162,100,1,1200,1300,"Sub-basin 3"
3163,100,3,1700,1800,"Sub-basin 3"
3164,3000,232,27300,30300,"Sub-basin 3"
3165,1900,311,14100,16000,"Sub-basin 3"
3166,400,21,5500,5900,"Sub-basin 3"
3167,100,12,2600,2700,"Sub-basin 3"
3168,700,43,1900,2600,"Sub-basin 3"
3169,300,9,2900,3200,"Sub-basin 3"
3170,9500,872,95400,104900,"Sub-basin 3"
3171,1900,72,8300,10200,"Sub-basin 3"
3172,400,6,3300,3700,"Sub-basin 3"
3173,100,1,2400,2500,"Sub-basin 3"
3174,3400,311,30100,33500,"Sub-basin 3"
3175,200,5,2000,2200,"Sub-basin 3"
3176,200,4,2300,2500,"Sub-basin 3"
3177,100,2,1500,1600,"Sub-basin 3"
3178,900,58,13700,14600,"Sub-basin 3"
3179,100,1,3900,4000,"Sub-basin 3"
3180,1800,87,26500,28300,"Sub-basin 3"
3181,100,2,1000,1100,"Sub-basin 3"
3182,2200,108,31300,33500,"Sub-basin 3"
3183,100,1,1200,1300,"Sub-basin 3"
3184,400,10,2300,2700,"Sub-basin 3"
3185,200,3,3500,3700,"Sub-basin 3"
3186,500,12,5000,5500,"Sub-basin 3"
3187,300,6,4800,5100,"Sub-basin 3"
3188,400,14,4800,5200,"Sub-basin 3"
3189,100,1,1000,1100,"Sub-basin 3"
3190,200,4,2300,2500,"Sub-basin 3"
3191,200,27,1300,1500,"Sub-basin 3"
3192,3900,331,37400,41300,"Sub-basin 3"
3193,500,26,3900,4400,"Sub-basin 3"
3194,200,6,1700,1900,"Sub-basin 3"
3195,100,2,2600,2700,"Sub-basin 3"
3196,100,1,4700,4800,"Sub-basin 3"
3197,100,7,2600,2700,"Sub-basin 3"
3198,400,8,1200,1600,"Sub-basin 3"
3199,500,36,4500,5000,"Sub-basin 3"
3200,100,1,1400,1500,"Sub-basin 3"
3201,100,2,800,900,"Sub-basin 3"
3202,200,5,1700,1900,"Sub-basin 3"
3203,100,3,1500,1600,"Sub-basin 3"
3204,400,15,6800,7200,"Sub-basin 3"
3205,200,4,2700,2900,"Sub-basin 3"
3206,300,4,7500,7800,"Sub-basin 3"
3207,200,4,2600,2800,"Sub-basin 3"
3208,400,15,4100,4500,"Sub-basin 3"
3209,200,2,1700,1900,"Sub-basin 3"
3210,600,27,5200,5800,"Sub-basin 3"
3211,800,58,12700,13500,"Sub-basin 3"
3212,100,2,1800,1900,"Sub-basin 3"
3213,100,1,1300,1400,"Sub-basin 3"
3214,100,1,600,700,"Sub-basin 3"
3215,600,21,5400,6000,"Sub-basin 3"
3216,300,3,3200,3500,"Sub-basin 3"
3217,700,21,13900,14600,"Sub-basin 3"
3218,400,8,5900,6300,"Sub-basin 3"
3219,900,38,7100,8000,"Sub-basin 3"
3220,100,1,1100,1200,"Sub-basin 3"
3221,600,33,5000,5600,"Sub-basin 3"
3222,200,5,3000,3200,"Sub-basin 3"
3223,100,2,1300,1400,"Sub-basin 3"
3224,100,1,1400,1500,"Sub-basin 3"
3225,400,8,10700,11100,"Sub-basin 3"
3226,3800,153,23200,27000,"Sub-basin 3"
3227,100,4,2000,2100,"Sub-basin 3"
3228,200,12,2000,2200,"Sub-basin 3"
3229,200,7,1800,2000,"Sub-basin 3"
3230,500,11.0337,5600,6100,"Sub-basin 3"
3231,2300,40.2036,12800,15100,"Sub-basin 3"
3232,100,1,600,700,"Sub-basin 3"
3233,100,1,2100,2200,"Sub-basin 3"
3234,100,2,1000,1100,"Sub-basin 3"
3235,700,16,4800,5500,"Sub-basin 3"
3236,500,13,7800,8300,"Sub-basin 3"
3237,300,4,3300,3600,"Sub-basin 3"
3238,100,4,1800,1900,"Sub-basin 3"
3239,200,5,5300,5500,"Sub-basin 3"
3240,100,1,2800,2900,"Sub-basin 3"
3241,800,21,12600,13400,"Sub-basin 3"
3242,200,7,600,800,"Sub-basin 3"
3243,200,5,2900,3100,"Sub-basin 3"
3244,200,2,1900,2100,"Sub-basin 3"
3245,400,17,1900,2300,"Sub-basin 3"
3246,100,1,600,700,"Sub-basin 3"
3247,100,1,200,300,"Sub-basin 3"
3248,100,1,300,400,"Sub-basin 3"
3249,100,1,900,1000,"Sub-basin 3"
3250,100,2,1700,1800,"Sub-basin 3"
3251,100,1,5000,5100,"Sub-basin 3"
3252,200,4,6200,6400,"Sub-basin 3"
3253,100,3,2400,2500,"Sub-basin 3"
3254,200,2,3600,3800,"Sub-basin 3"
3255,300,12,5000,5300,"Sub-basin 3"
3256,400,18,3800,4200,"Sub-basin 3"
3257,246400,8457.0084,214300,460700,"Sub-basin 3"
3258,100,1,600,700,"Sub-basin 3"
3259,100,2,600,700,"Sub-basin 3"
3260,100,1,2000,2100,"Sub-basin 3"
3261,600,17.33,5300,5900,"Sub-basin 3"
3262,500,13,9600,10100,"Sub-basin 3"
3263,500,32,7800,8300,"Sub-basin 3"
3264,100,1,400,500,"Sub-basin 3"
3265,1200,71,14500,15700,"Sub-basin 3"
3266,200,8,4800,5000,"Sub-basin 3"
3267,400,11,12700,13100,"Sub-basin 3"
3268,400,51,3300,3700,"Sub-basin 3"
3269,500,16,6500,7000,"Sub-basin 3"
3270,200,2,900,1100,"Sub-basin 3"
3271,400,10,3400,3800,"Sub-basin 3"
3272,100,2,500,600,"Sub-basin 3"
3273,100,1.0066,1200,1300,"Sub-basin 3"
3274,200,2.0141,1700,1900,"Sub-basin 3"
3275,4700,116.3886,17500,22200,"Sub-basin 3"
3276,100,2,1900,2000,"Sub-basin 3"
3277,100,1,2700,2800,"Sub-basin 3"
3278,100,3,1600,1700,"Sub-basin 3"
3279,200,77,2500,2700,"Sub-basin 3"
3280,100,1,4600,4700,"Sub-basin 3"
3281,100,2,2000,2100,"Sub-basin 3"
3282,100,1,5000,5100,"Sub-basin 3"
3283,300,10,4900,5200,"Sub-basin 3"
3284,200,2,4800,5000,"Sub-basin 3"
3285,1800,133,14700,16500,"Sub-basin 3"
3286,100,1,1800,1900,"Sub-basin 3"
3287,100,2,400,500,"Sub-basin 3"
3288,100,1.0052,800,900,"Sub-basin 3"
3289,100,2.0066,1200,1300,"Sub-basin 3"
3290,100,1,1200,1300,"Sub-basin 3"
3291,400,11,5200,5600,"Sub-basin 3"
3292,300,8,7000,7300,"Sub-basin 3"
3293,400,6,6400,6800,"Sub-basin 3"
3294,100,5,1400,1500,"Sub-basin 3"
3295,1000,45,7700,8700,"Sub-basin 3"
3296,100,2,1200,1300,"Sub-basin 3"
3297,300,5,3700,4000,"Sub-basin 3"
3298,200,3,2800,3000,"Sub-basin 3"
3299,200,2,5300,5500,"Sub-basin 3"
3300,100,2,3500,3600,"Sub-basin 3"
3301,400,4,10800,11200,"Sub-basin 3"
3302,100,1,3700,3800,"Sub-basin 3"
3303,100,2,1800,1900,"Sub-basin 3"
3304,21500,1587,96700,118200,"Sub-basin 3"
3305,100,1,900,1000,"Sub-basin 3"
3306,500,27,2700,3200,"Sub-basin 3"
3307,900,96,1600,2500,"Sub-basin 3"
3308,6400,302,18100,24500,"Sub-basin 3"
3309,1800,43,5100,6900,"Sub-basin 3"
3310,100,1.0054,400,500,"Sub-basin 3"
3311,200,2.0187,2000,2200,"Sub-basin 3"
3312,200,2.0003,1900,2100,"Sub-basin 3"
3313,300,5,4500,4800,"Sub-basin 3"
3314,500,10,10900,11400,"Sub-basin 3"
3315,400,14,4000,4400,"Sub-basin 3"
3316,400,16,3500,3900,"Sub-basin 3"
3317,300,3,6000,6300,"Sub-basin 3"
3318,100,1,3300,3400,"Sub-basin 3"
3319,100,2,2800,2900,"Sub-basin 3"
3320,200,11,3700,3900,"Sub-basin 3"
3321,900,58,15800,16700,"Sub-basin 3"
3322,100,2,1100,1200,"Sub-basin 3"
3323,400,33,4100,4500,"Sub-basin 3"
3324,100,1,1500,1600,"Sub-basin 3"
3325,700,58,5000,5700,"Sub-basin 3"
3326,300,5,1500,1800,"Sub-basin 3"
3327,100,2,1100,1200,"Sub-basin 3"
3328,100,3.0054,600,700,"Sub-basin 3"
3329,100,2.0065,300,400,"Sub-basin 3"
3330,900,29,12700,13600,"Sub-basin 3"
3331,300,5,4900,5200,"Sub-basin 3"
3332,100,1,2100,2200,"Sub-basin 3"
3333,200,8,3700,3900,"Sub-basin 3"
3334,700,38,10100,10800,"Sub-basin 3"
3335,200,6,2500,2700,"Sub-basin 3"
3336,100,1,1300,1400,"Sub-basin 3"
3337,100,6,2100,2200,"Sub-basin 3"
3338,200,7,4100,4300,"Sub-basin 3"
3339,100,1,3100,3200,"Sub-basin 3"
3340,400,9,11000,11400,"Sub-basin 3"
3341,400,9,5800,6200,"Sub-basin 3"
3342,2900,116,51300,54200,"Sub-basin 3"
3343,1600,246,5900,7500,"Sub-basin 3"
3344,100,3,2200,2300,"Sub-basin 3"
3345,100,2,600,700,"Sub-basin 3"
3346,100,4.0102,900,1000,"Sub-basin 3"
3347,300,4,9000,9300,"Sub-basin 3"
3348,200,4,3400,3600,"Sub-basin 3"
3349,200,3,4600,4800,"Sub-basin 3"
3350,1700,255,10400,12100,"Sub-basin 3"
3351,500,10,6000,6500,"Sub-basin 3"
3352,3300,307,45100,48400,"Sub-basin 3"
3353,500,19,15600,16100,"Sub-basin 3"
3354,3300,108.66,35100,38400,"Sub-basin 3"
3355,200,2,4800,5000,"Sub-basin 3"
3356,100,1,2800,2900,"Sub-basin 3"
3357,1300,54,13300,14600,"Sub-basin 3"
3358,200,7,4500,4700,"Sub-basin 3"
3359,16700,1311,90300,107000,"Sub-basin 3"
3360,100,1,900,1000,"Sub-basin 3"
3361,1200,36.0651,1700,2900,"Sub-basin 3"
3362,100,1.0065,800,900,"Sub-basin 3"
3363,300,9,3400,3700,"Sub-basin 3"
3364,1600,100,15700,17300,"Sub-basin 3"
3365,100,1,1100,1200,"Sub-basin 3"
3366,1900,136,13500,15400,"Sub-basin 3"
3367,300,7,5500,5800,"Sub-basin 3"
3368,200,2,7700,7900,"Sub-basin 3"
3369,100,3,3500,3600,"Sub-basin 3"
3370,100,1,1600,1700,"Sub-basin 3"
3371,100,1,2000,2100,"Sub-basin 3"
3372,7800,809,49200,57000,"Sub-basin 3"
3373,100,4,2400,2500,"Sub-basin 3"
3374,1600,249,2500,4100,"Sub-basin 3"
3375,200,10,2900,3100,"Sub-basin 3"
3376,100,1,600,700,"Sub-basin 3"
3377,900,15,5000,5900,"Sub-basin 3"
3378,400,28,3400,3800,"Sub-basin 3"
3379,100,1,400,500,"Sub-basin 3"
3380,400,12,3200,3600,"Sub-basin 3"
3381,200,2,4000,4200,"Sub-basin 3"
3382,100,3,2500,2600,"Sub-basin 3"
3383,100,2,2600,2700,"Sub-basin 3"
3384,200,5,3500,3700,"Sub-basin 3"
3385,100,3,1200,1300,"Sub-basin 3"
3386,200,3,4000,4200,"Sub-basin 3"
3387,200,4,3800,4000,"Sub-basin 3"
3388,900,37,14100,15000,"Sub-basin 3"
3389,1400,60,20600,22000,"Sub-basin 3"
3390,100,1,300,400,"Sub-basin 3"
3391,100,1,1600,1700,"Sub-basin 3"
3392,2100,126,5400,7500,"Sub-basin 3"
3393,100,4,1500,1600,"Sub-basin 3"
3394,2500,128,8800,11300,"Sub-basin 3"
3395,700,31,5500,6200,"Sub-basin 3"
3396,300,8,2200,2500,"Sub-basin 3"
3397,600,9,9200,9800,"Sub-basin 3"
3398,15900,2119,74800,90700,"Sub-basin 3"
3399,100,2,500,600,"Sub-basin 3"
3400,400,7,7400,7800,"Sub-basin 3"
3401,100,1,1800,1900,"Sub-basin 3"
3402,100,2,2500,2600,"Sub-basin 3"
3403,100,3,2800,2900,"Sub-basin 3"
3404,800,25,10400,11200,"Sub-basin 3"
3405,300,13,2200,2500,"Sub-basin 3"
3406,100,4,3900,4000,"Sub-basin 3"
3407,100,2,2600,2700,"Sub-basin 3"
3408,300,8,9700,10000,"Sub-basin 3"
3409,100,2,2600,2700,"Sub-basin 3"
3410,100,8,1700,1800,"Sub-basin 3"
3411,1300,106,14800,16100,"Sub-basin 3"
3412,400,21,9400,9800,"Sub-basin 3"
3413,400,15,1400,1800,"Sub-basin 3"
3414,300,4,4300,4600,"Sub-basin 3"
3415,100,1,600,700,"Sub-basin 3"
3416,100,1.005,1700,1800,"Sub-basin 3"
3417,1600,46,6100,7700,"Sub-basin 3"
3418,100,1,3600,3700,"Sub-basin 3"
3419,100,2,1400,1500,"Sub-basin 3"
3420,12100,963,100500,112600,"Sub-basin 3"
3421,100,2,2300,2400,"Sub-basin 3"
3422,100,2,2000,2100,"Sub-basin 3"
3423,700,78,4000,4700,"Sub-basin 3"
3424,100,1,1200,1300,"Sub-basin 3"
3425,100,2,800,900,"Sub-basin 3"
3426,1300,51.84,10900,12200,"Sub-basin 3"
3427,200,8,2800,3000,"Sub-basin 3"
3428,100,1,2100,2200,"Sub-basin 3"
3429,100,4,1500,1600,"Sub-basin 3"
3430,300,6,4200,4500,"Sub-basin 3"
3431,300,16,4500,4800,"Sub-basin 3"
3432,100,3.005,1400,1500,"Sub-basin 3"
3433,100,3,800,900,"Sub-basin 3"
3434,300,16,1300,1600,"Sub-basin 3"
3435,100,2,2500,2600,"Sub-basin 3"
3436,700,12,8500,9200,"Sub-basin 3"
3437,200,5,3000,3200,"Sub-basin 3"
3438,100,2,2000,2100,"Sub-basin 3"
3439,100,2,800,900,"Sub-basin 3"
3440,100,3,2400,2500,"Sub-basin 3"
3441,100,1,2900,3000,"Sub-basin 3"
3442,100,1,3500,3600,"Sub-basin 3"
3443,100,1,1900,2000,"Sub-basin 3"
3444,100,2,4100,4200,"Sub-basin 3"
3445,200,2,4800,5000,"Sub-basin 3"
3446,200,2,6000,6200,"Sub-basin 3"
3447,100,2,1600,1700,"Sub-basin 3"
3448,100,1,600,700,"Sub-basin 3"
3449,200,4.01,1300,1500,"Sub-basin 3"
3450,100,1,200,300,"Sub-basin 3"
3451,400,8,3400,3800,"Sub-basin 3"
3452,200,2,4800,5000,"Sub-basin 3"
3453,500,9,6400,6900,"Sub-basin 3"
3454,100,1,2000,2100,"Sub-basin 3"
3455,100,2,2200,2300,"Sub-basin 3"
3456,100,3,1800,1900,"Sub-basin 3"
3457,100,1,600,700,"Sub-basin 3"
3458,100,1,3500,3600,"Sub-basin 3"
3459,200,4,3600,3800,"Sub-basin 3"
3460,200,2,1100,1300,"Sub-basin 3"
3461,200,6,900,1100,"Sub-basin 3"
3462,200,3,1100,1300,"Sub-basin 3"
3463,100,3,2700,2800,"Sub-basin 3"
3464,600,24,3300,3900,"Sub-basin 3"
3465,100,1,2700,2800,"Sub-basin 3"
3466,100,3,3200,3300,"Sub-basin 3"
3467,100,1,900,1000,"Sub-basin 3"
3468,2000,148,18200,20200,"Sub-basin 3"
3469,1600,42,14600,16200,"Sub-basin 3"
3470,100,1,2000,2100,"Sub-basin 3"
3471,100,2,2700,2800,"Sub-basin 3"
3472,300,7,4400,4700,"Sub-basin 3"
3473,500,13,14200,14700,"Sub-basin 3"
3474,900,37,25500,26400,"Sub-basin 3"
3475,200,4,4500,4700,"Sub-basin 3"
3476,100,1,4000,4100,"Sub-basin 3"
3477,100,1,2200,2300,"Sub-basin 3"
3478,200,7,3300,3500,"Sub-basin 3"
3479,8000,266,23400,31400,"Sub-basin 3"
3480,300,7,2000,2300,"Sub-basin 3"
3481,800,30,3500,4300,"Sub-basin 3"
3482,15200,810,49700,64900,"Sub-basin 3"
3483,400,5,4700,5100,"Sub-basin 3"
3484,100,2,3100,3200,"Sub-basin 3"
3485,200,2,3100,3300,"Sub-basin 3"
3486,200,3,4900,5100,"Sub-basin 3"
3487,300,10,4200,4500,"Sub-basin 3"
3488,100,2,1100,1200,"Sub-basin 3"
3489,400,6,7200,7600,"Sub-basin 3"
3490,100,3,2300,2400,"Sub-basin 3"
3491,1100,73,5000,6100,"Sub-basin 3"
3492,100,1,900,1000,"Sub-basin 3"
3493,600,18,4800,5400,"Sub-basin 3"
3494,500,13,4000,4500,"Sub-basin 3"
3495,1400,39,19200,20600,"Sub-basin 3"
3496,200,5,7500,7700,"Sub-basin 3"
3497,100,1,2200,2300,"Sub-basin 3"
3498,100,2,2200,2300,"Sub-basin 3"
3499,400,8,1200,1600,"Sub-basin 3"
3500,200,4,1200,1400,"Sub-basin 3"
3501,200,5,2200,2400,"Sub-basin 3"
3502,100,1,300,400,"Sub-basin 3"
3503,200,5,600,800,"Sub-basin 3"
3504,100,5,2300,2400,"Sub-basin 3"
3505,100,2,2600,2700,"Sub-basin 3"
3506,400,9,3300,3700,"Sub-basin 3"
3507,300,9,8600,8900,"Sub-basin 3"
3508,900,53,18400,19300,"Sub-basin 3"
3509,100,1,2300,2400,"Sub-basin 3"
3510,200,3,3000,3200,"Sub-basin 3"
3511,500,40,7200,7700,"Sub-basin 3"
3512,400,57,2700,3100,"Sub-basin 3"
3513,7500,734,31500,39000,"Sub-basin 3"
3514,400,10,1500,1900,"Sub-basin 3"
3515,400,11,2700,3100,"Sub-basin 3"
3516,100,1,300,400,"Sub-basin 3"
3517,500,10,2800,3300,"Sub-basin 3"
3518,100,1,1100,1200,"Sub-basin 3"
3519,200,3,4900,5100,"Sub-basin 3"
3520,300,8,4400,4700,"Sub-basin 3"
3521,2200,143,30900,33100,"Sub-basin 3"
3522,200,4,3100,3300,"Sub-basin 3"
3523,100,1,800,900,"Sub-basin 3"
3524,100,2,500,600,"Sub-basin 3"
3525,2400,240,20600,23000,"Sub-basin 3"
3526,400,24,8400,8800,"Sub-basin 3"
3527,100,2,2100,2200,"Sub-basin 3"
3528,400,8,1900,2300,"Sub-basin 3"
3529,900,25,3400,4300,"Sub-basin 3"
3530,1500,71,16400,17900,"Sub-basin 3"
3531,500,15,9300,9800,"Sub-basin 3"
3532,4400,203,49700,54100,"Sub-basin 3"
3533,700,47,8000,8700,"Sub-basin 3"
3534,400,18,5900,6300,"Sub-basin 3"
3535,400,22,6100,6500,"Sub-basin 3"
3536,300,10,4000,4300,"Sub-basin 3"
3537,200,5,4400,4600,"Sub-basin 3"
3538,400,12,4000,4400,"Sub-basin 3"
3539,100,3,1300,1400,"Sub-basin 3"
3540,100,2,4800,4900,"Sub-basin 3"
3541,200,7,1200,1400,"Sub-basin 3"
3542,100,2,2000,2100,"Sub-basin 3"
3543,200,6,3300,3500,"Sub-basin 3"
3544,100,1,700,800,"Sub-basin 3"
3545,100,3,500,600,"Sub-basin 3"
3546,300,6,4200,4500,"Sub-basin 3"
3547,200,8,4100,4300,"Sub-basin 3"
3548,100,2,1700,1800,"Sub-basin 3"
3549,100,1,3000,3100,"Sub-basin 3"
3550,100,3,600,700,"Sub-basin 3"
3551,100,1,2500,2600,"Sub-basin 3"
3552,600,34,8100,8700,"Sub-basin 3"
3553,500,16,11300,11800,"Sub-basin 3"
3554,100,2,1300,1400,"Sub-basin 3"
3555,100,3,900,1000,"Sub-basin 3"
3556,100,1,1500,1600,"Sub-basin 3"
3557,1000,29,11400,12400,"Sub-basin 3"
3558,200,4,2600,2800,"Sub-basin 3"
3559,2300,144,13300,15600,"Sub-basin 3"
3560,400,22,7400,7800,"Sub-basin 3"
3561,200,8,5400,5600,"Sub-basin 3"
3562,100,2,2000,2100,"Sub-basin 3"
3563,200,9,5600,5800,"Sub-basin 3"
3564,2200,158,28200,30400,"Sub-basin 3"
3565,100,2,1600,1700,"Sub-basin 3"
3566,200,6,1200,1400,"Sub-basin 3"
3567,300,10,2800,3100,"Sub-basin 3"
3568,6200,576,42000,48200,"Sub-basin 3"
3569,100,1,100,200,"Sub-basin 3"
3570,100,3,1300,1400,"Sub-basin 3"
3571,100,1,2600,2700,"Sub-basin 3"
3572,200,5,1900,2100,"Sub-basin 3"
3573,400,23,1800,2200,"Sub-basin 3"
3574,1400,90,16500,17900,"Sub-basin 3"
3575,300,14,3000,3300,"Sub-basin 3"
3576,400,25,7600,8000,"Sub-basin 3"
3577,100,1,5000,5100,"Sub-basin 3"
3578,300,13,6700,7000,"Sub-basin 3"
3579,100,2,2000,2100,"Sub-basin 3"
3580,100,1,1100,1200,"Sub-basin 3"
3581,100,3,1500,1600,"Sub-basin 3"
3582,2200,207,10500,12700,"Sub-basin 3"
3583,1000,29,8500,9500,"Sub-basin 3"
3584,100,4,2500,2600,"Sub-basin 3"
3585,100,1,1500,1600,"Sub-basin 3"
3586,100,2,1700,1800,"Sub-basin 3"
3587,100,2,1000,1100,"Sub-basin 3"
3588,300,10,3800,4100,"Sub-basin 3"
3589,100,1,500,600,"Sub-basin 3"
3590,100,1,2400,2500,"Sub-basin 3"
3591,100,2,2400,2500,"Sub-basin 3"
3592,200,4,2800,3000,"Sub-basin 3"
3593,2700,176,11300,14000,"Sub-basin 3"
3594,400,10,4800,5200,"Sub-basin 3"
3595,100,1,1400,1500,"Sub-basin 3"
3596,800,115,3200,4000,"Sub-basin 3"
3597,100,1,2500,2600,"Sub-basin 3"
3598,200,4,2500,2700,"Sub-basin 3"
3599,600,14,1500,2100,"Sub-basin 3"
3600,4000,133,12100,16100,"Sub-basin 3"
3601,800,24,10500,11300,"Sub-basin 3"
3602,100,1,3700,3800,"Sub-basin 3"
3603,500,15,6300,6800,"Sub-basin 3"
3604,100,3,2200,2300,"Sub-basin 3"
3605,100,1,3300,3400,"Sub-basin 3"
3606,100,1,900,1000,"Sub-basin 3"
3607,100,1,500,600,"Sub-basin 3"
3608,1900,202,15000,16900,"Sub-basin 3"
3609,100,3,2000,2100,"Sub-basin 3"
3610,100,1,1500,1600,"Sub-basin 3"
3611,100,5,2800,2900,"Sub-basin 3"
3612,100,1,1500,1600,"Sub-basin 3"
3613,100,2,1900,2000,"Sub-basin 3"
3614,400,20,2000,2400,"Sub-basin 3"
3615,100,2,2600,2700,"Sub-basin 3"
3616,200,4,3800,4000,"Sub-basin 3"
3617,1800,140,9000,10800,"Sub-basin 3"
3618,700,37,7500,8200,"Sub-basin 3"
3619,300,9,4100,4400,"Sub-basin 3"
3620,200,6,2500,2700,"Sub-basin 3"
3621,100,1,1700,1800,"Sub-basin 3"
3622,100,1,2800,2900,"Sub-basin 3"
3623,300,3,3300,3600,"Sub-basin 3"
3624,500,7,10500,11000,"Sub-basin 3"
3625,200,7,3400,3600,"Sub-basin 3"
3626,5000,735,32900,37900,"Sub-basin 3"
3627,100,1,1800,1900,"Sub-basin 3"
3628,300,8,4200,4500,"Sub-basin 3"
3629,100,1,1800,1900,"Sub-basin 3"
3630,200,7,6900,7100,"Sub-basin 3"
3631,100,1,2700,2800,"Sub-basin 3"
3632,100,1,4100,4200,"Sub-basin 3"
3633,100,2,2800,2900,"Sub-basin 3"
3634,7900,533,144500,152400,"Sub-basin 3"
3635,1100,126,15400,16500,"Sub-basin 3"
3636,400,17,1300,1700,"Sub-basin 3"
3637,100,3,1900,2000,"Sub-basin 3"
3638,2900,321,8900,11800,"Sub-basin 3"
3639,200,6.0098,2400,2600,"Sub-basin 3"
3640,500,16,2300,2800,"Sub-basin 3"
3641,200,8,400,600,"Sub-basin 3"
3642,500,22,4900,5400,"Sub-basin 3"
3643,100,2,3500,3600,"Sub-basin 3"
3644,100,4,2000,2100,"Sub-basin 3"
3645,800,17,8400,9200,"Sub-basin 3"
3646,1000,46,20900,21900,"Sub-basin 3"
3647,100,3,2400,2500,"Sub-basin 3"
3648,100,2,2200,2300,"Sub-basin 3"
3649,300,5,1600,1900,"Sub-basin 3"
3650,400,4,6600,7000,"Sub-basin 3"
3651,300,3,4700,5000,"Sub-basin 3"
3652,100,4,2200,2300,"Sub-basin 3"
3653,100,1,1700,1800,"Sub-basin 3"
3654,100,1,700,800,"Sub-basin 3"
3655,1500,146,11000,12500,"Sub-basin 3"
3656,100,1,3200,3300,"Sub-basin 3"
3657,3100,134,30900,34000,"Sub-basin 3"
3658,200,3,4700,4900,"Sub-basin 3"
3659,500,41,2700,3200,"Sub-basin 3"
3660,200,4,4400,4600,"Sub-basin 3"
3661,100,1,4700,4800,"Sub-basin 3"
3662,1400,80,23900,25300,"Sub-basin 3"
3663,700,21,19200,19900,"Sub-basin 3"
3664,1800,125,35700,37500,"Sub-basin 3"
3665,900,32,14500,15400,"Sub-basin 3"
3666,100,4,600,700,"Sub-basin 3"
3667,100,1,1200,1300,"Sub-basin 3"
3668,100,1,2000,2100,"Sub-basin 3"
3669,100,1,1700,1800,"Sub-basin 3"
3670,100,1,1000,1100,"Sub-basin 3"
3671,100,1,3100,3200,"Sub-basin 3"
3672,1600,53,21500,23100,"Sub-basin 3"
3673,200,8,4000,4200,"Sub-basin 3"
3674,4900,384,22500,27400,"Sub-basin 3"
3675,500,33,4600,5100,"Sub-basin 3"
3676,100,2,1800,1900,"Sub-basin 3"
3677,100,3,1600,1700,"Sub-basin 3"
3678,600,21,5100,5700,"Sub-basin 3"
3679,2200,325,18700,20900,"Sub-basin 3"
3680,100,2,1700,1800,"Sub-basin 3"
3681,400,13,5200,5600,"Sub-basin 3"
3682,100,1,3500,3600,"Sub-basin 3"
3683,1800,83,26900,28700,"Sub-basin 3"
3684,100,1,1700,1800,"Sub-basin 3"
3685,600,46,5600,6200,"Sub-basin 3"
3686,500,15,6100,6600,"Sub-basin 3"
3687,100,2,2300,2400,"Sub-basin 3"
3688,100,1,800,900,"Sub-basin 3"
3689,100,1,2300,2400,"Sub-basin 3"
3690,200,7,4100,4300,"Sub-basin 3"
3691,500,13,5000,5500,"Sub-basin 3"
3692,100,1,3100,3200,"Sub-basin 3"
3693,1200,32,19700,20900,"Sub-basin 3"
3694,300,25,6300,6600,"Sub-basin 3"
3695,100,1,1600,1700,"Sub-basin 3"
3696,600,12,9400,10000,"Sub-basin 3"
3697,100,3,1600,1700,"Sub-basin 3"
3698,200,4,7400,7600,"Sub-basin 3"
3699,100,1,3300,3400,"Sub-basin 3"
3700,200,5,6500,6700,"Sub-basin 3"
3701,200,7,1400,1600,"Sub-basin 3"
3702,100,1,2200,2300,"Sub-basin 3"
3703,300,9,5600,5900,"Sub-basin 3"
3704,2000,117.17,8300,10300,"Sub-basin 3"
3705,2900,182,24500,27400,"Sub-basin 3"
3706,400,16,5700,6100,"Sub-basin 3"
3707,100,3,400,500,"Sub-basin 3"
3708,500,16,5900,6400,"Sub-basin 3"
3709,100,1,2100,2200,"Sub-basin 3"
3710,200,3,2800,3000,"Sub-basin 3"
3711,3500,148,34000,37500,"Sub-basin 3"
3712,100,1,1900,2000,"Sub-basin 3"
3713,400,31,1100,1500,"Sub-basin 3"
3714,200,7,3800,4000,"Sub-basin 3"
3715,600,35,11500,12100,"Sub-basin 3"
3716,300,3,6900,7200,"Sub-basin 3"
3717,300,13,4100,4400,"Sub-basin 3"
3718,100,1,2700,2800,"Sub-basin 3"
3719,1000,37,17900,18900,"Sub-basin 3"
3720,200,2,5500,5700,"Sub-basin 3"
3721,700,24,10500,11200,"Sub-basin 3"
3722,600,31,8500,9100,"Sub-basin 3"
3723,200,4,6100,6300,"Sub-basin 3"
3724,100,1,1100,1200,"Sub-basin 3"
3725,2500,116,15600,18100,"Sub-basin 3"
3726,11900,1358,70900,82800,"Sub-basin 3"
3727,100,2,600,700,"Sub-basin 3"
3728,2300,46.0897,5100,7400,"Sub-basin 3"
3729,100,3,900,1000,"Sub-basin 3"
3730,400,13,1600,2000,"Sub-basin 3"
3731,100,4,2400,2500,"Sub-basin 3"
3732,1200,39,11100,12300,"Sub-basin 3"
3733,100,2,1300,1400,"Sub-basin 3"
3734,800,27,8800,9600,"Sub-basin 3"
3735,200,9,5500,5700,"Sub-basin 3"
3736,300,9,3300,3600,"Sub-basin 3"
3737,1400,57,17500,18900,"Sub-basin 3"
3738,2500,336,21200,23700,"Sub-basin 3"
3739,600,14.17,9100,9700,"Sub-basin 3"
3740,200,7,1300,1500,"Sub-basin 3"
3741,400,18,2800,3200,"Sub-basin 3"
3742,600,24,7100,7700,"Sub-basin 3"
3743,1500,59,23000,24500,"Sub-basin 3"
3744,700,33,5700,6400,"Sub-basin 3"
3745,100,2,1800,1900,"Sub-basin 3"
3746,600,44,9400,10000,"Sub-basin 3"
3747,300,6,4300,4600,"Sub-basin 3"
3748,500,13,7600,8100,"Sub-basin 3"
3749,100,2,2800,2900,"Sub-basin 3"
3750,400,10,9900,10300,"Sub-basin 3"
3751,100,2,2500,2600,"Sub-basin 3"
3752,200,8,4500,4700,"Sub-basin 3"
3753,100,2,1300,1400,"Sub-basin 3"
3754,1400,48,12300,13700,"Sub-basin 3"
3755,1200,71,2600,3800,"Sub-basin 3"
3756,500,23,4800,5300,"Sub-basin 3"
3757,200,2,3900,4100,"Sub-basin 3"
3758,200,6,3400,3600,"Sub-basin 3"
3759,500,13,12600,13100,"Sub-basin 3"
3760,100,3,3400,3500,"Sub-basin 3"
3761,100,3,3100,3200,"Sub-basin 3"
3762,100,4,2700,2800,"Sub-basin 3"
3763,19500,1127.67,405900,425400,"Sub-basin 3"
3764,1500,45,14400,15900,"Sub-basin 3"
3765,2200,156,16400,18600,"Sub-basin 3"
3766,2800,577,12400,15200,"Sub-basin 3"
3767,3300,298,45900,49200,"Sub-basin 3"
3768,100,1,1400,1500,"Sub-basin 3"
3769,1200,58,16600,17800,"Sub-basin 3"
3770,400,30,3600,4000,"Sub-basin 3"
3771,400,18,4800,5200,"Sub-basin 3"
3772,100,4,1800,1900,"Sub-basin 3"
3773,100,2,2000,2100,"Sub-basin 3"
3774,2100,68,17400,19500,"Sub-basin 3"
3775,200,6,3300,3500,"Sub-basin 3"
3776,600,41,8500,9100,"Sub-basin 3"
3777,100,2,1900,2000,"Sub-basin 3"
3778,100,2,2100,2200,"Sub-basin 3"
3779,100,5,3200,3300,"Sub-basin 3"
3780,100,1,4700,4800,"Sub-basin 3"
3781,100,1,2100,2200,"Sub-basin 3"
3782,400,9,1200,1600,"Sub-basin 3"
3783,100,6,900,1000,"Sub-basin 3"
3784,100,1,1500,1600,"Sub-basin 3"
3785,400,8.0192,1600,2000,"Sub-basin 3"
3786,800,53,10000,10800,"Sub-basin 3"
3787,200,6,3200,3400,"Sub-basin 3"
3788,600,31,6500,7100,"Sub-basin 3"
3789,300,10,11100,11400,"Sub-basin 3"
3790,200,6,4600,4800,"Sub-basin 3"
3791,100,1,2300,2400,"Sub-basin 3"
3792,400,37,1900,2300,"Sub-basin 3"
3793,200,11,3200,3400,"Sub-basin 3"
3794,100,1,500,600,"Sub-basin 3"
3795,600,18,9000,9600,"Sub-basin 3"
3796,300,5,3700,4000,"Sub-basin 3"
3797,400,8,4700,5100,"Sub-basin 3"
3798,200,4,5000,5200,"Sub-basin 3"
3799,100,2,2000,2100,"Sub-basin 3"
3800,1800,136,13700,15500,"Sub-basin 3"
3801,100,3,900,1000,"Sub-basin 3"
3802,100,1,600,700,"Sub-basin 3"
3803,100,1,1900,2000,"Sub-basin 3"
3804,300,8,5600,5900,"Sub-basin 3"
3805,100,3,3000,3100,"Sub-basin 3"
3806,300,5,4900,5200,"Sub-basin 3"
3807,13300,906.67,45700,59000,"Sub-basin 3"
3808,100,2,1100,1200,"Sub-basin 3"
3809,100,2,1700,1800,"Sub-basin 3"
3810,100,5,1300,1400,"Sub-basin 3"
3811,400,11,4800,5200,"Sub-basin 3"
3812,2300,69.1104,5500,7800,"Sub-basin 3"
3813,100,1,1300,1400,"Sub-basin 3"
3814,100,2,2200,2300,"Sub-basin 3"
3815,100,2,2000,2100,"Sub-basin 3"
3816,700,21,5000,5700,"Sub-basin 3"
3817,400,22,7600,8000,"Sub-basin 3"
3818,200,6,4400,4600,"Sub-basin 3"
3819,200,2,3600,3800,"Sub-basin 3"
3820,100,7,2500,2600,"Sub-basin 3"
3821,500,36,7500,8000,"Sub-basin 3"
3822,100,1,3600,3700,"Sub-basin 3"
3823,400,13,8600,9000,"Sub-basin 3"
3824,100,1,2200,2300,"Sub-basin 3"
3825,200,7,1500,1700,"Sub-basin 3"
3826,800,11,12300,13100,"Sub-basin 3"
3827,100,2,1100,1200,"Sub-basin 3"
3828,400,14,2000,2400,"Sub-basin 3"
3829,100,2,3000,3100,"Sub-basin 3"
3830,300,4,300,600,"Sub-basin 3"
3831,300,10,5900,6200,"Sub-basin 3"
3832,100,1,1400,1500,"Sub-basin 3"
3833,100,2,1400,1500,"Sub-basin 3"
3834,100,1,1400,1500,"Sub-basin 3"
3835,400,24,5200,5600,"Sub-basin 3"
3836,100,2,2400,2500,"Sub-basin 3"
3837,6700,463.83,43400,50100,"Sub-basin 3"
3838,100,1,1000,1100,"Sub-basin 3"
3839,100,1,400,500,"Sub-basin 3"
3840,100,1,2000,2100,"Sub-basin 3"
3841,1600,45,20800,22400,"Sub-basin 3"
3842,100,4,2400,2500,"Sub-basin 3"
3843,100,1,2100,2200,"Sub-basin 3"
3844,600,17,3600,4200,"Sub-basin 3"
3845,100,3,700,800,"Sub-basin 3"
3846,100,1,1600,1700,"Sub-basin 3"
3847,100,1,1800,1900,"Sub-basin 3"
3848,100,1,1800,1900,"Sub-basin 3"
3849,100,4,2100,2200,"Sub-basin 3"
3850,200,9,3500,3700,"Sub-basin 3"
3851,100,1,400,500,"Sub-basin 3"
3852,200,10,6200,6400,"Sub-basin 3"
3853,200,4,3900,4100,"Sub-basin 3"
3854,300,13,3900,4200,"Sub-basin 3"
3855,200,4,4900,5100,"Sub-basin 3"
3856,200,3,3900,4100,"Sub-basin 3"
3857,1300,112,10500,11800,"Sub-basin 3"
3858,100,1,1500,1600,"Sub-basin 3"
3859,800,31,8200,9000,"Sub-basin 3"
3860,100,2,1000,1100,"Sub-basin 3"
3861,200,3,1100,1300,"Sub-basin 3"
3862,1200,119,7700,8900,"Sub-basin 3"
3863,100,2,1200,1300,"Sub-basin 3"
3864,100,2,600,700,"Sub-basin 3"
3865,500,54,3600,4100,"Sub-basin 3"
3866,200,5,3400,3600,"Sub-basin 3"
3867,1200,105,21500,22700,"Sub-basin 3"
3868,100,1,2600,2700,"Sub-basin 3"
3869,600,28,6000,6600,"Sub-basin 3"
3870,100,1,1900,2000,"Sub-basin 3"
3871,500,10,9700,10200,"Sub-basin 3"
3872,100,1,1300,1400,"Sub-basin 3"
3873,900,28,5300,6200,"Sub-basin 3"
3874,100,3,700,800,"Sub-basin 3"
3875,200,3,4400,4600,"Sub-basin 3"
3876,300,11,5500,5800,"Sub-basin 3"
3877,900,59,8700,9600,"Sub-basin 3"
3878,1700,84,17200,18900,"Sub-basin 3"
3879,4200,321,31400,35600,"Sub-basin 3"
3880,100,1,2700,2800,"Sub-basin 3"
3881,300,9,8500,8800,"Sub-basin 3"
3882,100,1,2200,2300,"Sub-basin 3"
3883,300,7,2000,2300,"Sub-basin 3"
3884,100,1,2900,3000,"Sub-basin 3"
3885,1000,80,5000,6000,"Sub-basin 3"
3886,2700,305,5300,8000,"Sub-basin 3"
3887,300,10,6300,6600,"Sub-basin 3"
3888,100,2,2300,2400,"Sub-basin 3"
3889,3500,198,32500,36000,"Sub-basin 3"
3890,500,18,5000,5500,"Sub-basin 3"
3891,100,9,2000,2100,"Sub-basin 3"
3892,100,1,800,900,"Sub-basin 3"
3893,800,20,9800,10600,"Sub-basin 3"
3894,600,18,14100,14700,"Sub-basin 3"
3895,300,9,6600,6900,"Sub-basin 3"
3896,200,3,4600,4800,"Sub-basin 3"
3897,300,9,6600,6900,"Sub-basin 3"
3898,200,3,4400,4600,"Sub-basin 3"
3899,1200,161,9700,10900,"Sub-basin 3"
3900,100,1,1300,1400,"Sub-basin 3"
3901,200,7,3600,3800,"Sub-basin 3"
3902,200,2,1800,2000,"Sub-basin 3"
3903,3300,150,44200,47500,"Sub-basin 3"
3904,100,5,2000,2100,"Sub-basin 3"
3905,1800,66,20600,22400,"Sub-basin 3"
3906,800,29,8300,9100,"Sub-basin 3"
3907,100,1,2300,2400,"Sub-basin 3"
3908,100,5,1300,1400,"Sub-basin 3"
3909,100,6,2000,2100,"Sub-basin 3"
3910,100,1,2700,2800,"Sub-basin 3"
3911,100,1,3300,3400,"Sub-basin 3"
3912,100,1,3900,4000,"Sub-basin 3"
3913,100,1,1400,1500,"Sub-basin 3"
3914,100,5,1800,1900,"Sub-basin 3"
3915,800,162,4000,4800,"Sub-basin 3"
3916,300,10,7500,7800,"Sub-basin 3"
3917,100,3,900,1000,"Sub-basin 3"
3918,200,3,2300,2500,"Sub-basin 3"
3919,100,2,900,1000,"Sub-basin 3"
3920,3200,357,23800,27000,"Sub-basin 3"
3921,200,3,3500,3700,"Sub-basin 3"
3922,100,2,3000,3100,"Sub-basin 3"
3923,700,33,9000,9700,"Sub-basin 3"
3924,100,1,1700,1800,"Sub-basin 3"
3925,400,20,9400,9800,"Sub-basin 3"
3926,100,1,1900,2000,"Sub-basin 3"
3927,900,124,6000,6900,"Sub-basin 3"
3928,100,3,1100,1200,"Sub-basin 3"
3929,200,3,1300,1500,"Sub-basin 3"
3930,21900,1541.67,94200,116100,"Sub-basin 3"
3931,100,2.0047,700,800,"Sub-basin 3"
3932,100,2,400,500,"Sub-basin 3"
3933,100,3,2000,2100,"Sub-basin 3"
3934,100,2,2000,2100,"Sub-basin 3"
3935,100,1,1800,1900,"Sub-basin 3"
3936,100,1,2300,2400,"Sub-basin 3"
3937,5300,479,26300,31600,"Sub-basin 3"
3938,300,6,6000,6300,"Sub-basin 3"
3939,300,5,3300,3600,"Sub-basin 3"
3940,100,3,2300,2400,"Sub-basin 3"
3941,200,6,3900,4100,"Sub-basin 3"
3942,700,34,4500,5200,"Sub-basin 3"
3943,200,4,4700,4900,"Sub-basin 3"
3944,100,2,3000,3100,"Sub-basin 3"
3945,700,29,11100,11800,"Sub-basin 3"
3946,100,1,1100,1200,"Sub-basin 3"
3947,100,1,2300,2400,"Sub-basin 3"
3948,100,3,1200,1300,"Sub-basin 3"
3949,1100,92,3400,4500,"Sub-basin 3"
3950,100,1,2500,2600,"Sub-basin 3"
3951,200,4,4600,4800,"Sub-basin 3"
3952,100,2,2100,2200,"Sub-basin 3"
3953,1200,94,18600,19800,"Sub-basin 3"
3954,400,11,4200,4600,"Sub-basin 3"
3955,800,58,8100,8900,"Sub-basin 3"
3956,400,23,1700,2100,"Sub-basin 3"
3957,100,2,1900,2000,"Sub-basin 3"
3958,1300,74,17900,19200,"Sub-basin 3"
3959,600,13,7500,8100,"Sub-basin 3"
3960,100,2,2500,2600,"Sub-basin 3"
3961,600,24,4900,5500,"Sub-basin 3"
3962,300,9,3900,4200,"Sub-basin 3"
3963,100,1,2100,2200,"Sub-basin 3"
3964,100,2,1900,2000,"Sub-basin 3"
3965,800,119,2200,3000,"Sub-basin 3"
3966,100,1,1200,1300,"Sub-basin 3"
3967,100,2,1500,1600,"Sub-basin 3"
3968,100,1,1900,2000,"Sub-basin 3"
3969,1800,135,10700,12500,"Sub-basin 3"
3970,500,19,7600,8100,"Sub-basin 3"
3971,200,8,2300,2500,"Sub-basin 3"
3972,1400,186,12400,13800,"Sub-basin 3"
3973,200,11,2300,2500,"Sub-basin 3"
3974,400,9,5400,5800,"Sub-basin 3"
3975,700,84,9700,10400,"Sub-basin 3"
3976,200,6,4600,4800,"Sub-basin 3"
3977,100,2,1700,1800,"Sub-basin 3"
3978,100,1,1500,1600,"Sub-basin 3"
3979,300,12,4700,5000,"Sub-basin 3"
3980,100,1,2200,2300,"Sub-basin 3"
3981,300,4,3300,3600,"Sub-basin 3"
3982,700,37,6300,7000,"Sub-basin 3"
3983,3200,342,14900,18100,"Sub-basin 3"
3984,1600,124,15000,16600,"Sub-basin 3"
3985,11000,830,81200,92200,"Sub-basin 3"
3986,1000,59,10700,11700,"Sub-basin 3"
3987,200,9,2500,2700,"Sub-basin 3"
3988,12000,1454,53100,65100,"Sub-basin 3"
3989,100,1,2100,2200,"Sub-basin 3"
3990,100,2,1500,1600,"Sub-basin 3"
3991,100,1,1900,2000,"Sub-basin 3"
3992,200,4,4100,4300,"Sub-basin 3"
3993,2200,106,24800,27000,"Sub-basin 3"
3994,2900,134,17600,20500,"Sub-basin 3"
3995,100,3,1900,2000,"Sub-basin 3"
3996,100,1,2700,2800,"Sub-basin 3"
3997,300,6,7200,7500,"Sub-basin 3"
3998,100,3,4700,4800,"Sub-basin 3"
3999,500,15,9500,10000,"Sub-basin 3"
4000,1600,55,9700,11300,"Sub-basin 3"
4001,200,2,2400,2600,"Sub-basin 3"
4002,4500,392,26600,31100,"Sub-basin 3"
4003,1400,172,7900,9300,"Sub-basin 3"
4004,100,1,700,800,"Sub-basin 3"
4005,100,5,600,700,"Sub-basin 3"
4006,100,2.0047,300,400,"Sub-basin 3"
4007,100,1,2800,2900,"Sub-basin 3"
4008,100,5,2000,2100,"Sub-basin 3"
4009,100,1,1000,1100,"Sub-basin 3"
4010,100,1,1500,1600,"Sub-basin 3"
4011,100,2,1900,2000,"Sub-basin 3"
4012,300,5,2600,2900,"Sub-basin 3"
4013,200,7,4600,4800,"Sub-basin 3"
4014,100,1,2300,2400,"Sub-basin 3"
4015,200,3,2000,2200,"Sub-basin 3"
4016,300,5,7500,7800,"Sub-basin 3"
4017,300,6,3800,4100,"Sub-basin 3"
4018,200,2,5300,5500,"Sub-basin 3"
4019,1700,261,7700,9400,"Sub-basin 3"
4020,4600,502,14300,18900,"Sub-basin 3"
4021,17000,3697,20100,37100,"Sub-basin 3"
4022,400,11,4400,4800,"Sub-basin 3"
4023,100,1,1200,1300,"Sub-basin 3"
4024,400,12,6000,6400,"Sub-basin 3"
4025,100,1,4300,4400,"Sub-basin 3"
4026,1100,32,9500,10600,"Sub-basin 3"
4027,2100,188,15200,17300,"Sub-basin 3"
4028,200,2,0,200,"Sub-basin 3"
4029,800,79,4600,5400,"Sub-basin 3"
4030,100,3,1900,2000,"Sub-basin 3"
4031,100,1,500,600,"Sub-basin 3"
4032,100,1,1600,1700,"Sub-basin 3"
4033,200,6,3600,3800,"Sub-basin 3"
4034,200,16,2100,2300,"Sub-basin 3"
4035,100,2,3100,3200,"Sub-basin 3"
4036,100,1,2000,2100,"Sub-basin 3"
4037,100,2,4000,4100,"Sub-basin 3"
4038,100,1,3400,3500,"Sub-basin 3"
4039,100,1,2400,2500,"Sub-basin 3"
4040,200,6,1300,1500,"Sub-basin 3"
4041,1000,65,9800,10800,"Sub-basin 3"
4042,100,1,2500,2600,"Sub-basin 3"
4043,800,13,7400,8200,"Sub-basin 3"
4044,300,3,5300,5600,"Sub-basin 3"
4045,1200,33,13200,14400,"Sub-basin 3"
4046,100,2,3200,3300,"Sub-basin 3"
4047,300,9,6500,6800,"Sub-basin 3"
4048,100,1,1200,1300,"Sub-basin 3"
4049,300,5,6500,6800,"Sub-basin 3"
4050,600,34,9700,10300,"Sub-basin 3"
4051,500,9,7400,7900,"Sub-basin 3"
4052,400,23,5200,5600,"Sub-basin 3"
4053,100,2,500,600,"Sub-basin 3"
4054,100,1,1200,1300,"Sub-basin 3"
4055,600,16,7400,8000,"Sub-basin 3"
4056,200,6,2000,2200,"Sub-basin 3"
4057,100,2,2000,2100,"Sub-basin 3"
4058,1200,59,7200,8400,"Sub-basin 3"
4059,100,2,1600,1700,"Sub-basin 3"
4060,100,2,1700,1800,"Sub-basin 3"
4061,500,6,5600,6100,"Sub-basin 3"
4062,100,1,2800,2900,"Sub-basin 3"
4063,100,3,2600,2700,"Sub-basin 3"
4064,500,16,7200,7700,"Sub-basin 3"
4065,300,6,6700,7000,"Sub-basin 3"
4066,100,1,2200,2300,"Sub-basin 3"
4067,10500,532.5,35200,45700,"Sub-basin 3"
4068,100,2,1200,1300,"Sub-basin 3"
4069,100,1,1200,1300,"Sub-basin 3"
4070,100,3,800,900,"Sub-basin 3"
4071,100,2,1800,1900,"Sub-basin 3"
4072,700,23,9100,9800,"Sub-basin 3"
4073,800,31,11200,12000,"Sub-basin 3"
4074,200,2,2800,3000,"Sub-basin 3"
4075,700,16,9200,9900,"Sub-basin 3"
4076,100,1,1600,1700,"Sub-basin 3"
4077,400,23,7100,7500,"Sub-basin 3"
4078,200,3,4300,4500,"Sub-basin 3"
4079,700,31,4600,5300,"Sub-basin 3"
4080,100,1,1400,1500,"Sub-basin 3"
4081,500,40,3800,4300,"Sub-basin 3"
4082,200,5,1800,2000,"Sub-basin 3"
4083,100,4,600,700,"Sub-basin 3"
4084,200,4,3500,3700,"Sub-basin 3"
4085,300,10,3900,4200,"Sub-basin 3"
4086,600,30,4300,4900,"Sub-basin 3"
4087,4700,460.67,26900,31600,"Sub-basin 3"
4088,100,2,800,900,"Sub-basin 3"
4089,100,2,1400,1500,"Sub-basin 3"
4090,100,1,3300,3400,"Sub-basin 3"
4091,100,1,1600,1700,"Sub-basin 3"
4092,500,26,6800,7300,"Sub-basin 3"
4093,500,56,6500,7000,"Sub-basin 3"
4094,600,32,9300,9900,"Sub-basin 3"
4095,600,23,8300,8900,"Sub-basin 3"
4096,100,1,3400,3500,"Sub-basin 3"
4097,300,7,5700,6000,"Sub-basin 3"
4098,10100,385,48500,58600,"Sub-basin 3"
4099,5200,685.5,30400,35600,"Sub-basin 3"
4100,700,23,7400,8100,"Sub-basin 3"
4101,2100,292,4500,6600,"Sub-basin 3"
4102,200,4,3200,3400,"Sub-basin 3"
4103,200,5,3200,3400,"Sub-basin 3"
4104,1700,56.0247,7500,9200,"Sub-basin 3"
4105,300,14,1100,1400,"Sub-basin 3"
4106,100,1,1800,1900,"Sub-basin 3"
4107,100,5,2700,2800,"Sub-basin 3"
4108,400,10,4500,4900,"Sub-basin 3"
4109,300,3,6900,7200,"Sub-basin 3"
4110,100,3,2100,2200,"Sub-basin 3"
4111,700,25,7600,8300,"Sub-basin 3"
4112,600,17,8900,9500,"Sub-basin 3"
4113,100,2,1900,2000,"Sub-basin 3"
4114,100,2,1100,1200,"Sub-basin 3"
4115,200,7,2400,2600,"Sub-basin 3"
4116,200,16,3700,3900,"Sub-basin 3"
4117,100,1,1500,1600,"Sub-basin 3"
4118,100,3,1800,1900,"Sub-basin 3"
4119,300,6,3200,3500,"Sub-basin 3"
4120,100,6,800,900,"Sub-basin 3"
4121,200,4,1300,1500,"Sub-basin 3"
4122,200,5,500,700,"Sub-basin 3"
4123,5900,960.16,29600,35500,"Sub-basin 3"
4124,100,1,2100,2200,"Sub-basin 3"
4125,100,1,1600,1700,"Sub-basin 3"
4126,400,19,7100,7500,"Sub-basin 3"
4127,200,3,3800,4000,"Sub-basin 3"
4128,300,4,3300,3600,"Sub-basin 3"
4129,100,1,2300,2400,"Sub-basin 3"
4130,100,1,2900,3000,"Sub-basin 3"
4131,2700,185,20600,23300,"Sub-basin 3"
4132,300,3,3400,3700,"Sub-basin 3"
4133,300,17,3400,3700,"Sub-basin 3"
4134,200,2,4200,4400,"Sub-basin 3"
4135,100,2,700,800,"Sub-basin 3"
4136,1100,57.5,6400,7500,"Sub-basin 3"
4137,200,3,2700,2900,"Sub-basin 3"
4138,100,3,1200,1300,"Sub-basin 3"
4139,100,1,2500,2600,"Sub-basin 3"
4140,1200,42,13100,14300,"Sub-basin 3"
4141,300,12,2400,2700,"Sub-basin 3"
4142,400,8,8100,8500,"Sub-basin 3"
4143,100,2,2100,2200,"Sub-basin 3"
4144,700,13,11700,12400,"Sub-basin 3"
4145,100,1,2400,2500,"Sub-basin 3"
4146,100,2,2000,2100,"Sub-basin 3"
4147,100,1,1900,2000,"Sub-basin 3"
4148,100,1,2400,2500,"Sub-basin 3"
4149,100,1,1600,1700,"Sub-basin 3"
4150,200,3,2600,2800,"Sub-basin 3"
4151,100,3,2200,2300,"Sub-basin 3"
4152,100,2,700,800,"Sub-basin 3"
4153,300,13,1400,1700,"Sub-basin 3"
4154,200,14,3100,3300,"Sub-basin 3"
4155,300,5,5300,5600,"Sub-basin 3"
4156,900,21,20300,21200,"Sub-basin 3"
4157,500,29,3400,3900,"Sub-basin 3"
4158,400,14,8300,8700,"Sub-basin 3"
4159,100,2,1300,1400,"Sub-basin 3"
4160,100,1,4200,4300,"Sub-basin 3"
4161,1700,102,18500,20200,"Sub-basin 3"
4162,800,80,2500,3300,"Sub-basin 3"
4163,200,13,2000,2200,"Sub-basin 3"
4164,3000,171.17,24100,27100,"Sub-basin 3"
4165,300,9,5200,5500,"Sub-basin 3"
4166,300,5,4300,4600,"Sub-basin 3"
4167,400,24,4000,4400,"Sub-basin 3"
4168,100,7,1400,1500,"Sub-basin 3"
4169,6400,395.33,47200,53600,"Sub-basin 3"
4170,4000,233,21600,25600,"Sub-basin 3"
4171,100,1,1300,1400,"Sub-basin 3"
4172,300,4,6300,6600,"Sub-basin 3"
4173,100,2,1400,1500,"Sub-basin 3"
4174,100,1,3900,4000,"Sub-basin 3"
4175,200,5,5100,5300,"Sub-basin 3"
4176,100,2,1900,2000,"Sub-basin 3"
4177,600,20.5136,6700,7300,"Sub-basin 3"
4178,700,36,1700,2400,"Sub-basin 3"
4179,200,5,2400,2600,"Sub-basin 3"
4180,400,13,6500,6900,"Sub-basin 3"
4181,200,5,2600,2800,"Sub-basin 3"
4182,1000,162.33,3100,4100,"Sub-basin 3"
4183,100,2,2500,2600,"Sub-basin 3"
4184,700,38.84,1300,2000,"Sub-basin 3"
4185,2100,256,26100,28200,"Sub-basin 3"
4186,6000,860,46500,52500,"Sub-basin 3"
4187,200,11,3100,3300,"Sub-basin 3"
4188,100,1,1800,1900,"Sub-basin 3"
4189,100,2,1800,1900,"Sub-basin 3"
4190,1000,77,13300,14300,"Sub-basin 3"
4191,400,5,5900,6300,"Sub-basin 3"
4192,1300,153,13600,14900,"Sub-basin 3"
4193,1700,91,21800,23500,"Sub-basin 3"
4194,100,2,2300,2400,"Sub-basin 3"
4195,200,9,3600,3800,"Sub-basin 3"
4196,100,0.67,2900,3000,"Sub-basin 3"
4197,100,2,2500,2600,"Sub-basin 3"
4198,300,6.5,10300,10600,"Sub-basin 3"
4199,100,1,3200,3300,"Sub-basin 3"
4200,100,2,1000,1100,"Sub-basin 3"
4201,100,1,1500,1600,"Sub-basin 3"
4202,4300,424,23900,28200,"Sub-basin 3"
4203,300,7,3000,3300,"Sub-basin 3"
4204,100,1,1200,1300,"Sub-basin 3"
4205,800,23,6300,7100,"Sub-basin 3"
4206,300,7,7500,7800,"Sub-basin 3"
4207,100,1.5,2900,3000,"Sub-basin 3"
4208,300,5,4300,4600,"Sub-basin 3"
4209,1600,211,15600,17200,"Sub-basin 3"
4210,100,4,3800,3900,"Sub-basin 3"
4211,700,36,10100,10800,"Sub-basin 3"
4212,200,2,4400,4600,"Sub-basin 3"
4213,100,1,2800,2900,"Sub-basin 3"
4214,1100,142,11900,13000,"Sub-basin 3"
4215,100,2,3000,3100,"Sub-basin 3"
4216,300,4,5800,6100,"Sub-basin 3"
4217,10200,981,76000,86200,"Sub-basin 3"
4218,100,1,700,800,"Sub-basin 3"
4219,69900,17661,140500,210400,"Sub-basin 3"
4220,100,3,400,500,"Sub-basin 3"
4221,100,1,1300,1400,"Sub-basin 3"
4222,200,7,3700,3900,"Sub-basin 3"
4223,100,3,2800,2900,"Sub-basin 3"
4224,300,24,6700,7000,"Sub-basin 3"
4225,100,1,1800,1900,"Sub-basin 3"
4226,200,2,6500,6700,"Sub-basin 3"
4227,100,1,3500,3600,"Sub-basin 3"
4228,300,5,5300,5600,"Sub-basin 3"
4229,200,4,1900,2100,"Sub-basin 3"
4230,200,5.0028,3600,3800,"Sub-basin 3"
4231,100,1,700,800,"Sub-basin 3"
4232,100,2,1000,1100,"Sub-basin 3"
4233,400,11,5400,5800,"Sub-basin 3"
4234,900,47,10400,11300,"Sub-basin 3"
4235,100,1,1800,1900,"Sub-basin 3"
4236,200,4,4900,5100,"Sub-basin 3"
4237,300,11,12000,12300,"Sub-basin 3"
4238,400,11,4100,4500,"Sub-basin 3"
4239,1000,41,12900,13900,"Sub-basin 3"
4240,4200,596,27900,32100,"Sub-basin 3"
4241,2300,180,18800,21100,"Sub-basin 3"
4242,100,2,1400,1500,"Sub-basin 3"
4243,1100,171,4300,5400,"Sub-basin 3"
4244,400,13,2500,2900,"Sub-basin 3"
4245,200,9,1200,1400,"Sub-basin 3"
4246,100,2,700,800,"Sub-basin 3"
4247,400,14,1600,2000,"Sub-basin 3"
4248,600,41,2400,3000,"Sub-basin 3"
4249,100,1,2100,2200,"Sub-basin 3"
4250,200,2,3600,3800,"Sub-basin 3"
4251,100,1,1500,1600,"Sub-basin 3"
4252,200,3,5700,5900,"Sub-basin 3"
4253,100,2,2200,2300,"Sub-basin 3"
4254,100,1,2500,2600,"Sub-basin 3"
4255,100,1,1200,1300,"Sub-basin 3"
4256,100,1,2900,3000,"Sub-basin 3"
4257,100,2,3900,4000,"Sub-basin 3"
4258,100,4,3400,3500,"Sub-basin 3"
4259,600,66,12900,13500,"Sub-basin 3"
4260,200,11,4200,4400,"Sub-basin 3"
4261,100,2,1300,1400,"Sub-basin 3"
4262,100,11,1400,1500,"Sub-basin 3"
4263,100,1,1200,1300,"Sub-basin 3"
4264,100,1,1200,1300,"Sub-basin 3"
4265,300,3,2400,2700,"Sub-basin 3"
4266,200,10,1400,1600,"Sub-basin 3"
4267,900,54,19000,19900,"Sub-basin 3"
4268,500,14,4600,5100,"Sub-basin 3"
4269,100,1,2300,2400,"Sub-basin 3"
4270,100,3,2000,2100,"Sub-basin 3"
4271,300,24,5000,5300,"Sub-basin 3"
4272,500,18,8900,9400,"Sub-basin 3"
4273,800,17,19300,20100,"Sub-basin 3"
4274,1500,67,26900,28400,"Sub-basin 3"
4275,100,8,600,700,"Sub-basin 3"
4276,300,13,6900,7200,"Sub-basin 3"
4277,900,101,2600,3500,"Sub-basin 3"
4278,200,5,1600,1800,"Sub-basin 3"
4279,700,29,5600,6300,"Sub-basin 3"
4280,200,4,2500,2700,"Sub-basin 3"
4281,100,1,1700,1800,"Sub-basin 3"
4282,100,2,1200,1300,"Sub-basin 3"
4283,100,1,1600,1700,"Sub-basin 3"
4284,3700,162,38400,42100,"Sub-basin 3"
4285,300,7,3600,3900,"Sub-basin 3"
4286,100,3,1000,1100,"Sub-basin 3"
4287,300,10,5300,5600,"Sub-basin 3"
4288,300,14,3400,3700,"Sub-basin 3"
4289,3800,122,27300,31100,"Sub-basin 3"
4290,200,5,5400,5600,"Sub-basin 3"
4291,200,2,4700,4900,"Sub-basin 3"
4292,300,6,5900,6200,"Sub-basin 3"
4293,100,3,900,1000,"Sub-basin 3"
4294,200,5,1900,2100,"Sub-basin 3"
4295,4000,248,39300,43300,"Sub-basin 3"
4296,100,2,2600,2700,"Sub-basin 3"
4297,100,1,1700,1800,"Sub-basin 3"
4298,1200,46,11600,12800,"Sub-basin 3"
4299,100,2,1800,1900,"Sub-basin 3"
4300,100,2,1900,2000,"Sub-basin 3"
4301,300,9,3900,4200,"Sub-basin 3"
4302,400,17,8200,8600,"Sub-basin 3"
4303,200,3,3300,3500,"Sub-basin 3"
4304,100,3,3200,3300,"Sub-basin 3"
4305,100,1,2900,3000,"Sub-basin 3"
4306,1900,89,42600,44500,"Sub-basin 3"
4307,100,1,1600,1700,"Sub-basin 3"
4308,500,15,2000,2500,"Sub-basin 3"
4309,800,36,12000,12800,"Sub-basin 3"
4310,100,2.0032,1600,1700,"Sub-basin 3"
4311,500,18.024,5200,5700,"Sub-basin 3"
4312,100,1,1000,1100,"Sub-basin 3"
4313,100,2,1700,1800,"Sub-basin 3"
4314,1100,52,6200,7300,"Sub-basin 3"
4315,1000,30,19200,20200,"Sub-basin 3"
4316,200,3,4600,4800,"Sub-basin 3"
4317,100,2,1200,1300,"Sub-basin 3"
4318,200,13,3900,4100,"Sub-basin 3"
4319,100,2,3600,3700,"Sub-basin 3"
4320,300,9,5500,5800,"Sub-basin 3"
4321,16800,2150,51400,68200,"Sub-basin 3"
4322,100,1,1900,2000,"Sub-basin 3"
4323,1000,79,3300,4300,"Sub-basin 3"
4324,700,55,4200,4900,"Sub-basin 3"
4325,1500,76.5,20700,22200,"Sub-basin 3"
4326,200,8,3100,3300,"Sub-basin 3"
4327,100,1,1100,1200,"Sub-basin 3"
4328,500,22,2900,3400,"Sub-basin 3"
4329,400,10,2700,3100,"Sub-basin 3"
4330,400,13,5400,5800,"Sub-basin 3"
4331,100,2,1600,1700,"Sub-basin 3"
4332,100,2,3500,3600,"Sub-basin 3"
4333,300,21,5900,6200,"Sub-basin 3"
4334,2700,274,26800,29500,"Sub-basin 3"
4335,100,1,1500,1600,"Sub-basin 3"
4336,100,1,2600,2700,"Sub-basin 3"
4337,100,2,2000,2100,"Sub-basin 3"
4338,1400,105,15000,16400,"Sub-basin 3"
4339,100,1,800,900,"Sub-basin 3"
4340,900,64,6200,7100,"Sub-basin 3"
4341,100,1,2000,2100,"Sub-basin 3"
4342,2100,214,9200,11300,"Sub-basin 3"
4343,900,32,11100,12000,"Sub-basin 3"
4344,400,11,5200,5600,"Sub-basin 3"
4345,100,2,2200,2300,"Sub-basin 3"
4346,100,2,3000,3100,"Sub-basin 3"
4347,200,6,2700,2900,"Sub-basin 3"
4348,600,30,9400,10000,"Sub-basin 3"
4349,100,3,2000,2100,"Sub-basin 3"
4350,100,1,1600,1700,"Sub-basin 3"
4351,1000,64,11700,12700,"Sub-basin 3"
4352,300,5,2500,2800,"Sub-basin 3"
4353,100,2,2200,2300,"Sub-basin 3"
4354,900,27,10500,11400,"Sub-basin 3"
4355,100,1,1700,1800,"Sub-basin 3"
4356,400,86,2100,2500,"Sub-basin 3"
4357,1300,100,10200,11500,"Sub-basin 3"
4358,200,3,3600,3800,"Sub-basin 3"
4359,700,25,3000,3700,"Sub-basin 3"
4360,100,2.0017,1400,1500,"Sub-basin 3"
4361,4600,366,26600,31200,"Sub-basin 3"
4362,200,2,4500,4700,"Sub-basin 3"
4363,100,2,2400,2500,"Sub-basin 3"
4364,4700,309,47400,52100,"Sub-basin 3"
4365,300,8,3400,3700,"Sub-basin 3"
4366,800,33,14100,14900,"Sub-basin 3"
4367,200,5,5900,6100,"Sub-basin 3"
4368,200,2,4500,4700,"Sub-basin 3"
4369,100,3,3600,3700,"Sub-basin 3"
4370,200,27,2200,2400,"Sub-basin 3"
4371,100,3,700,800,"Sub-basin 3"
4372,800,36,9800,10600,"Sub-basin 3"
4373,100,1,700,800,"Sub-basin 3"
4374,200,8,2200,2400,"Sub-basin 3"
4375,200,16,800,1000,"Sub-basin 3"
4376,200,4,3600,3800,"Sub-basin 3"
4377,100,1,2000,2100,"Sub-basin 3"
4378,200,4,3900,4100,"Sub-basin 3"
4379,100,2,1500,1600,"Sub-basin 3"
4380,100,1,3600,3700,"Sub-basin 3"
4381,200,6,8000,8200,"Sub-basin 3"
4382,100,1,2600,2700,"Sub-basin 3"
4383,800,63,7500,8300,"Sub-basin 3"
4384,1700,55,3500,5200,"Sub-basin 3"
4385,200,5,3700,3900,"Sub-basin 3"
4386,100,1,1000,1100,"Sub-basin 3"
4387,1500,100,12900,14400,"Sub-basin 3"
4388,500,11.0104,6800,7300,"Sub-basin 3"
4389,1700,114,12700,14400,"Sub-basin 3"
4390,2300,166,9700,12000,"Sub-basin 3"
4391,100,1,700,800,"Sub-basin 3"
4392,200,2,2200,2400,"Sub-basin 3"
4393,200,3,5300,5500,"Sub-basin 3"
4394,100,2,3000,3100,"Sub-basin 3"
4395,100,3,3000,3100,"Sub-basin 3"
4396,100,1,3300,3400,"Sub-basin 3"
4397,600,57,1800,2400,"Sub-basin 3"
4398,300,8,1500,1800,"Sub-basin 3"
4399,100,2,2000,2100,"Sub-basin 3"
4400,100,1,1000,1100,"Sub-basin 3"
4401,1000,45.67,5200,6200,"Sub-basin 3"
4402,100,1,900,1000,"Sub-basin 3"
4403,200,8,3600,3800,"Sub-basin 3"
4404,100,3,2100,2200,"Sub-basin 3"
4405,100,2,1200,1300,"Sub-basin 3"
4406,100,1,2000,2100,"Sub-basin 3"
4407,1300,66,16500,17800,"Sub-basin 3"
4408,200,7,2800,3000,"Sub-basin 3"
4409,2700,208,36500,39200,"Sub-basin 3"
4410,200,3,3800,4000,"Sub-basin 3"
4411,300,6,10800,11100,"Sub-basin 3"
4412,100,1,1900,2000,"Sub-basin 3"
4413,200,12,3200,3400,"Sub-basin 3"
4414,200,4,2800,3000,"Sub-basin 3"
4415,600,29,1800,2400,"Sub-basin 3"
4416,400,16,8300,8700,"Sub-basin 3"
4417,500,8,6300,6800,"Sub-basin 3"
4418,100,5,800,900,"Sub-basin 3"
4419,900,80,7300,8200,"Sub-basin 3"
4420,100,1,2200,2300,"Sub-basin 3"
4421,100,2,900,1000,"Sub-basin 3"
4422,1000,27,14500,15500,"Sub-basin 3"
4423,200,5,1800,2000,"Sub-basin 3"
4424,300,18,4500,4800,"Sub-basin 3"
4425,7700,631,61500,69200,"Sub-basin 3"
4426,500,42,5500,6000,"Sub-basin 3"
4427,400,35,6400,6800,"Sub-basin 3"
4428,500,28,6900,7400,"Sub-basin 3"
4429,1700,207,20300,22000,"Sub-basin 3"
4430,300,7,5200,5500,"Sub-basin 3"
4431,1400,63,16400,17800,"Sub-basin 3"
4432,400,9,10900,11300,"Sub-basin 3"
4433,700,59,10600,11300,"Sub-basin 3"
4434,100,8,1400,1500,"Sub-basin 3"
4435,3000,203,11000,14000,"Sub-basin 3"
4436,100,2,500,600,"Sub-basin 3"
4437,400,12,6200,6600,"Sub-basin 3"
4438,100,1,2000,2100,"Sub-basin 3"
4439,400,34,4000,4400,"Sub-basin 3"
4440,100,2,1400,1500,"Sub-basin 3"
4441,100,3,2000,2100,"Sub-basin 3"
4442,700,24,8300,9000,"Sub-basin 3"
4443,200,4,3800,4000,"Sub-basin 3"
4444,300,7,10400,10700,"Sub-basin 3"
4445,100,1,2400,2500,"Sub-basin 3"
4446,200,3,4200,4400,"Sub-basin 3"
4447,100,1,2200,2300,"Sub-basin 3"
4448,100,2,3200,3300,"Sub-basin 3"
4449,500,11,4000,4500,"Sub-basin 3"
4450,100,1,1000,1100,"Sub-basin 3"
4451,300,12.0036,4600,4900,"Sub-basin 3"
4452,200,12,1100,1300,"Sub-basin 3"
4453,3700,572,24200,27900,"Sub-basin 3"
4454,300,7,3600,3900,"Sub-basin 3"
4455,100,3,1800,1900,"Sub-basin 3"
4456,200,3,4500,4700,"Sub-basin 3"
4457,100,1,1800,1900,"Sub-basin 3"
4458,61300,24484,105200,166500,"Sub-basin 3"
4459,700,13,1700,2400,"Sub-basin 3"
4460,2200,53,12400,14600,"Sub-basin 3"
4461,1400,62,27000,28400,"Sub-basin 3"
4462,100,1,1900,2000,"Sub-basin 3"
4463,100,1,1000,1100,"Sub-basin 3"
4464,100,6,1200,1300,"Sub-basin 3"
4465,100,1,1200,1300,"Sub-basin 3"
4466,300,18,4200,4500,"Sub-basin 3"
4467,200,3,1900,2100,"Sub-basin 3"
4468,500,20,5700,6200,"Sub-basin 3"
4469,200,5,4300,4500,"Sub-basin 3"
4470,200,5,4600,4800,"Sub-basin 3"
4471,300,6,5100,5400,"Sub-basin 3"
4472,100,1,1800,1900,"Sub-basin 3"
4473,200,5,3000,3200,"Sub-basin 3"
4474,100,1,2800,2900,"Sub-basin 3"
4475,100,1,1900,2000,"Sub-basin 3"
4476,100,1,1100,1200,"Sub-basin 3"
4477,500,13,8700,9200,"Sub-basin 3"
4478,1000,16,2500,3500,"Sub-basin 3"
4479,500,32,5700,6200,"Sub-basin 3"
4480,200,8,3500,3700,"Sub-basin 3"
4481,9100,710,33900,43000,"Sub-basin 3"
4482,100,2,1700,1800,"Sub-basin 3"
4483,300,8,4500,4800,"Sub-basin 3"
4484,200,3,5500,5700,"Sub-basin 3"
4485,400,32,5600,6000,"Sub-basin 3"
4486,100,3,2900,3000,"Sub-basin 3"
4487,100,4,1400,1500,"Sub-basin 3"
4488,100,3,1300,1400,"Sub-basin 3"
4489,200,3.0168,3300,3500,"Sub-basin 3"
4490,200,17,2700,2900,"Sub-basin 3"
4491,400,10,2800,3200,"Sub-basin 3"
4492,3500,192,33300,36800,"Sub-basin 3"
4493,200,13,4600,4800,"Sub-basin 3"
4494,700,40,11500,12200,"Sub-basin 3"
4495,2200,72,19300,21500,"Sub-basin 3"
4496,1500,96,17000,18500,"Sub-basin 3"
4497,900,35,13700,14600,"Sub-basin 3"
4498,200,4,3700,3900,"Sub-basin 3"
4499,100,1,2500,2600,"Sub-basin 3"
4500,600,42,5700,6300,"Sub-basin 3"
4501,200,2,3500,3700,"Sub-basin 3"
4502,300,6,8700,9000,"Sub-basin 3"
4503,200,2,5200,5400,"Sub-basin 3"
4504,100,2,1600,1700,"Sub-basin 3"
4505,200,3,2600,2800,"Sub-basin 3"
4506,700,22,7600,8300,"Sub-basin 3"
4507,400,14,2000,2400,"Sub-basin 3"
4508,900,72,6900,7800,"Sub-basin 3"
4509,300,4,300,600,"Sub-basin 3"
4510,400,7.0105,7600,8000,"Sub-basin 3"
4511,100,5,1700,1800,"Sub-basin 3"
4512,400,10,2200,2600,"Sub-basin 3"
4513,4800,341,29000,33800,"Sub-basin 3"
4514,600,39,9600,10200,"Sub-basin 3"
4515,100,1,3500,3600,"Sub-basin 3"
4516,100,1,3900,4000,"Sub-basin 3"
4517,100,2,2700,2800,"Sub-basin 3"
4518,300,9,2900,3200,"Sub-basin 3"
4519,900,26,5100,6000,"Sub-basin 3"
4520,100,1,800,900,"Sub-basin 3"
4521,100,2.0015,1200,1300,"Sub-basin 3"
4522,100,3,2000,2100,"Sub-basin 3"
4523,200,9,1700,1900,"Sub-basin 3"
4524,100,1,1400,1500,"Sub-basin 3"
4525,100,1,800,900,"Sub-basin 3"
4526,100,4,1100,1200,"Sub-basin 3"
4527,100,1,1600,1700,"Sub-basin 3"
4528,400,4,5200,5600,"Sub-basin 3"
4529,100,3,2800,2900,"Sub-basin 3"
4530,100,2,2000,2100,"Sub-basin 3"
4531,100,2,1900,2000,"Sub-basin 3"
4532,100,1,2700,2800,"Sub-basin 3"
4533,100,3,2600,2700,"Sub-basin 3"
4534,100,2,3700,3800,"Sub-basin 3"
4535,200,8,3800,4000,"Sub-basin 3"
4536,200,5,3300,3500,"Sub-basin 3"
4537,3100,224,39000,42100,"Sub-basin 3"
4538,300,4,1400,1700,"Sub-basin 3"
4539,1100,37,1900,3000,"Sub-basin 3"
4540,600,10,6700,7300,"Sub-basin 3"
4541,100,1,2300,2400,"Sub-basin 3"
4542,5400,500.2376,38100,43500,"Sub-basin 3"
4543,100,1.008,2000,2100,"Sub-basin 3"
4544,100,1,1700,1800,"Sub-basin 3"
4545,100,1,1000,1100,"Sub-basin 3"
4546,2200,423,15800,18000,"Sub-basin 3"
4547,100,1,800,900,"Sub-basin 3"
4548,400,17,6500,6900,"Sub-basin 3"
4549,46700,21974.99,63000,109700,"Sub-basin 3"
4550,100,2,1300,1400,"Sub-basin 3"
4551,3300,101,18200,21500,"Sub-basin 3"
4552,100,1,1400,1500,"Sub-basin 3"
4553,100,3.002,2300,2400,"Sub-basin 3"
4554,900,29.0269,9400,10300,"Sub-basin 3"
4555,100,2,700,800,"Sub-basin 3"
4556,300,10,1800,2100,"Sub-basin 3"
4557,2200,117,26200,28400,"Sub-basin 3"
4558,100,3,2700,2800,"Sub-basin 3"
4559,1100,28,17900,19000,"Sub-basin 3"
4560,500,20,4000,4500,"Sub-basin 3"
4561,100,1,6100,6200,"Sub-basin 3"
4562,200,5,4600,4800,"Sub-basin 3"
4563,500,32,7100,7600,"Sub-basin 3"
4564,900,53,14300,15200,"Sub-basin 3"
4565,300,7,2700,3000,"Sub-basin 3"
4566,300,8,4800,5100,"Sub-basin 3"
4567,1000,291,7200,8200,"Sub-basin 3"
4568,600,36,4900,5500,"Sub-basin 3"
4569,400,18,1700,2100,"Sub-basin 3"
4570,200,2,3400,3600,"Sub-basin 3"
4571,300,12,5700,6000,"Sub-basin 3"
4572,200,6,1300,1500,"Sub-basin 3"
4573,100,1,2900,3000,"Sub-basin 3"
4574,1000,43,16200,17200,"Sub-basin 3"
4575,1500,96,16700,18200,"Sub-basin 3"
4576,300,4,5900,6200,"Sub-basin 3"
4577,200,6,3700,3900,"Sub-basin 3"
4578,200,4,2400,2600,"Sub-basin 3"
4579,1600,128,15400,17000,"Sub-basin 3"
4580,200,4,2000,2200,"Sub-basin 3"
4581,400,92,2400,2800,"Sub-basin 3"
4582,7200,756,68500,75700,"Sub-basin 3"
4583,100,1,1400,1500,"Sub-basin 3"
4584,100,5,2600,2700,"Sub-basin 3"
4585,200,6.0032,3000,3200,"Sub-basin 3"
4586,500,54,2700,3200,"Sub-basin 3"
4587,600,26,1500,2100,"Sub-basin 3"
4588,400,9,2400,2800,"Sub-basin 3"
4589,200,2,2200,2400,"Sub-basin 3"
4590,800,68,11300,12100,"Sub-basin 3"
4591,200,14,1100,1300,"Sub-basin 3"
4592,800,13,10000,10800,"Sub-basin 3"
4593,100,1,3200,3300,"Sub-basin 3"
4594,100,3,2700,2800,"Sub-basin 3"
4595,100,3,900,1000,"Sub-basin 3"
4596,700,25,10900,11600,"Sub-basin 3"
4597,200,3,4400,4600,"Sub-basin 3"
4598,100,2,2300,2400,"Sub-basin 3"
4599,100,1,1700,1800,"Sub-basin 3"
4600,3800,551,21100,24900,"Sub-basin 3"
4601,100,2,1000,1100,"Sub-basin 3"
4602,600,29,3700,4300,"Sub-basin 3"
4603,2400,290,9100,11500,"Sub-basin 3"
4604,400,7,5600,6000,"Sub-basin 3"
4605,400,13,1900,2300,"Sub-basin 3"
4606,200,8,5400,5600,"Sub-basin 3"
4607,100,3,2000,2100,"Sub-basin 3"
4608,300,12,6200,6500,"Sub-basin 3"
4609,100,1,3500,3600,"Sub-basin 3"
4610,100,1,1900,2000,"Sub-basin 3"
4611,100,1,2900,3000,"Sub-basin 3"
4612,300,10,6200,6500,"Sub-basin 3"
4613,100,1,1600,1700,"Sub-basin 3"
4614,100,3,2400,2500,"Sub-basin 3"
4615,100,1,1500,1600,"Sub-basin 3"
4616,100,3,1800,1900,"Sub-basin 3"
4617,600,22.0102,8900,9500,"Sub-basin 3"
4618,800,38,2300,3100,"Sub-basin 3"
4619,100,1,1500,1600,"Sub-basin 3"
4620,200,6,3500,3700,"Sub-basin 3"
4621,600,9,10100,10700,"Sub-basin 3"
4622,300,8,1700,2000,"Sub-basin 3"
4623,100,2,4800,4900,"Sub-basin 3"
4624,200,4,3900,4100,"Sub-basin 3"
4625,100,1,2800,2900,"Sub-basin 3"
4626,400,8,11300,11700,"Sub-basin 3"
4627,2500,328,16500,19000,"Sub-basin 3"
4628,400,10,4200,4600,"Sub-basin 3"
4629,6800,976,101600,108400,"Sub-basin 3"
4630,100,6,800,900,"Sub-basin 3"
4631,600,15,5600,6200,"Sub-basin 3"
4632,100,2,1200,1300,"Sub-basin 3"
4633,2900,134.1849,28900,31800,"Sub-basin 3"
4634,500,37,4900,5400,"Sub-basin 3"
4635,300,10,2400,2700,"Sub-basin 3"
4636,300,11,1800,2100,"Sub-basin 3"
4637,200,6,3200,3400,"Sub-basin 3"
4638,800,36,10400,11200,"Sub-basin 3"
4639,1700,262,21300,23000,"Sub-basin 3"
4640,700,27,7800,8500,"Sub-basin 3"
4641,200,3,6900,7100,"Sub-basin 3"
4642,100,1,3600,3700,"Sub-basin 3"
4643,100,4,2200,2300,"Sub-basin 3"
4644,600,16,7100,7700,"Sub-basin 3"
4645,200,8,3300,3500,"Sub-basin 3"
4646,100,2,900,1000,"Sub-basin 3"
4647,800,85,2800,3600,"Sub-basin 3"
4648,300,33,3000,3300,"Sub-basin 3"
4649,200,5,4500,4700,"Sub-basin 3"
4650,200,5,2600,2800,"Sub-basin 3"
4651,100,1,1800,1900,"Sub-basin 3"
4652,200,5,3000,3200,"Sub-basin 3"
4653,300,4,3000,3300,"Sub-basin 3"
4654,300,5,3100,3400,"Sub-basin 3"
4655,100,1,3000,3100,"Sub-basin 3"
4656,400,10,8700,9100,"Sub-basin 3"
4657,1200,38,16200,17400,"Sub-basin 3"
4658,100,2,2100,2200,"Sub-basin 3"
4659,800,22,10400,11200,"Sub-basin 3"
4660,400,9,9200,9600,"Sub-basin 3"
4661,100,1,900,1000,"Sub-basin 3"
4662,200,8,2800,3000,"Sub-basin 3"
4663,200,7,2300,2500,"Sub-basin 3"
4664,700,81,5900,6600,"Sub-basin 3"
4665,300,8,3800,4100,"Sub-basin 3"
4666,100,2,1800,1900,"Sub-basin 3"
4667,300,5,5800,6100,"Sub-basin 3"
4668,300,11,4300,4600,"Sub-basin 3"
4669,100,2,3400,3500,"Sub-basin 3"
4670,100,2,3400,3500,"Sub-basin 3"
4671,200,3,2500,2700,"Sub-basin 3"
4672,100,1,3500,3600,"Sub-basin 3"
4673,100,1,1800,1900,"Sub-basin 3"
4674,200,3,3200,3400,"Sub-basin 3"
4675,200,6,2300,2500,"Sub-basin 3"
4676,900,32,8200,9100,"Sub-basin 3"
4677,400,10,8800,9200,"Sub-basin 3"
4678,500,9,3900,4400,"Sub-basin 3"
4679,200,8,2300,2500,"Sub-basin 3"
4680,100,1,4800,4900,"Sub-basin 3"
4681,100,4,2300,2400,"Sub-basin 3"
4682,100,2,4200,4300,"Sub-basin 3"
4683,100,1,900,1000,"Sub-basin 3"
4684,100,1,1900,2000,"Sub-basin 3"
4685,100,1,3200,3300,"Sub-basin 3"
4686,400,15,6500,6900,"Sub-basin 3"
4687,200,6,6000,6200,"Sub-basin 3"
4688,200,3,4400,4600,"Sub-basin 3"
4689,600,17,22100,22700,"Sub-basin 3"
4690,500,11,9200,9700,"Sub-basin 3"
4691,100,4,1000,1100,"Sub-basin 3"
4692,600,60,4500,5100,"Sub-basin 3"
4693,100,2,2000,2100,"Sub-basin 3"
4694,300,8.0037,4700,5000,"Sub-basin 3"
4695,400,4,2800,3200,"Sub-basin 3"
4696,100,1,1000,1100,"Sub-basin 3"
4697,100,3,1500,1600,"Sub-basin 3"
4698,500,28,1900,2400,"Sub-basin 3"
4699,100,1,1000,1100,"Sub-basin 3"
4700,100,2,2700,2800,"Sub-basin 3"
4701,400,8,6000,6400,"Sub-basin 3"
4702,100,2,2400,2500,"Sub-basin 3"
4703,600,29,7800,8400,"Sub-basin 3"
4704,100,3,800,900,"Sub-basin 3"
4705,100,2,1000,1100,"Sub-basin 3"
4706,200,2.0032,2000,2200,"Sub-basin 3"
4707,300,12,2700,3000,"Sub-basin 3"
4708,6800,916,19700,26500,"Sub-basin 3"
4709,800,33,1600,2400,"Sub-basin 3"
4710,100,1,3100,3200,"Sub-basin 3"
4711,100,1,2200,2300,"Sub-basin 3"
4712,4500,309,44900,49400,"Sub-basin 3"
4713,200,4,3400,3600,"Sub-basin 3"
4714,500,11,14600,15100,"Sub-basin 3"
4715,200,3,5100,5300,"Sub-basin 3"
4716,300,10,4600,4900,"Sub-basin 3"
4717,100,1,3000,3100,"Sub-basin 3"
4718,200,2,4200,4400,"Sub-basin 3"
4719,2500,197,20300,22800,"Sub-basin 3"
4720,100,1,1700,1800,"Sub-basin 3"
4721,800,31,10800,11600,"Sub-basin 3"
4722,100,3,1500,1600,"Sub-basin 3"
4723,100,1,2600,2700,"Sub-basin 3"
4724,100,4,3100,3200,"Sub-basin 3"
4725,100,4,700,800,"Sub-basin 3"
4726,3800,127,21200,25000,"Sub-basin 3"
4727,600,53,900,1500,"Sub-basin 3"
4728,700,34,5900,6600,"Sub-basin 3"
4729,500,14,7800,8300,"Sub-basin 3"
4730,100,1,1900,2000,"Sub-basin 3"
4731,200,5,2000,2200,"Sub-basin 3"
4732,300,8,3200,3500,"Sub-basin 3"
4733,300,11,3600,3900,"Sub-basin 3"
4734,100,1,2100,2200,"Sub-basin 3"
4735,10500,531,61400,71900,"Sub-basin 3"
4736,500,25,1800,2300,"Sub-basin 3"
4737,1100,49,7300,8400,"Sub-basin 3"
4738,200,3,2000,2200,"Sub-basin 3"
4739,100,1,2800,2900,"Sub-basin 3"
4740,100,1,2100,2200,"Sub-basin 3"
4741,100,1,2400,2500,"Sub-basin 3"
4742,100,3,2900,3000,"Sub-basin 3"
4743,300,10,3400,3700,"Sub-basin 3"
4744,400,8,5900,6300,"Sub-basin 3"
4745,200,4,3100,3300,"Sub-basin 3"
4746,400,19,4200,4600,"Sub-basin 3"
4747,300,10,3800,4100,"Sub-basin 3"
4748,200,7,900,1100,"Sub-basin 3"
4749,600,28,6600,7200,"Sub-basin 3"
4750,1500,132,11300,12800,"Sub-basin 3"
4751,600,41,2900,3500,"Sub-basin 3"
4752,200,4,3100,3300,"Sub-basin 3"
4753,400,19,2700,3100,"Sub-basin 3"
4754,100,2,1200,1300,"Sub-basin 3"
4755,700,16,6800,7500,"Sub-basin 3"
4756,100,1,1900,2000,"Sub-basin 3"
4757,300,5,6900,7200,"Sub-basin 3"
4758,100,1,1600,1700,"Sub-basin 3"
4759,100,3,2200,2300,"Sub-basin 3"
4760,300,7,4200,4500,"Sub-basin 3"
4761,1500,92,9200,10700,"Sub-basin 3"
4762,2200,202.16,14800,17000,"Sub-basin 3"
4763,200,2,3700,3900,"Sub-basin 3"
4764,4300,207,16000,20300,"Sub-basin 3"
4765,1200,27,4200,5400,"Sub-basin 3"
4766,500,15,5100,5600,"Sub-basin 3"
4767,100,1,300,400,"Sub-basin 3"
4768,13100,1240,98400,111500,"Sub-basin 3"
4769,300,7,6300,6600,"Sub-basin 3"
4770,200,5,1200,1400,"Sub-basin 3"
4771,400,8,5600,6000,"Sub-basin 3"
4772,200,5,4300,4500,"Sub-basin 3"
4773,100,1,1700,1800,"Sub-basin 3"
4774,300,7,5800,6100,"Sub-basin 3"
4775,100,1,3700,3800,"Sub-basin 3"
4776,200,2,4200,4400,"Sub-basin 3"
4777,300,17,2100,2400,"Sub-basin 3"
4778,1300,92,8900,10200,"Sub-basin 3"
4779,200,4,4200,4400,"Sub-basin 3"
4780,200,13,3400,3600,"Sub-basin 3"
4781,100,1,1100,1200,"Sub-basin 3"
4782,3700,230,35900,39600,"Sub-basin 3"
4783,200,4,3100,3300,"Sub-basin 3"
4784,200,2,3800,4000,"Sub-basin 3"
4785,1000,18,18900,19900,"Sub-basin 3"
4786,100,1,700,800,"Sub-basin 3"
4787,500,16,6000,6500,"Sub-basin 3"
4788,200,5,2300,2500,"Sub-basin 3"
4789,200,4,2600,2800,"Sub-basin 3"
4790,200,4,6300,6500,"Sub-basin 3"
4791,900,33,13600,14500,"Sub-basin 3"
4792,100,3,2400,2500,"Sub-basin 3"
4793,1200,102,18200,19400,"Sub-basin 3"
4794,3200,321,46900,50100,"Sub-basin 3"
4795,300,7,6400,6700,"Sub-basin 3"
4796,400,25,4100,4500,"Sub-basin 3"
4797,300,13.0087,4900,5200,"Sub-basin 3"
4798,300,20,1400,1700,"Sub-basin 3"
4799,900,149,6200,7100,"Sub-basin 3"
4800,200,2,3300,3500,"Sub-basin 3"
4801,2000,138,11700,13700,"Sub-basin 3"
4802,400,15,4400,4800,"Sub-basin 3"
4803,3500,200,16900,20400,"Sub-basin 3"
4804,100,2,1800,1900,"Sub-basin 3"
4805,300,4,6200,6500,"Sub-basin 3"
4806,100,1,1800,1900,"Sub-basin 3"
4807,200,4,3800,4000,"Sub-basin 3"
4808,100,3,2900,3000,"Sub-basin 3"
4809,400,5,4400,4800,"Sub-basin 3"
4810,200,15,4400,4600,"Sub-basin 3"
4811,600,61,5500,6100,"Sub-basin 3"
4812,100,4,2000,2100,"Sub-basin 3"
4813,2000,129,14200,16200,"Sub-basin 3"
4814,2000,110,19700,21700,"Sub-basin 3"
4815,2100,110,17300,19400,"Sub-basin 3"
4816,100,3,1300,1400,"Sub-basin 3"
4817,100,2,1600,1700,"Sub-basin 3"
4818,1100,41,8400,9500,"Sub-basin 3"
4819,100,4,1400,1500,"Sub-basin 3"
4820,400,11,4800,5200,"Sub-basin 3"
4821,100,2,1600,1700,"Sub-basin 3"
4822,200,6,4900,5100,"Sub-basin 3"
4823,100,1,1100,1200,"Sub-basin 3"
4824,300,4,5000,5300,"Sub-basin 3"
4825,200,6,8000,8200,"Sub-basin 3"
4826,100,1,2700,2800,"Sub-basin 3"
4827,100,2,1600,1700,"Sub-basin 3"
4828,100,4,1600,1700,"Sub-basin 3"
4829,200,4,1900,2100,"Sub-basin 3"
4830,500,10.0193,9500,10000,"Sub-basin 3"
4831,400,9,3600,4000,"Sub-basin 3"
4832,300,22,1000,1300,"Sub-basin 3"
4833,200,2,500,700,"Sub-basin 3"
4834,200,5,2300,2500,"Sub-basin 3"
4835,400,7,1800,2200,"Sub-basin 3"
4836,500,10,3000,3500,"Sub-basin 3"
4837,16700,1451,91100,107800,"Sub-basin 3"
4838,300,8,4300,4600,"Sub-basin 3"
4839,100,1,2200,2300,"Sub-basin 3"
4840,200,4,5400,5600,"Sub-basin 3"
4841,100,1,700,800,"Sub-basin 3"
4842,100,4,1900,2000,"Sub-basin 3"
4843,200,3,2300,2500,"Sub-basin 3"
4844,100,1,100,200,"Sub-basin 3"
4845,700,50,5400,6100,"Sub-basin 3"
4846,100,1,1800,1900,"Sub-basin 3"
4847,400,28,2500,2900,"Sub-basin 3"
4848,600,23,6700,7300,"Sub-basin 3"
4849,100,3,2500,2600,"Sub-basin 3"
4850,300,4,2700,3000,"Sub-basin 3"
4851,100,2,2200,2300,"Sub-basin 3"
4852,100,5,1800,1900,"Sub-basin 3"
4853,700,20,15700,16400,"Sub-basin 3"
4854,700,16,10000,10700,"Sub-basin 3"
4855,1000,69,8300,9300,"Sub-basin 3"
4856,300,15,2200,2500,"Sub-basin 3"
4857,300,6,2600,2900,"Sub-basin 3"
4858,100,3,600,700,"Sub-basin 3"
4859,500,30,5900,6400,"Sub-basin 3"
4860,1700,55,40900,42600,"Sub-basin 3"
4861,100,1,1800,1900,"Sub-basin 3"
4862,100,1,2100,2200,"Sub-basin 3"
4863,200,6,6900,7100,"Sub-basin 3"
4864,8300,1033,17200,25500,"Sub-basin 3"
4865,3100,701,8500,11600,"Sub-basin 3"
4866,100,2,1400,1500,"Sub-basin 3"
4867,400,24,1800,2200,"Sub-basin 3"
4868,15300,873.377,96700,112000,"Sub-basin 3"
4869,1000,77,7700,8700,"Sub-basin 3"
4870,1200,174,5800,7000,"Sub-basin 3"
4871,100,2,1300,1400,"Sub-basin 3"
4872,100,1,1400,1500,"Sub-basin 3"
4873,800,82,6100,6900,"Sub-basin 3"
4874,400,28,2900,3300,"Sub-basin 3"
4875,900,54,8500,9400,"Sub-basin 3"
4876,100,1,1300,1400,"Sub-basin 3"
4877,400,10,4400,4800,"Sub-basin 3"
4878,200,6,2300,2500,"Sub-basin 3"
4879,100,1,2500,2600,"Sub-basin 3"
4880,100,1,2300,2400,"Sub-basin 3"
4881,1100,45,9300,10400,"Sub-basin 3"
4882,100,4,2500,2600,"Sub-basin 3"
4883,200,2,5000,5200,"Sub-basin 3"
4884,300,9,4800,5100,"Sub-basin 3"
4885,800,27,16200,17000,"Sub-basin 3"
4886,100,1,1300,1400,"Sub-basin 3"
4887,100,2,2200,2300,"Sub-basin 3"
4888,7400,676,34100,41500,"Sub-basin 3"
4889,1800,191,14600,16400,"Sub-basin 3"
4890,100,1,2800,2900,"Sub-basin 3"
4891,300,9,500,800,"Sub-basin 3"
4892,200,4,800,1000,"Sub-basin 3"
4893,400,16,4500,4900,"Sub-basin 3"
4894,100,1,1700,1800,"Sub-basin 3"
4895,100,1,700,800,"Sub-basin 3"
4896,100,1,2800,2900,"Sub-basin 3"
4897,100,2,1400,1500,"Sub-basin 3"
4898,1500,246,24000,25500,"Sub-basin 3"
4899,1400,61,32800,34200,"Sub-basin 3"
4900,200,6,4700,4900,"Sub-basin 3"
4901,200,4,1000,1200,"Sub-basin 3"
4902,100,2,2300,2400,"Sub-basin 3"
4903,3600,731,7600,11200,"Sub-basin 3"
4904,500,269,4300,4800,"Sub-basin 3"
4905,400,14,4600,5000,"Sub-basin 3"
4906,3800,299,20200,24000,"Sub-basin 3"
4907,200,8,2000,2200,"Sub-basin 3"
4908,100,1,1300,1400,"Sub-basin 3"
4909,100,3,1100,1200,"Sub-basin 3"
4910,200,4,4600,4800,"Sub-basin 3"
4911,200,3,4400,4600,"Sub-basin 3"
4912,6600,781,36500,43100,"Sub-basin 3"
4913,200,4,2200,2400,"Sub-basin 3"
4914,300,4,6800,7100,"Sub-basin 3"
4915,400,16,14500,14900,"Sub-basin 3"
4916,100,1,4200,4300,"Sub-basin 3"
4917,100,8,2200,2300,"Sub-basin 3"
4918,200,6,5300,5500,"Sub-basin 3"
4919,200,2,3700,3900,"Sub-basin 3"
4920,200,8,2900,3100,"Sub-basin 3"
4921,200,4,3300,3500,"Sub-basin 3"
4922,800,57,5400,6200,"Sub-basin 3"
4923,300,6,3900,4200,"Sub-basin 3"
4924,300,6,7100,7400,"Sub-basin 3"
4925,100,2,700,800,"Sub-basin 3"
4926,200,5,5500,5700,"Sub-basin 3"
4927,200,3,6000,6200,"Sub-basin 3"
4928,400,10,8000,8400,"Sub-basin 3"
4929,500,18,7500,8000,"Sub-basin 3"
4930,100,2,1700,1800,"Sub-basin 3"
4931,200,7,2200,2400,"Sub-basin 3"
4932,200,3,3200,3400,"Sub-basin 3"
4933,100,1,1800,1900,"Sub-basin 3"
4934,100,1,900,1000,"Sub-basin 3"
4935,100,1,2100,2200,"Sub-basin 3"
4936,100,1,800,900,"Sub-basin 3"
4937,200,7,900,1100,"Sub-basin 3"
4938,200,9,2900,3100,"Sub-basin 3"
4939,200,4,4300,4500,"Sub-basin 3"
4940,100,2,1700,1800,"Sub-basin 3"
4941,300,17,3300,3600,"Sub-basin 3"
4942,300,15,5400,5700,"Sub-basin 3"
4943,300,11,5200,5500,"Sub-basin 3"
4944,200,2,1600,1800,"Sub-basin 3"
4945,200,5,600,800,"Sub-basin 3"
4946,3500,246,46600,50100,"Sub-basin 3"
4947,100,2,2000,2100,"Sub-basin 3"
4948,200,2,800,1000,"Sub-basin 3"
4949,200,3,2600,2800,"Sub-basin 3"
4950,100,1,1500,1600,"Sub-basin 3"
4951,100,1,1800,1900,"Sub-basin 3"
4952,200,3,2800,3000,"Sub-basin 3"
4953,300,6,8300,8600,"Sub-basin 3"
4954,8100,483,28500,36600,"Sub-basin 3"
4955,400,10,4600,5000,"Sub-basin 3"
4956,400,13,3600,4000,"Sub-basin 3"
4957,200,3,4000,4200,"Sub-basin 3"
4958,400,7,6900,7300,"Sub-basin 3"
4959,100,2,2100,2200,"Sub-basin 3"
4960,300,12,3200,3500,"Sub-basin 3"
4961,700,31,10000,10700,"Sub-basin 3"
4962,100,2,3700,3800,"Sub-basin 3"
4963,200,2,4300,4500,"Sub-basin 3"
4964,100,1,3000,3100,"Sub-basin 3"
4965,300,13,2500,2800,"Sub-basin 3"
4966,200,2,2600,2800,"Sub-basin 3"
4967,200,3,3600,3800,"Sub-basin 3"
4968,400,8,1900,2300,"Sub-basin 3"
4969,100,1,900,1000,"Sub-basin 3"
4970,900,30,17000,17900,"Sub-basin 3"
4971,100,1,2900,3000,"Sub-basin 3"
4972,100,3,2100,2200,"Sub-basin 3"
4973,300,6,4500,4800,"Sub-basin 3"
4974,100,3,2500,2600,"Sub-basin 3"
4975,100,2,900,1000,"Sub-basin 3"
4976,200,2,2900,3100,"Sub-basin 3"
4977,100,1,1600,1700,"Sub-basin 3"
4978,2200,455,8700,10900,"Sub-basin 3"
4979,1400,119,5400,6800,"Sub-basin 3"
4980,400,11,3700,4100,"Sub-basin 3"
4981,200,5,2900,3100,"Sub-basin 3"
4982,300,14,600,900,"Sub-basin 3"
4983,400,18,4500,4900,"Sub-basin 3"
4984,100,1,1600,1700,"Sub-basin 3"
4985,100,1,2100,2200,"Sub-basin 3"
4986,100,1,1300,1400,"Sub-basin 3"
4987,100,3,1600,1700,"Sub-basin 3"
4988,1400,64,10300,11700,"Sub-basin 3"
4989,300,5,3300,3600,"Sub-basin 3"
4990,200,3,3400,3600,"Sub-basin 3"
4991,200,5,3400,3600,"Sub-basin 3"
4992,100,1,1800,1900,"Sub-basin 3"
4993,100,1,2200,2300,"Sub-basin 3"
4994,700,18,17600,18300,"Sub-basin 3"
4995,100,1,1600,1700,"Sub-basin 3"
4996,100,1,2500,2600,"Sub-basin 3"
4997,700,56,10400,11100,"Sub-basin 3"
4998,200,3,6000,6200,"Sub-basin 3"
4999,100,1,1500,1600,"Sub-basin 3"
5000,300,5,2800,3100,"Sub-basin 3"
5001,100,1,1000,1100,"Sub-basin 3"
5002,300,10,3000,3300,"Sub-basin 3"
5003,200,2,2700,2900,"Sub-basin 3"
5004,200,12,1500,1700,"Sub-basin 3"
5005,600,32,7300,7900,"Sub-basin 3"
5006,200,7,2700,2900,"Sub-basin 3"
5007,400,7,5700,6100,"Sub-basin 3"
5008,2100,126,27800,29900,"Sub-basin 3"
5009,600,42,8900,9500,"Sub-basin 3"
5010,300,11,3700,4000,"Sub-basin 3"
5011,600,40,4600,5200,"Sub-basin 3"
5012,1400,114,15400,16800,"Sub-basin 3"
5013,2300,97,22600,24900,"Sub-basin 3"
5014,1000,23,23900,24900,"Sub-basin 3"
5015,800,26,12000,12800,"Sub-basin 3"
5016,100,2,3800,3900,"Sub-basin 3"
5017,200,4,3000,3200,"Sub-basin 3"
5018,100,1,3900,4000,"Sub-basin 3"
5019,300,11,4300,4600,"Sub-basin 3"
5020,100,3,1100,1200,"Sub-basin 3"
5021,100,6,1000,1100,"Sub-basin 3"
5022,400,13,6800,7200,"Sub-basin 3"
5023,200,10,4000,4200,"Sub-basin 3"
5024,100,4,1900,2000,"Sub-basin 3"
5025,500,28,4300,4800,"Sub-basin 3"
5026,300,19,6000,6300,"Sub-basin 3"
5027,200,9,2200,2400,"Sub-basin 3"
5028,400,23,2700,3100,"Sub-basin 3"
5029,100,1,1300,1400,"Sub-basin 3"
5030,100,4,2800,2900,"Sub-basin 3"
5031,500,29,5800,6300,"Sub-basin 3"
5032,600,20,4600,5200,"Sub-basin 3"
5033,200,4,4300,4500,"Sub-basin 3"
5034,200,4,4400,4600,"Sub-basin 3"
5035,100,1,1300,1400,"Sub-basin 3"
5036,200,4,3300,3500,"Sub-basin 3"
5037,9900,1893,29000,38900,"Sub-basin 3"
5038,2500,183,9900,12400,"Sub-basin 3"
5039,300,12,3200,3500,"Sub-basin 3"
5040,800,27,3900,4700,"Sub-basin 3"
5041,100,1,600,700,"Sub-basin 3"
5042,800,42,11200,12000,"Sub-basin 3"
5043,300,28,2700,3000,"Sub-basin 3"
5044,100,2,1000,1100,"Sub-basin 3"
5045,100,5,3900,4000,"Sub-basin 3"
5046,100,1,3400,3500,"Sub-basin 3"
5047,1000,61,14400,15400,"Sub-basin 3"
5048,100,1,2100,2200,"Sub-basin 3"
5049,100,2,2100,2200,"Sub-basin 3"
5050,5500,648,53800,59300,"Sub-basin 3"
5051,1900,95,10000,11900,"Sub-basin 3"
5052,900,32,5600,6500,"Sub-basin 3"
5053,100,1,200,300,"Sub-basin 3"
5054,200,2,1000,1200,"Sub-basin 3"
5055,100,1,1300,1400,"Sub-basin 3"
5056,100,2,2800,2900,"Sub-basin 3"
5057,200,6,3400,3600,"Sub-basin 3"
5058,100,3,2200,2300,"Sub-basin 3"
5059,300,5,5700,6000,"Sub-basin 3"
5060,200,4,1600,1800,"Sub-basin 3"
5061,200,2,2000,2200,"Sub-basin 3"
5062,400,13,1100,1500,"Sub-basin 3"
5063,1100,98,4500,5600,"Sub-basin 3"
5064,400,12,4500,4900,"Sub-basin 3"
5065,1400,84,7800,9200,"Sub-basin 3"
5066,200,3,2000,2200,"Sub-basin 3"
5067,200,5,2100,2300,"Sub-basin 3"
5068,100,1,800,900,"Sub-basin 3"
5069,1000,33,11400,12400,"Sub-basin 3"
5070,500,8,10000,10500,"Sub-basin 3"
5071,100,1,1400,1500,"Sub-basin 3"
5072,500,41,4600,5100,"Sub-basin 3"
5073,100,1,2400,2500,"Sub-basin 3"
5074,100,1,2700,2800,"Sub-basin 3"
5075,100,5,3100,3200,"Sub-basin 3"
5076,100,1,2900,3000,"Sub-basin 3"
5077,100,4,1100,1200,"Sub-basin 3"
5078,100,1,2000,2100,"Sub-basin 3"
5079,100,2,2000,2100,"Sub-basin 3"
5080,200,6,5700,5900,"Sub-basin 3"
5081,100,1,3500,3600,"Sub-basin 3"
5082,500,9,6000,6500,"Sub-basin 3"
5083,5700,338,35200,40900,"Sub-basin 3"
5084,200,7,2100,2300,"Sub-basin 3"
5085,400,38,3900,4300,"Sub-basin 3"
5086,1800,445,9200,11000,"Sub-basin 3"
5087,900,91,6700,7600,"Sub-basin 3"
5088,900,42,9800,10700,"Sub-basin 3"
5089,200,5,2000,2200,"Sub-basin 3"
5090,200,7,4800,5000,"Sub-basin 3"
5091,500,16,8600,9100,"Sub-basin 3"
5092,300,8,2600,2900,"Sub-basin 3"
5093,700,23,7700,8400,"Sub-basin 3"
5094,1100,64,7400,8500,"Sub-basin 3"
5095,1000,34,13400,14400,"Sub-basin 3"
5096,100,2,1600,1700,"Sub-basin 3"
5097,900,72,7800,8700,"Sub-basin 3"
5098,100,1,1800,1900,"Sub-basin 3"
5099,100,4,2400,2500,"Sub-basin 3"
5100,1700,83,35500,37200,"Sub-basin 3"
5101,400,9,12900,13300,"Sub-basin 3"
5102,200,10,4400,4600,"Sub-basin 3"
5103,100,4,1800,1900,"Sub-basin 3"
5104,300,13,3400,3700,"Sub-basin 3"
5105,100,1,1800,1900,"Sub-basin 3"
5106,100,3,700,800,"Sub-basin 3"
5107,100,1,2400,2500,"Sub-basin 3"
5108,300,11,3300,3600,"Sub-basin 3"
5109,300,9,3500,3800,"Sub-basin 3"
5110,100,1,2900,3000,"Sub-basin 3"
5111,300,6,3900,4200,"Sub-basin 3"
5112,800,19,19200,20000,"Sub-basin 3"
5113,300,11,6700,7000,"Sub-basin 3"
5114,100,2,2000,2100,"Sub-basin 3"
5115,300,9,5300,5600,"Sub-basin 3"
5116,1900,131,28900,30800,"Sub-basin 3"
5117,100,1,2300,2400,"Sub-basin 3"
5118,700,28,12800,13500,"Sub-basin 3"
5119,26600,1676,145400,172000,"Sub-basin 3"
5120,800,43,9300,10100,"Sub-basin 3"
5121,100,2,1400,1500,"Sub-basin 3"
5122,1000,74,5800,6800,"Sub-basin 3"
5123,500,23,2200,2700,"Sub-basin 3"
5124,600,75,2300,2900,"Sub-basin 3"
5125,600,91,3700,4300,"Sub-basin 3"
5126,100,1,1300,1400,"Sub-basin 3"
5127,100,4,4400,4500,"Sub-basin 3"
5128,200,7,2200,2400,"Sub-basin 3"
5129,100,1,2800,2900,"Sub-basin 3"
5130,200,2,1300,1500,"Sub-basin 3"
5131,300,6,10000,10300,"Sub-basin 3"
5132,900,64,9300,10200,"Sub-basin 3"
5133,2900,243,39200,42100,"Sub-basin 3"
5134,400,17,8200,8600,"Sub-basin 3"
5135,300,6,5200,5500,"Sub-basin 3"
5136,100,1,1000,1100,"Sub-basin 3"
5137,300,5,3800,4100,"Sub-basin 3"
5138,5100,736,17700,22800,"Sub-basin 3"
5139,200,11,3500,3700,"Sub-basin 3"
5140,200,4,1000,1200,"Sub-basin 3"
5141,2000,144,2400,4400,"Sub-basin 3"
5142,400,18,1600,2000,"Sub-basin 3"
5143,900,43,9000,9900,"Sub-basin 3"
5144,100,1,1700,1800,"Sub-basin 3"
5145,4000,301,30300,34300,"Sub-basin 3"
5146,100,1,1900,2000,"Sub-basin 3"
5147,800,32,7800,8600,"Sub-basin 3"
5148,800,22,10700,11500,"Sub-basin 3"
5149,100,3,4700,4800,"Sub-basin 3"
5150,300,7,4800,5100,"Sub-basin 3"
5151,300,6,5400,5700,"Sub-basin 3"
5152,1800,90,14100,15900,"Sub-basin 3"
5153,19300,3859,85600,104900,"Sub-basin 3"
5154,300,14,1800,2100,"Sub-basin 3"
5155,300,19,1100,1400,"Sub-basin 3"
5156,100,1,200,300,"Sub-basin 3"
5157,100,1,1700,1800,"Sub-basin 3"
5158,200,13,2200,2400,"Sub-basin 3"
5159,100,4,400,500,"Sub-basin 3"
5160,200,4,1400,1600,"Sub-basin 3"
5161,100,2,500,600,"Sub-basin 3"
5162,300,5,3500,3800,"Sub-basin 3"
5163,200,3,1500,1700,"Sub-basin 3"
5164,300,8,2900,3200,"Sub-basin 3"
5165,100,1,2800,2900,"Sub-basin 3"
5166,400,11,3300,3700,"Sub-basin 3"
5167,800,98,4600,5400,"Sub-basin 3"
5168,5300,760,26600,31900,"Sub-basin 3"
5169,100,2,500,600,"Sub-basin 3"
5170,100,6,1600,1700,"Sub-basin 3"
5171,100,1,700,800,"Sub-basin 3"
5172,100,3,900,1000,"Sub-basin 3"
5173,100,3,400,500,"Sub-basin 3"
5174,1300,358,7100,8400,"Sub-basin 3"
5175,700,67,9100,9800,"Sub-basin 3"
5176,500,21,3600,4100,"Sub-basin 3"
5177,600,50,6100,6700,"Sub-basin 3"
5178,100,1,2600,2700,"Sub-basin 3"
5179,400,8,3600,4000,"Sub-basin 3"
5180,100,7,2700,2800,"Sub-basin 3"
5181,100,1,1300,1400,"Sub-basin 3"
5182,100,1,3600,3700,"Sub-basin 3"
5183,900,23,15500,16400,"Sub-basin 3"
5184,600,390.1778,2100,2700,"Sub-basin 3"
5185,100,4,1500,1600,"Sub-basin 3"
5186,200,5,3200,3400,"Sub-basin 3"
5187,100,3,900,1000,"Sub-basin 3"
5188,100,5,2000,2100,"Sub-basin 3"
5189,300,11,900,1200,"Sub-basin 3"
5190,500,19,3200,3700,"Sub-basin 3"
5191,200,40,1700,1900,"Sub-basin 3"
5192,1700,298,10900,12600,"Sub-basin 3"
5193,800,61,8900,9700,"Sub-basin 3"
5194,100,1,2000,2100,"Sub-basin 3"
5195,100,1,500,600,"Sub-basin 3"
5196,100,4,1200,1300,"Sub-basin 3"
5197,200,8,1900,2100,"Sub-basin 3"
5198,100,1,1200,1300,"Sub-basin 3"
5199,200,2,3400,3600,"Sub-basin 3"
5200,2600,139,22800,25400,"Sub-basin 3"
5201,100,1,4100,4200,"Sub-basin 3"
5202,200,4,3900,4100,"Sub-basin 3"
5203,100,1,2400,2500,"Sub-basin 3"
5204,200,5,4700,4900,"Sub-basin 3"
5205,100,2,1500,1600,"Sub-basin 3"
5206,1100,40,22100,23200,"Sub-basin 3"
5207,200,7,1100,1300,"Sub-basin 3"
5208,2300,174,13900,16200,"Sub-basin 3"
5209,100,7,1100,1200,"Sub-basin 3"
5210,5100,477,48000,53100,"Sub-basin 3"
5211,100,2,2300,2400,"Sub-basin 3"
5212,100,1,1200,1300,"Sub-basin 3"
5213,200,24,2300,2500,"Sub-basin 3"
5214,100,2,400,500,"Sub-basin 3"
5215,100,1,1300,1400,"Sub-basin 3"
5216,400,69,4900,5300,"Sub-basin 3"
5217,2400,512,13800,16200,"Sub-basin 3"
5218,300,12,2600,2900,"Sub-basin 3"
5219,100,1,1100,1200,"Sub-basin 3"
5220,200,3,1600,1800,"Sub-basin 3"
5221,400,37,3000,3400,"Sub-basin 3"
5222,200,2,2200,2400,"Sub-basin 3"
5223,300,8,4900,5200,"Sub-basin 3"
5224,100,2,1100,1200,"Sub-basin 3"
5225,3900,712,15700,19600,"Sub-basin 3"
5226,600,30,10300,10900,"Sub-basin 3"
5227,700,24,5800,6500,"Sub-basin 3"
5228,200,4,2700,2900,"Sub-basin 3"
5229,100,4,1000,1100,"Sub-basin 3"
5230,100,1,700,800,"Sub-basin 3"
5231,200,10,1900,2100,"Sub-basin 3"
5232,300,17,2700,3000,"Sub-basin 3"
5233,200,5,2300,2500,"Sub-basin 3"
5234,300,6,4100,4400,"Sub-basin 3"
5235,400,21,2200,2600,"Sub-basin 3"
5236,200,22,2600,2800,"Sub-basin 3"
5237,400,28,2500,2900,"Sub-basin 3"
5238,300,11,4400,4700,"Sub-basin 3"
5239,600,12,6400,7000,"Sub-basin 3"
5240,1500,52,5800,7300,"Sub-basin 3"
5241,100,1,2500,2600,"Sub-basin 3"
5242,300,5,4900,5200,"Sub-basin 3"
5243,100,1,4100,4200,"Sub-basin 3"
5244,100,1,2100,2200,"Sub-basin 3"
5245,100,4,1900,2000,"Sub-basin 3"
5246,300,13,3600,3900,"Sub-basin 3"
5247,100,2,3100,3200,"Sub-basin 3"
5248,100,1,2300,2400,"Sub-basin 3"
5249,800,108,8700,9500,"Sub-basin 3"
5250,400,18,4000,4400,"Sub-basin 3"
5251,100,2,1900,2000,"Sub-basin 3"
5252,300,12,4000,4300,"Sub-basin 3"
5253,100,1,700,800,"Sub-basin 3"
5254,700,32,4400,5100,"Sub-basin 3"
5255,700,64,6000,6700,"Sub-basin 3"
5256,500,14,6200,6700,"Sub-basin 3"
5257,200,3,2200,2400,"Sub-basin 3"
5258,500,13,3600,4100,"Sub-basin 3"
5259,1600,40,9400,11000,"Sub-basin 3"
5260,2500,454,7600,10100,"Sub-basin 3"
5261,500,25,6600,7100,"Sub-basin 3"
5262,9300,1179,34100,43400,"Sub-basin 3"
5263,200,21,2100,2300,"Sub-basin 3"
5264,100,4,1800,1900,"Sub-basin 3"
5265,200,2.0035,2900,3100,"Sub-basin 3"
5266,100,8,800,900,"Sub-basin 3"
5267,100,3,800,900,"Sub-basin 3"
5268,400,14,4300,4700,"Sub-basin 3"
5269,100,4,1000,1100,"Sub-basin 3"
5270,200,14,1000,1200,"Sub-basin 3"
5271,100,1,2200,2300,"Sub-basin 3"
5272,500,23,7200,7700,"Sub-basin 3"
5273,100,1,900,1000,"Sub-basin 3"
5274,100,2,1300,1400,"Sub-basin 3"
5275,400,5,4200,4600,"Sub-basin 3"
5276,500,11,4500,5000,"Sub-basin 3"
5277,200,3,3500,3700,"Sub-basin 3"
5278,200,5,5000,5200,"Sub-basin 3"
5279,100,1,3800,3900,"Sub-basin 3"
5280,900,137,5200,6100,"Sub-basin 3"
5281,1100,76,8000,9100,"Sub-basin 3"
5282,100,3,1200,1300,"Sub-basin 3"
5283,2800,507,9400,12200,"Sub-basin 3"
5284,500,64,3800,4300,"Sub-basin 3"
5285,200,26,2900,3100,"Sub-basin 3"
5286,100,11,1500,1600,"Sub-basin 3"
5287,500,43,7900,8400,"Sub-basin 3"
5288,100,5,2200,2300,"Sub-basin 3"
5289,200,17,5200,5400,"Sub-basin 3"
5290,700,54,4300,5000,"Sub-basin 3"
5291,100,2,1200,1300,"Sub-basin 3"
5292,100,2,500,600,"Sub-basin 3"
5293,200,4,1100,1300,"Sub-basin 3"
5294,800,22,4500,5300,"Sub-basin 3"
5295,700,54,6800,7500,"Sub-basin 3"
5296,100,1,1200,1300,"Sub-basin 3"
5297,100,3,1900,2000,"Sub-basin 3"
5298,700,11,10000,10700,"Sub-basin 3"
5299,400,8,7200,7600,"Sub-basin 3"
5300,100,2,1600,1700,"Sub-basin 3"
5301,100,1,1100,1200,"Sub-basin 3"
5302,200,57,1200,1400,"Sub-basin 3"
5303,100,2,1400,1500,"Sub-basin 3"
5304,100,4,1600,1700,"Sub-basin 3"
5305,200,6.0002,4100,4300,"Sub-basin 3"
5306,600,74,7200,7800,"Sub-basin 3"
5307,100,2,1800,1900,"Sub-basin 3"
5308,200,12,2300,2500,"Sub-basin 3"
5309,100,3,1700,1800,"Sub-basin 3"
5310,300,6,1800,2100,"Sub-basin 3"
5311,900,37,6800,7700,"Sub-basin 3"
5312,100,3,2400,2500,"Sub-basin 3"
5313,100,3,2400,2500,"Sub-basin 3"
5314,100,2,2000,2100,"Sub-basin 3"
5315,400,13,6200,6600,"Sub-basin 3"
5316,300,4,9300,9600,"Sub-basin 3"
5317,100,3,1000,1100,"Sub-basin 3"
5318,400,12,3400,3800,"Sub-basin 3"
5319,200,8,1400,1600,"Sub-basin 3"
5320,100,4,900,1000,"Sub-basin 3"
5321,200,16,3900,4100,"Sub-basin 3"
5322,200,2,1600,1800,"Sub-basin 3"
5323,100,2,1700,1800,"Sub-basin 3"
5324,200,7,1600,1800,"Sub-basin 3"
5325,200,4,2200,2400,"Sub-basin 3"
5326,3500,269,21500,25000,"Sub-basin 3"
5327,400,15,4200,4600,"Sub-basin 3"
5328,700,65,6300,7000,"Sub-basin 3"
5329,1300,129,7400,8700,"Sub-basin 3"
5330,200,8,3500,3700,"Sub-basin 3"
5331,100,2,1400,1500,"Sub-basin 3"
5332,100,1,2100,2200,"Sub-basin 3"
5333,100,1,2300,2400,"Sub-basin 3"
5334,100,3,2800,2900,"Sub-basin 3"
5335,200,2,5400,5600,"Sub-basin 3"
5336,400,7,5900,6300,"Sub-basin 3"
5337,3200,236,25400,28600,"Sub-basin 3"
5338,200,5,2300,2500,"Sub-basin 3"
5339,200,4,4400,4600,"Sub-basin 3"
5340,200,16,8900,9100,"Sub-basin 3"
5341,500,36,9700,10200,"Sub-basin 3"
5342,100,2,2600,2700,"Sub-basin 3"
5343,600,6,14400,15000,"Sub-basin 3"
5344,100,1,2200,2300,"Sub-basin 3"
5345,200,3,1700,1900,"Sub-basin 3"
5346,300,4,3200,3500,"Sub-basin 3"
5347,1100,49.015,8400,9500,"Sub-basin 3"
5348,200,3,4200,4400,"Sub-basin 3"
5349,200,3,800,1000,"Sub-basin 3"
5350,500,43,5100,5600,"Sub-basin 3"
5351,100,1,500,600,"Sub-basin 3"
5352,400,29,2200,2600,"Sub-basin 3"
5353,400,18,1400,1800,"Sub-basin 3"
5354,100,2,6100,6200,"Sub-basin 3"
5355,100,2,1500,1600,"Sub-basin 3"
5356,700,27,5400,6100,"Sub-basin 3"
5357,2300,125,11800,14100,"Sub-basin 3"
5358,500,18,7400,7900,"Sub-basin 3"
5359,200,2,3000,3200,"Sub-basin 3"
5360,500,17,4000,4500,"Sub-basin 3"
5361,100,1,1200,1300,"Sub-basin 3"
5362,2000,197,4900,6900,"Sub-basin 3"
5363,200,5,4800,5000,"Sub-basin 3"
5364,2900,552,10900,13800,"Sub-basin 3"
5365,400,11,5000,5400,"Sub-basin 3"
5366,500,9,4500,5000,"Sub-basin 3"
5367,1500,166,3000,4500,"Sub-basin 3"
5368,500,18,2600,3100,"Sub-basin 3"
5369,2400,262,14600,17000,"Sub-basin 3"
5370,100,4,1700,1800,"Sub-basin 3"
5371,500,29,7900,8400,"Sub-basin 3"
5372,500,28,7100,7600,"Sub-basin 3"
5373,300,24,1400,1700,"Sub-basin 3"
5374,400,44,4600,5000,"Sub-basin 3"
5375,900,88,7500,8400,"Sub-basin 3"
5376,700,39,8900,9600,"Sub-basin 3"
5377,300,8,3700,4000,"Sub-basin 3"
5378,200,2,400,600,"Sub-basin 3"
5379,2100,100,24800,26900,"Sub-basin 3"
5380,100,1,2100,2200,"Sub-basin 3"
5381,200,3,6200,6400,"Sub-basin 3"
5382,200,3,2600,2800,"Sub-basin 3"
5383,200,4,3000,3200,"Sub-basin 3"
5384,200,2,7100,7300,"Sub-basin 3"
5385,200,3,3200,3400,"Sub-basin 3"
5386,2800,149,31600,34400,"Sub-basin 3"
5387,100,2,1600,1700,"Sub-basin 3"
5388,200,4,2800,3000,"Sub-basin 3"
5389,300,5,3800,4100,"Sub-basin 3"
5390,100,4,700,800,"Sub-basin 3"
5391,400,6,6400,6800,"Sub-basin 3"
5392,200,9,4200,4400,"Sub-basin 3"
5393,400,35,2800,3200,"Sub-basin 3"
5394,100,6,1000,1100,"Sub-basin 3"
5395,100,4,1000,1100,"Sub-basin 3"
5396,600,28,2400,3000,"Sub-basin 3"
5397,4900,350,22800,27700,"Sub-basin 3"
5398,100,1,1000,1100,"Sub-basin 3"
5399,500,22,5800,6300,"Sub-basin 3"
5400,400,18,3900,4300,"Sub-basin 3"
5401,1000,26,11100,12100,"Sub-basin 3"
5402,200,4,3900,4100,"Sub-basin 3"
5403,800,25,16300,17100,"Sub-basin 3"
5404,100,3,2300,2400,"Sub-basin 3"
5405,400,11,7600,8000,"Sub-basin 3"
5406,200,7,5700,5900,"Sub-basin 3"
5407,200,8,1800,2000,"Sub-basin 3"
5408,700,55,9400,10100,"Sub-basin 3"
5409,200,3,1800,2000,"Sub-basin 3"
5410,100,2,300,400,"Sub-basin 3"
5411,100,1,1700,1800,"Sub-basin 3"
5412,100,10,900,1000,"Sub-basin 3"
5413,100,1,200,300,"Sub-basin 3"
5414,1900,177,14900,16800,"Sub-basin 3"
5415,100,3,1500,1600,"Sub-basin 3"
5416,100,2,900,1000,"Sub-basin 3"
5417,300,4,1800,2100,"Sub-basin 3"
5418,600,42,1800,2400,"Sub-basin 3"
5419,400,28,3300,3700,"Sub-basin 3"
5420,100,2,1800,1900,"Sub-basin 3"
5421,100,1,2000,2100,"Sub-basin 3"
5422,200,3,1700,1900,"Sub-basin 3"
5423,300,4,5600,5900,"Sub-basin 3"
5424,100,1,1800,1900,"Sub-basin 3"
5425,100,1,2800,2900,"Sub-basin 3"
5426,200,5,2200,2400,"Sub-basin 3"
5427,2000,161,26100,28100,"Sub-basin 3"
5428,2200,203,18800,21000,"Sub-basin 3"
5429,100,2,700,800,"Sub-basin 3"
5430,500,55,1300,1800,"Sub-basin 3"
5431,400,27,2500,2900,"Sub-basin 3"
5432,100,1,1700,1800,"Sub-basin 3"
5433,400,30,4000,4400,"Sub-basin 3"
5434,2000,451,15600,17600,"Sub-basin 3"
5435,100,4,2000,2100,"Sub-basin 3"
5436,100,2,2300,2400,"Sub-basin 3"
5437,300,13,3700,4000,"Sub-basin 3"
5438,200,5,1000,1200,"Sub-basin 3"
5439,500,14,6400,6900,"Sub-basin 3"
5440,1900,77,17100,19000,"Sub-basin 3"
5441,100,1,1500,1600,"Sub-basin 3"
5442,1100,70,5000,6100,"Sub-basin 3"
5443,100,3,2600,2700,"Sub-basin 3"
5444,1300,117,10400,11700,"Sub-basin 3"
5445,500,17,1200,1700,"Sub-basin 3"
5446,900,53,5800,6700,"Sub-basin 3"
5447,100,2,1400,1500,"Sub-basin 3"
5448,100,2,2000,2100,"Sub-basin 3"
5449,500,16,5200,5700,"Sub-basin 3"
5450,100,1,1300,1400,"Sub-basin 3"
5451,500,14,10900,11400,"Sub-basin 3"
5452,100,1,2100,2200,"Sub-basin 3"
5453,600,19,10200,10800,"Sub-basin 3"
5454,400,19,4500,4900,"Sub-basin 3"
5455,100,14,1200,1300,"Sub-basin 3"
5456,400,10.0074,6800,7200,"Sub-basin 3"
5457,1000,97,5700,6700,"Sub-basin 3"
5458,500,16,3700,4200,"Sub-basin 3"
5459,4000,399,16900,20900,"Sub-basin 3"
5460,3600,190,12700,16300,"Sub-basin 3"
5461,100,1,500,600,"Sub-basin 3"
5462,300,8,3900,4200,"Sub-basin 3"
5463,300,6,2100,2400,"Sub-basin 3"
5464,100,5,1500,1600,"Sub-basin 3"
5465,600,24,4300,4900,"Sub-basin 3"
5466,100,7,700,800,"Sub-basin 3"
5467,100,1,1000,1100,"Sub-basin 3"
5468,100,1,1800,1900,"Sub-basin 3"
5469,100,1,1200,1300,"Sub-basin 3"
5470,600,16,4600,5200,"Sub-basin 3"
5471,100,1,1100,1200,"Sub-basin 3"
5472,300,3,5200,5500,"Sub-basin 3"
5473,300,5,4000,4300,"Sub-basin 3"
5474,6000,265,81400,87400,"Sub-basin 3"
5475,200,3,8200,8400,"Sub-basin 3"
5476,100,1,2000,2100,"Sub-basin 3"
5477,900,43,8200,9100,"Sub-basin 3"
5478,100,1,1400,1500,"Sub-basin 3"
5479,300,6,2800,3100,"Sub-basin 3"
5480,200,4,3100,3300,"Sub-basin 3"
5481,100,1,1600,1700,"Sub-basin 3"
5482,100,1,1200,1300,"Sub-basin 3"
5483,100,1,400,500,"Sub-basin 3"
5484,100,2,4600,4700,"Sub-basin 3"
5485,100,1,1600,1700,"Sub-basin 3"
5486,100,5,1000,1100,"Sub-basin 3"
5487,300,19,700,1000,"Sub-basin 3"
5488,100,2,1500,1600,"Sub-basin 3"
5489,300,5,5700,6000,"Sub-basin 3"
5490,100,1,1000,1100,"Sub-basin 3"
5491,100,1,3400,3500,"Sub-basin 3"
5492,200,6,4700,4900,"Sub-basin 3"
5493,100,2,900,1000,"Sub-basin 3"
5494,300,6,4200,4500,"Sub-basin 3"
5495,1300,94,12100,13400,"Sub-basin 3"
5496,100,3,200,300,"Sub-basin 3"
5497,200,3,1200,1400,"Sub-basin 3"
5498,400,13,2500,2900,"Sub-basin 3"
5499,100,3,200,300,"Sub-basin 3"
5500,23700,5988,69300,93000,"Sub-basin 3"
5501,300,14,3600,3900,"Sub-basin 3"
5502,100,3,1500,1600,"Sub-basin 3"
5503,100,2,1000,1100,"Sub-basin 3"
5504,400,42,3600,4000,"Sub-basin 3"
5505,300,17,3300,3600,"Sub-basin 3"
5506,200,19,2600,2800,"Sub-basin 3"
5507,200,4,1300,1500,"Sub-basin 3"
5508,100,2,1400,1500,"Sub-basin 3"
5509,100,2,2000,2100,"Sub-basin 3"
5510,100,2,1600,1700,"Sub-basin 3"
5511,500,27,7900,8400,"Sub-basin 3"
5512,100,1,1700,1800,"Sub-basin 3"
5513,100,1,3500,3600,"Sub-basin 3"
5514,1700,51,36400,38100,"Sub-basin 3"
5515,100,3,1800,1900,"Sub-basin 3"
5516,3200,387,22500,25700,"Sub-basin 3"
5517,200,10,2300,2500,"Sub-basin 3"
5518,3300,667,14100,17400,"Sub-basin 3"
5519,300,5,4000,4300,"Sub-basin 3"
5520,100,2.002,3300,3400,"Sub-basin 3"
5521,400,17,2000,2400,"Sub-basin 3"
5522,2100,102,14700,16800,"Sub-basin 3"
5523,300,6,1800,2100,"Sub-basin 3"
5524,100,1,2700,2800,"Sub-basin 3"
5525,700,45,3600,4300,"Sub-basin 3"
5526,100,11,1700,1800,"Sub-basin 3"
5527,5600,412,29300,34900,"Sub-basin 3"
5528,100,2,600,700,"Sub-basin 3"
5529,100,2,900,1000,"Sub-basin 3"
5530,200,12,1700,1900,"Sub-basin 3"
5531,900,61,5500,6400,"Sub-basin 3"
5532,100,3,1300,1400,"Sub-basin 3"
5533,100,1,1100,1200,"Sub-basin 3"
5534,100,4,1500,1600,"Sub-basin 3"
5535,900,104,5800,6700,"Sub-basin 3"
5536,700,32,5700,6400,"Sub-basin 3"
5537,400,15,5100,5500,"Sub-basin 3"
5538,1300,63,17700,19000,"Sub-basin 3"
5539,600,13,13700,14300,"Sub-basin 3"
5540,100,1,3400,3500,"Sub-basin 3"
5541,200,9,3100,3300,"Sub-basin 3"
5542,100,1,3700,3800,"Sub-basin 3"
5543,100,5,1600,1700,"Sub-basin 3"
5544,1100,83,10300,11400,"Sub-basin 3"
5545,600,65,3200,3800,"Sub-basin 3"
5546,600,44,3900,4500,"Sub-basin 3"
5547,100,1,2400,2500,"Sub-basin 3"
5548,1000,28,8100,9100,"Sub-basin 3"
5549,200,8,3600,3800,"Sub-basin 3"
5550,100,4,1800,1900,"Sub-basin 3"
5551,400,6,3600,4000,"Sub-basin 3"
5552,4200,238.17,49700,53900,"Sub-basin 3"
5553,100,1,1200,1300,"Sub-basin 3"
5554,100,1,1800,1900,"Sub-basin 3"
5555,100,6,900,1000,"Sub-basin 3"
5556,100,8,2000,2100,"Sub-basin 3"
5557,400,37,3100,3500,"Sub-basin 3"
5558,300,20,2700,3000,"Sub-basin 3"
5559,300,22,3200,3500,"Sub-basin 3"
5560,100,10,1500,1600,"Sub-basin 3"
5561,100,7,1100,1200,"Sub-basin 3"
5562,500,13,3600,4100,"Sub-basin 3"
5563,300,10,3100,3400,"Sub-basin 3"
5564,100,3,500,600,"Sub-basin 3"
5565,100,2,1900,2000,"Sub-basin 3"
5566,100,1,2600,2700,"Sub-basin 3"
5567,300,5,6300,6600,"Sub-basin 3"
5568,1300,61,11200,12500,"Sub-basin 3"
5569,100,4,5800,5900,"Sub-basin 3"
5570,100,1,2900,3000,"Sub-basin 3"
5571,300,13,1200,1500,"Sub-basin 3"
5572,100,5,1600,1700,"Sub-basin 3"
5573,100,1,1300,1400,"Sub-basin 3"
5574,500,8.0128,7100,7600,"Sub-basin 3"
5575,100,1,1100,1200,"Sub-basin 3"
5576,3100,356,14000,17100,"Sub-basin 3"
5577,500,14,5600,6100,"Sub-basin 3"
5578,200,2,2300,2500,"Sub-basin 3"
5579,400,21,3900,4300,"Sub-basin 3"
5580,900,25,6400,7300,"Sub-basin 3"
5581,400,10.36,2200,2600,"Sub-basin 3"
5582,200,13,1800,2000,"Sub-basin 3"
5583,10200,2110,43800,54000,"Sub-basin 3"
5584,300,20,2300,2600,"Sub-basin 3"
5585,400,30,1100,1500,"Sub-basin 3"
5586,100,2,800,900,"Sub-basin 3"
5587,100,1,1900,2000,"Sub-basin 3"
5588,1100,110,7900,9000,"Sub-basin 3"
5589,200,4,3700,3900,"Sub-basin 3"
5590,500,20,5600,6100,"Sub-basin 3"
5591,100,1,4200,4300,"Sub-basin 3"
5592,100,2,1400,1500,"Sub-basin 3"
5593,700,26,13200,13900,"Sub-basin 3"
5594,100,2,1400,1500,"Sub-basin 3"
5595,600,33,5500,6100,"Sub-basin 3"
5596,900,72,3900,4800,"Sub-basin 3"
5597,400,18,2100,2500,"Sub-basin 3"
5598,400,22,4400,4800,"Sub-basin 3"
5599,100,1,1600,1700,"Sub-basin 3"
5600,400,36,3600,4000,"Sub-basin 3"
5601,100,2,1900,2000,"Sub-basin 3"
5602,100,1,1000,1100,"Sub-basin 3"
5603,500,44,3900,4400,"Sub-basin 3"
5604,600,57,7100,7700,"Sub-basin 3"
5605,300,45,2700,3000,"Sub-basin 3"
5606,200,5,1200,1400,"Sub-basin 3"
5607,200,9,4300,4500,"Sub-basin 3"
5608,100,1,2100,2200,"Sub-basin 3"
5609,800,34,11300,12100,"Sub-basin 3"
5610,100,3,3100,3200,"Sub-basin 3"
5611,100,4,2300,2400,"Sub-basin 3"
5612,300,10,5500,5800,"Sub-basin 3"
5613,300,8,2900,3200,"Sub-basin 3"
5614,500,11.0102,7300,7800,"Sub-basin 3"
5615,200,7,3900,4100,"Sub-basin 3"
5616,1300,95,4500,5800,"Sub-basin 3"
5617,1000,52,3700,4700,"Sub-basin 3"
5618,200,39,3700,3900,"Sub-basin 3"
5619,500,77,6900,7400,"Sub-basin 3"
5620,4000,408.17,54800,58800,"Sub-basin 3"
5621,100,2,3900,4000,"Sub-basin 3"
5622,200,7,1200,1400,"Sub-basin 3"
5623,100,3,2400,2500,"Sub-basin 3"
5624,1800,53,27100,28900,"Sub-basin 3"
5625,200,2,2800,3000,"Sub-basin 3"
5626,2500,145,20100,22600,"Sub-basin 3"
5627,200,6,3000,3200,"Sub-basin 3"
5628,700,37,5100,5800,"Sub-basin 3"
5629,100,3,2200,2300,"Sub-basin 3"
5630,900,51,4700,5600,"Sub-basin 3"
5631,400,18,3200,3600,"Sub-basin 3"
5632,300,14,2200,2500,"Sub-basin 3"
5633,200,3,1900,2100,"Sub-basin 3"
5634,300,6,2500,2800,"Sub-basin 3"
5635,100,3,600,700,"Sub-basin 3"
5636,200,3,4200,4400,"Sub-basin 3"
5637,300,14,5700,6000,"Sub-basin 3"
5638,900,58,8900,9800,"Sub-basin 3"
5639,100,2,2300,2400,"Sub-basin 3"
5640,300,5,3000,3300,"Sub-basin 3"
5641,600,17,6400,7000,"Sub-basin 3"
5642,100,2,2100,2200,"Sub-basin 3"
5643,100,2,2100,2200,"Sub-basin 3"
5644,500,17,5100,5600,"Sub-basin 3"
5645,800,36,12600,13400,"Sub-basin 3"
5646,200,4,5800,6000,"Sub-basin 3"
5647,200,5,2800,3000,"Sub-basin 3"
5648,100,7,900,1000,"Sub-basin 3"
5649,100,3,3100,3200,"Sub-basin 3"
5650,700,42,11700,12400,"Sub-basin 3"
5651,100,2,3900,4000,"Sub-basin 3"
5652,100,11,800,900,"Sub-basin 3"
5653,900,86,12000,12900,"Sub-basin 3"
5654,100,1,2600,2700,"Sub-basin 3"
5655,200,11,5600,5800,"Sub-basin 3"
5656,200,15,1800,2000,"Sub-basin 3"
5657,500,19,6900,7400,"Sub-basin 3"
5658,500,46,4300,4800,"Sub-basin 3"
5659,200,27,1000,1200,"Sub-basin 3"
5660,100,2,2400,2500,"Sub-basin 3"
5661,100,2,1500,1600,"Sub-basin 3"
5662,100,2,1900,2000,"Sub-basin 3"
5663,4700,661,35600,40300,"Sub-basin 3"
5664,3000,670,12100,15100,"Sub-basin 3"
5665,200,17,700,900,"Sub-basin 3"
5666,100,4,1200,1300,"Sub-basin 3"
5667,200,8,2400,2600,"Sub-basin 3"
5668,100,2,1300,1400,"Sub-basin 3"
5669,300,6,5900,6200,"Sub-basin 3"
5670,100,1,1500,1600,"Sub-basin 3"
5671,100,1,2300,2400,"Sub-basin 3"
5672,100,1,1600,1700,"Sub-basin 3"
5673,200,2,3300,3500,"Sub-basin 3"
5674,100,3,1900,2000,"Sub-basin 3"
5675,100,2,2300,2400,"Sub-basin 3"
5676,200,12,2900,3100,"Sub-basin 3"
5677,100,1,1000,1100,"Sub-basin 3"
5678,2400,85,40900,43300,"Sub-basin 3"
5679,400,20,2400,2800,"Sub-basin 3"
5680,100,4,1600,1700,"Sub-basin 3"
5681,400,28,3700,4100,"Sub-basin 3"
5682,200,4,1600,1800,"Sub-basin 3"
5683,1200,120,4900,6100,"Sub-basin 3"
5684,100,2,3000,3100,"Sub-basin 3"
5685,100,3,1400,1500,"Sub-basin 3"
5686,400,21,6300,6700,"Sub-basin 3"
5687,500,13.0066,7900,8400,"Sub-basin 3"
5688,1700,164,6000,7700,"Sub-basin 3"
5689,3600,347,13400,17000,"Sub-basin 3"
5690,100,2,2000,2100,"Sub-basin 3"
5691,300,8,3100,3400,"Sub-basin 3"
5692,100,2,1000,1100,"Sub-basin 3"
5693,100,2,1400,1500,"Sub-basin 3"
5694,100,1,2200,2300,"Sub-basin 3"
5695,100,2,2500,2600,"Sub-basin 3"
5696,1400,151,19100,20500,"Sub-basin 3"
5697,300,10,10100,10400,"Sub-basin 3"
5698,200,3,2800,3000,"Sub-basin 3"
5699,100,5,2600,2700,"Sub-basin 3"
5700,200,8,1900,2100,"Sub-basin 3"
5701,100,1,2000,2100,"Sub-basin 3"
5702,100,2,1300,1400,"Sub-basin 3"
5703,300,21,3700,4000,"Sub-basin 3"
5704,400,17,1300,1700,"Sub-basin 3"
5705,200,6,5300,5500,"Sub-basin 3"
5706,100,3,1900,2000,"Sub-basin 3"
5707,100,4,500,600,"Sub-basin 3"
5708,1000,51,11300,12300,"Sub-basin 3"
5709,100,4,1700,1800,"Sub-basin 3"
5710,100,3,1100,1200,"Sub-basin 3"
5711,200,4,2600,2800,"Sub-basin 3"
5712,100,1,2000,2100,"Sub-basin 3"
5713,1400,96,9000,10400,"Sub-basin 3"
5714,100,1,3100,3200,"Sub-basin 3"
5715,200,8,700,900,"Sub-basin 3"
5716,900,27,8900,9800,"Sub-basin 3"
5717,500,24,3700,4200,"Sub-basin 3"
5718,300,10,4300,4600,"Sub-basin 3"
5719,100,2,2800,2900,"Sub-basin 3"
5720,200,6,1800,2000,"Sub-basin 3"
5721,200,5,1300,1500,"Sub-basin 3"
5722,100,2,1000,1100,"Sub-basin 3"
5723,100,4,2400,2500,"Sub-basin 3"
5724,100,1,800,900,"Sub-basin 3"
5725,300,14,1200,1500,"Sub-basin 3"
5726,200,4,2500,2700,"Sub-basin 3"
5727,100,1,2400,2500,"Sub-basin 3"
5728,200,2,3500,3700,"Sub-basin 3"
5729,100,1,3100,3200,"Sub-basin 3"
5730,3000,316,23000,26000,"Sub-basin 3"
5731,100,1,2600,2700,"Sub-basin 3"
5732,100,1,1200,1300,"Sub-basin 3"
5733,1800,213,6100,7900,"Sub-basin 3"
5734,14500,1964,22100,36600,"Sub-basin 3"
5735,400,16,5700,6100,"Sub-basin 3"
5736,700,71,3800,4500,"Sub-basin 3"
5737,100,1,1800,1900,"Sub-basin 3"
5738,800,48,2900,3700,"Sub-basin 3"
5739,4300,202.5,40200,44500,"Sub-basin 3"
5740,1100,59,5900,7000,"Sub-basin 3"
5741,200,2,2800,3000,"Sub-basin 3"
5742,200,4,1400,1600,"Sub-basin 3"
5743,100,3,2000,2100,"Sub-basin 3"
5744,500,65,1900,2400,"Sub-basin 3"
5745,1800,123,8900,10700,"Sub-basin 3"
5746,600,62,6400,7000,"Sub-basin 3"
5747,900,80,7800,8700,"Sub-basin 3"
5748,100,1,600,700,"Sub-basin 3"
5749,200,14,2700,2900,"Sub-basin 3"
5750,100,2,2400,2500,"Sub-basin 3"
5751,600,27,9200,9800,"Sub-basin 3"
5752,900,33,16400,17300,"Sub-basin 3"
5753,400,21,3700,4100,"Sub-basin 3"
5754,100,3,2300,2400,"Sub-basin 3"
5755,400,10.83,4700,5100,"Sub-basin 3"
5756,900,36,10200,11100,"Sub-basin 3"
5757,100,1,2600,2700,"Sub-basin 3"
5758,200,2,3300,3500,"Sub-basin 3"
5759,100,4,1500,1600,"Sub-basin 3"
5760,100,1,2800,2900,"Sub-basin 3"
5761,900,26,17700,18600,"Sub-basin 3"
5762,900,76,9400,10300,"Sub-basin 3"
5763,8400,869,26800,35200,"Sub-basin 3"
5764,100,3,1400,1500,"Sub-basin 3"
5765,100,2,3400,3500,"Sub-basin 3"
5766,200,7,4600,4800,"Sub-basin 3"
5767,100,6,2300,2400,"Sub-basin 3"
5768,200,11,2700,2900,"Sub-basin 3"
5769,200,3,2900,3100,"Sub-basin 3"
5770,400,16,4000,4400,"Sub-basin 3"
5771,200,5,5400,5600,"Sub-basin 3"
5772,900,45,11700,12600,"Sub-basin 3"
5773,400,24,7000,7400,"Sub-basin 3"
5774,300,8,2800,3100,"Sub-basin 3"
5775,300,14,3400,3700,"Sub-basin 3"
5776,100,1,500,600,"Sub-basin 3"
5777,100,1,300,400,"Sub-basin 3"
5778,200,3,900,1100,"Sub-basin 3"
5779,500,35,4600,5100,"Sub-basin 3"
5780,300,6,4400,4700,"Sub-basin 3"
5781,2400,109.83,29500,31900,"Sub-basin 3"
5782,7200,419.84,26500,33700,"Sub-basin 3"
5783,500,30,4600,5100,"Sub-basin 3"
5784,3500,165.1396,32500,36000,"Sub-basin 3"
5785,300,13,4300,4600,"Sub-basin 3"
5786,100,2.0019,3300,3400,"Sub-basin 3"
5787,100,8,1900,2000,"Sub-basin 3"
5788,100,1,2100,2200,"Sub-basin 3"
5789,100,1,1700,1800,"Sub-basin 3"
5790,100,3,2900,3000,"Sub-basin 3"
5791,300,18,1500,1800,"Sub-basin 3"
5792,1400,75,7400,8800,"Sub-basin 3"
5793,100,1,1300,1400,"Sub-basin 3"
5794,100,2,1000,1100,"Sub-basin 3"
5795,1000,40,18500,19500,"Sub-basin 3"
5796,100,2,400,500,"Sub-basin 3"
5797,12100,1668,132900,145000,"Sub-basin 3"
5798,100,3,1100,1200,"Sub-basin 3"
5799,1600,188,15600,17200,"Sub-basin 3"
5800,600,30,5500,6100,"Sub-basin 3"
5801,300,7,4200,4500,"Sub-basin 3"
5802,500,37,6100,6600,"Sub-basin 3"
5803,500,11,11600,12100,"Sub-basin 3"
5804,1800,81.83,9500,11300,"Sub-basin 3"
5805,100,1,2300,2400,"Sub-basin 3"
5806,200,4,3800,4000,"Sub-basin 3"
5807,200,3,4500,4700,"Sub-basin 3"
5808,500,10.0403,7100,7600,"Sub-basin 3"
5809,1600,129,8100,9700,"Sub-basin 3"
5810,200,5,2700,2900,"Sub-basin 3"
5811,100,3,800,900,"Sub-basin 3"
5812,700,22,7300,8000,"Sub-basin 3"
5813,400,9,6900,7300,"Sub-basin 3"
5814,100,2,900,1000,"Sub-basin 3"
5815,400,10,6000,6400,"Sub-basin 3"
5816,300,6,2500,2800,"Sub-basin 3"
5817,9600,1387,41500,51100,"Sub-basin 3"
5818,200,7,1500,1700,"Sub-basin 3"
5819,100,9,1200,1300,"Sub-basin 3"
5820,10300,1177,48600,58900,"Sub-basin 3"
5821,100,3,900,1000,"Sub-basin 3"
5822,200,3,2600,2800,"Sub-basin 3"
5823,200,2,4700,4900,"Sub-basin 3"
5824,1000,78,8800,9800,"Sub-basin 3"
5825,1200,151.67,9600,10800,"Sub-basin 3"
5826,200,15,3000,3200,"Sub-basin 3"
5827,1300,86,10000,11300,"Sub-basin 3"
5828,2100,137.84,17200,19300,"Sub-basin 3"
5829,300,5,4000,4300,"Sub-basin 3"
5830,400,22,2400,2800,"Sub-basin 3"
5831,100,2,2900,3000,"Sub-basin 3"
5832,200,8,2100,2300,"Sub-basin 3"
5833,43500,4898.66,137800,181300,"Sub-basin 3"
5834,100,2,600,700,"Sub-basin 3"
5835,100,2,3300,3400,"Sub-basin 3"
5836,100,4,1400,1500,"Sub-basin 3"
5837,3100,323,46800,49900,"Sub-basin 3"
5838,200,6,5700,5900,"Sub-basin 3"
5839,100,2,600,700,"Sub-basin 3"
5840,100,1,1100,1200,"Sub-basin 3"
5841,1000,21,11100,12100,"Sub-basin 3"
5842,1900,211.33,9000,10900,"Sub-basin 3"
5843,300,10,5500,5800,"Sub-basin 3"
5844,100,4,1400,1500,"Sub-basin 3"
5845,300,8,6700,7000,"Sub-basin 3"
5846,100,3,2300,2400,"Sub-basin 3"
5847,400,17,2800,3200,"Sub-basin 3"
5848,100,2,2500,2600,"Sub-basin 3"
5849,100,1,1300,1400,"Sub-basin 3"
5850,100,2,1100,1200,"Sub-basin 3"
5851,200,2,2700,2900,"Sub-basin 3"
5852,100,1,700,800,"Sub-basin 3"
5853,2400,137,17900,20300,"Sub-basin 3"
5854,1100,85.83,14800,15900,"Sub-basin 3"
5855,300,16,3600,3900,"Sub-basin 3"
5856,100,1,1300,1400,"Sub-basin 3"
5857,100,2,2500,2600,"Sub-basin 3"
5858,100,1,3400,3500,"Sub-basin 3"
5859,100,1,4800,4900,"Sub-basin 3"
5860,100,2,3600,3700,"Sub-basin 3"
5861,200,3,3400,3600,"Sub-basin 3"
5862,200,11,1900,2100,"Sub-basin 3"
5863,500,17,7000,7500,"Sub-basin 3"
5864,2200,507,8200,10400,"Sub-basin 3"
5865,100,2,800,900,"Sub-basin 3"
5866,1900,91.67,10800,12700,"Sub-basin 3"
5867,100,3,1600,1700,"Sub-basin 3"
5868,100,1,1100,1200,"Sub-basin 3"
5869,600,34.5,6700,7300,"Sub-basin 3"
5870,200,2,3400,3600,"Sub-basin 3"
5871,100,1,1200,1300,"Sub-basin 3"
5872,200,1.67,2700,2900,"Sub-basin 3"
5873,500,12.33,5000,5500,"Sub-basin 3"
5874,1200,51,8400,9600,"Sub-basin 3"
5875,900,170.33,12500,13400,"Sub-basin 3"
5876,100,3,1600,1700,"Sub-basin 3"
5877,700,53,13600,14300,"Sub-basin 3"
5878,200,12,3000,3200,"Sub-basin 3"
5879,100,0.5,1900,2000,"Sub-basin 3"
5880,500,14.83,7400,7900,"Sub-basin 3"
5881,100,2,2100,2200,"Sub-basin 3"
5882,300,17,4700,5000,"Sub-basin 3"
5883,800,35,12500,13300,"Sub-basin 3"
5884,200,13,1500,1700,"Sub-basin 3"
5885,100,1,1000,1100,"Sub-basin 3"
5886,1500,182,8400,9900,"Sub-basin 3"
5887,100,2,3200,3300,"Sub-basin 3"
5888,300,10,6300,6600,"Sub-basin 3"
5889,400,7,6900,7300,"Sub-basin 3"
5890,200,3,2400,2600,"Sub-basin 3"
5891,400,8,3200,3600,"Sub-basin 3"
5892,100,2,1500,1600,"Sub-basin 3"
5893,1300,100,18800,20100,"Sub-basin 3"
5894,100,1,3600,3700,"Sub-basin 3"
5895,300,4,3800,4100,"Sub-basin 3"
5896,600,23,13000,13600,"Sub-basin 3"
5897,100,1,1700,1800,"Sub-basin 3"
5898,100,1,3100,3200,"Sub-basin 3"
5899,400,49,2200,2600,"Sub-basin 3"
5900,100,2,1700,1800,"Sub-basin 3"
5901,200,3,200,400,"Sub-basin 3"
5902,200,2,11800,12000,"Sub-basin 3"
5903,100,1,4000,4100,"Sub-basin 3"
5904,300,4,2900,3200,"Sub-basin 3"
5905,100,1,2200,2300,"Sub-basin 3"
5906,200,7,3400,3600,"Sub-basin 3"
5907,400,7,7800,8200,"Sub-basin 3"
5908,63700,23698,75200,138900,"Sub-basin 3"
5909,6800,1563,20000,26800,"Sub-basin 3"
5910,9500,1531,14600,24100,"Sub-basin 3"
5911,100,4,1300,1400,"Sub-basin 3"
5912,500,9,4400,4900,"Sub-basin 3"
5913,200,4,5100,5300,"Sub-basin 3"
5914,100,1,1100,1200,"Sub-basin 3"
5915,100,1,3100,3200,"Sub-basin 3"
5916,500,45,16200,16700,"Sub-basin 3"
5917,200,2,3100,3300,"Sub-basin 3"
5918,100,3,1700,1800,"Sub-basin 3"
5919,100,7,4200,4300,"Sub-basin 3"
5920,100,1,3300,3400,"Sub-basin 3"
5921,100,1,3300,3400,"Sub-basin 3"
5922,900,90,6300,7200,"Sub-basin 3"
5923,300,7,3500,3800,"Sub-basin 3"
5924,100,1,2700,2800,"Sub-basin 3"
5925,1000,118,6500,7500,"Sub-basin 3"
5926,200,2,2300,2500,"Sub-basin 3"
5927,3500,459,20800,24300,"Sub-basin 3"
5928,600,14.021,12900,13500,"Sub-basin 3"
5929,700,98,10100,10800,"Sub-basin 3"
5930,1900,184,6700,8600,"Sub-basin 3"
5931,300,4,2100,2400,"Sub-basin 3"
5932,300,10,3500,3800,"Sub-basin 3"
5933,2000,76,20300,22300,"Sub-basin 3"
5934,300,7,3600,3900,"Sub-basin 3"
5935,200,5,1300,1500,"Sub-basin 3"
5936,100,1,1200,1300,"Sub-basin 3"
5937,100,1,2000,2100,"Sub-basin 3"
5938,300,4,6500,6800,"Sub-basin 3"
5939,200,3,3300,3500,"Sub-basin 3"
5940,700,16,13700,14400,"Sub-basin 3"
5941,200,3,2000,2200,"Sub-basin 3"
5942,100,1,1100,1200,"Sub-basin 3"
5943,100,1,2900,3000,"Sub-basin 3"
5944,200,2,2400,2600,"Sub-basin 3"
5945,100,1,1700,1800,"Sub-basin 3"
5946,100,2,1300,1400,"Sub-basin 3"
5947,100,1,700,800,"Sub-basin 3"
5948,900,53.83,9400,10300,"Sub-basin 3"
5949,100,2,2100,2200,"Sub-basin 3"
5950,300,8,7500,7800,"Sub-basin 3"
5951,4700,558,21700,26400,"Sub-basin 3"
5952,100,4.0015,2200,2300,"Sub-basin 3"
5953,200,4,1400,1600,"Sub-basin 3"
5954,100,1,1200,1300,"Sub-basin 3"
5955,300,5,2000,2300,"Sub-basin 3"
5956,200,2,4400,4600,"Sub-basin 3"
5957,200,3,3200,3400,"Sub-basin 3"
5958,100,1,1800,1900,"Sub-basin 3"
5959,100,2,1400,1500,"Sub-basin 3"
5960,100,3,1800,1900,"Sub-basin 3"
5961,2600,98,18500,21100,"Sub-basin 3"
5962,300,4,4100,4400,"Sub-basin 3"
5963,1100,102,10200,11300,"Sub-basin 3"
5964,100,1,1300,1400,"Sub-basin 3"
5965,600,51,5400,6000,"Sub-basin 3"
5966,1000,51,13200,14200,"Sub-basin 3"
5967,700,46,8200,8900,"Sub-basin 3"
5968,1400,248,9300,10700,"Sub-basin 3"
5969,100,3,1500,1600,"Sub-basin 3"
5970,100,1,500,600,"Sub-basin 3"
5971,100,1,1400,1500,"Sub-basin 3"
5972,100,2,3200,3300,"Sub-basin 3"
5973,100,1,1300,1400,"Sub-basin 3"
5974,700,31,9800,10500,"Sub-basin 3"
5975,200,7,2700,2900,"Sub-basin 3"
5976,100,1,1400,1500,"Sub-basin 3"
5977,100,3,1700,1800,"Sub-basin 3"
5978,300,10,3300,3600,"Sub-basin 3"
5979,200,4,4800,5000,"Sub-basin 3"
5980,100,2,3800,3900,"Sub-basin 3"
5981,200,7,4200,4400,"Sub-basin 3"
5982,100,3,1300,1400,"Sub-basin 3"
5983,100,1,3000,3100,"Sub-basin 3"
5984,800,50,7700,8500,"Sub-basin 3"
5985,400,31,7700,8100,"Sub-basin 3"
5986,14200,1086,164100,178300,"Sub-basin 3"
5987,100,1,2400,2500,"Sub-basin 3"
5988,100,2,2100,2200,"Sub-basin 3"
5989,800,60,15100,15900,"Sub-basin 3"
5990,500,46,3500,4000,"Sub-basin 3"
5991,400,26,1300,1700,"Sub-basin 3"
5992,100,1,1400,1500,"Sub-basin 3"
5993,400,19.0051,4600,5000,"Sub-basin 3"
5994,100,2,1500,1600,"Sub-basin 3"
5995,200,6,2000,2200,"Sub-basin 3"
5996,100,4,1400,1500,"Sub-basin 3"
5997,200,4,4000,4200,"Sub-basin 3"
5998,200,2,5000,5200,"Sub-basin 3"
5999,100,1,1600,1700,"Sub-basin 3"
6000,100,1,3100,3200,"Sub-basin 3"
6001,300,10,3400,3700,"Sub-basin 3"
6002,100,7,700,800,"Sub-basin 3"
6003,500,39,5700,6200,"Sub-basin 3"
6004,2800,308,29300,32100,"Sub-basin 3"
6005,1000,593,8800,9800,"Sub-basin 3"
6006,200,2.0032,4200,4400,"Sub-basin 3"
6007,400,6.0048,3300,3700,"Sub-basin 3"
6008,3400,274,18200,21600,"Sub-basin 3"
6009,100,3,900,1000,"Sub-basin 3"
6010,100,1,2200,2300,"Sub-basin 3"
6011,200,7,4300,4500,"Sub-basin 3"
6012,200,2,3000,3200,"Sub-basin 3"
6013,200,2,6300,6500,"Sub-basin 3"
6014,200,3,2200,2400,"Sub-basin 3"
6015,500,8,3600,4100,"Sub-basin 3"
6016,100,1,600,700,"Sub-basin 3"
6017,1100,110,6800,7900,"Sub-basin 3"
6018,100,1,2000,2100,"Sub-basin 3"
6019,2300,122,17500,19800,"Sub-basin 3"
6020,100,1.0021,1800,1900,"Sub-basin 3"
6021,100,3,2100,2200,"Sub-basin 3"
6022,400,24,4000,4400,"Sub-basin 3"
6023,300,8,6000,6300,"Sub-basin 3"
6024,200,5,1700,1900,"Sub-basin 3"
6025,100,4,700,800,"Sub-basin 3"
6026,200,7,2600,2800,"Sub-basin 3"
6027,200,7,3100,3300,"Sub-basin 3"
6028,900,38,8000,8900,"Sub-basin 3"
6029,400,14,4900,5300,"Sub-basin 3"
6030,200,2,2800,3000,"Sub-basin 3"
6031,400,6,9400,9800,"Sub-basin 3"
6032,100,2,2000,2100,"Sub-basin 3"
6033,100,1,3400,3500,"Sub-basin 3"
6034,100,1,2500,2600,"Sub-basin 3"
6035,1800,55,27700,29500,"Sub-basin 3"
6036,4400,300,36400,40800,"Sub-basin 3"
6037,100,1,1600,1700,"Sub-basin 3"
6038,100,2,1000,1100,"Sub-basin 3"
6039,700,25,6700,7400,"Sub-basin 3"
6040,100,4,1200,1300,"Sub-basin 3"
6041,3700,307,14700,18400,"Sub-basin 3"
6042,100,3,1100,1200,"Sub-basin 3"
6043,100,1,500,600,"Sub-basin 3"
6044,100,1,600,700,"Sub-basin 3"
6045,1700,338,10300,12000,"Sub-basin 3"
6046,300,7.0095,5300,5600,"Sub-basin 3"
6047,300,13.0038,4900,5200,"Sub-basin 3"
6048,600,18,4600,5200,"Sub-basin 3"
6049,2400,244,17700,20100,"Sub-basin 3"
6050,500,7,8200,8700,"Sub-basin 3"
6051,200,2,2400,2600,"Sub-basin 3"
6052,100,1,2500,2600,"Sub-basin 3"
6053,100,1,1400,1500,"Sub-basin 3"
6054,200,5,3500,3700,"Sub-basin 3"
6055,500,12,11100,11600,"Sub-basin 3"
6056,200,3,5200,5400,"Sub-basin 3"
6057,200,17,2700,2900,"Sub-basin 3"
6058,100,1,1600,1700,"Sub-basin 3"
6059,6600,700,30200,36800,"Sub-basin 3"
6060,1000,34,10100,11100,"Sub-basin 3"
6061,200,5,1800,2000,"Sub-basin 3"
6062,5100,306,27400,32500,"Sub-basin 3"
6063,200,9,4200,4400,"Sub-basin 3"
6064,100,1,800,900,"Sub-basin 3"
6065,400,4.0074,5200,5600,"Sub-basin 3"
6066,400,7,7700,8100,"Sub-basin 3"
6067,2900,133,6200,9100,"Sub-basin 3"
6068,2400,140,12500,14900,"Sub-basin 3"
6069,800,34,8300,9100,"Sub-basin 3"
6070,200,4,6700,6900,"Sub-basin 3"
6071,100,2,1900,2000,"Sub-basin 3"
6072,400,6,10800,11200,"Sub-basin 3"
6073,11600,691,66800,78400,"Sub-basin 3"
6074,500,15,13400,13900,"Sub-basin 3"
6075,1500,95,8400,9900,"Sub-basin 3"
6076,200,7,3100,3300,"Sub-basin 3"
6077,200,5,1500,1700,"Sub-basin 3"
6078,300,6,4400,4700,"Sub-basin 3"
6079,100,2,3500,3600,"Sub-basin 3"
6080,100,4,1900,2000,"Sub-basin 3"
6081,100,1,2600,2700,"Sub-basin 3"
6082,100,1,500,600,"Sub-basin 3"
6083,2500,266,18000,20500,"Sub-basin 3"
6084,100,1,700,800,"Sub-basin 3"
6085,100,3,800,900,"Sub-basin 3"
6086,100,3,2100,2200,"Sub-basin 3"
6087,100,3,2800,2900,"Sub-basin 3"
6088,4300,179,34000,38300,"Sub-basin 3"
6089,100,2,2800,2900,"Sub-basin 3"
6090,100,5,3300,3400,"Sub-basin 3"
6091,300,13,4400,4700,"Sub-basin 3"
6092,1800,148,18400,20200,"Sub-basin 3"
6093,200,3,5700,5900,"Sub-basin 3"
6094,100,4,2300,2400,"Sub-basin 3"
6095,3100,79,18200,21300,"Sub-basin 3"
6096,300,8,3500,3800,"Sub-basin 3"
6097,300,9,2700,3000,"Sub-basin 3"
6098,300,4,4600,4900,"Sub-basin 3"
6099,11300,2687.5,17500,28800,"Sub-basin 3"
6100,300,10,4700,5000,"Sub-basin 3"
6101,100,2,1300,1400,"Sub-basin 3"
6102,400,6,7500,7900,"Sub-basin 3"
6103,100,2,2000,2100,"Sub-basin 3"
6104,400,15,7500,7900,"Sub-basin 3"
6105,200,4,8300,8500,"Sub-basin 3"
6106,200,5,2800,3000,"Sub-basin 3"
6107,700,25,4300,5000,"Sub-basin 3"
6108,100,1,700,800,"Sub-basin 3"
6109,100,1,1000,1100,"Sub-basin 3"
6110,200,5,2600,2800,"Sub-basin 3"
6111,100,2,1400,1500,"Sub-basin 3"
6112,1900,183,7500,9400,"Sub-basin 3"
6113,200,6,800,1000,"Sub-basin 3"
6114,500,22,5700,6200,"Sub-basin 3"
6115,400,17,2000,2400,"Sub-basin 3"
6116,100,1,2000,2100,"Sub-basin 3"
6117,1600,230,12000,13600,"Sub-basin 3"
6118,100,6,100,200,"Sub-basin 3"
6119,100,1,500,600,"Sub-basin 3"
6120,400,17,1700,2100,"Sub-basin 3"
6121,100,1,4200,4300,"Sub-basin 3"
6122,100,2,3300,3400,"Sub-basin 3"
6123,100,3,2400,2500,"Sub-basin 3"
6124,100,3,1600,1700,"Sub-basin 3"
6125,1200,77,9900,11100,"Sub-basin 3"
6126,200,3,2600,2800,"Sub-basin 3"
6127,900,25,10500,11400,"Sub-basin 3"
6128,100,8,2800,2900,"Sub-basin 3"
6129,100,1,1700,1800,"Sub-basin 3"
6130,300,20,2700,3000,"Sub-basin 3"
6131,3400,351,16100,19500,"Sub-basin 3"
6132,100,1,2900,3000,"Sub-basin 3"
6133,500,9,5300,5800,"Sub-basin 3"
6134,200,6,2100,2300,"Sub-basin 3"
6135,100,2,2500,2600,"Sub-basin 3"
6136,200,7,5700,5900,"Sub-basin 3"
6137,3000,213.5,24000,27000,"Sub-basin 3"
6138,100,3,1600,1700,"Sub-basin 3"
6139,100,1,1000,1100,"Sub-basin 3"
6140,100,2,1600,1700,"Sub-basin 3"
6141,100,1,1300,1400,"Sub-basin 3"
6142,2200,105,16200,18400,"Sub-basin 3"
6143,100,1,3200,3300,"Sub-basin 3"
6144,400,7,9200,9600,"Sub-basin 3"
6145,1400,359,9900,11300,"Sub-basin 3"
6146,82400,49154.8824,96700,179100,"Sub-basin 3"
6147,300,5,6000,6300,"Sub-basin 3"
6148,600,16,2800,3400,"Sub-basin 3"
6149,100,2,1600,1700,"Sub-basin 3"
6150,200,4,2100,2300,"Sub-basin 3"
6151,100,5.0021,2400,2500,"Sub-basin 3"
6152,400,29,3100,3500,"Sub-basin 3"
6153,4900,578,20200,25100,"Sub-basin 3"
6154,100,2,700,800,"Sub-basin 3"
6155,800,32,4800,5600,"Sub-basin 3"
6156,200,7,2400,2600,"Sub-basin 3"
6157,600,21,5000,5600,"Sub-basin 3"
6158,1600,56,14200,15800,"Sub-basin 3"
6159,300,8,6700,7000,"Sub-basin 3"
6160,700,37,12700,13400,"Sub-basin 3"
6161,200,6,1300,1500,"Sub-basin 3"
6162,600,75,4100,4700,"Sub-basin 3"
6163,100,1,1300,1400,"Sub-basin 3"
6164,200,3,4100,4300,"Sub-basin 3"
6165,600,19,3300,3900,"Sub-basin 3"
6166,600,18,5700,6300,"Sub-basin 3"
6167,100,4.0016,2800,2900,"Sub-basin 3"
6168,200,5.0087,3300,3500,"Sub-basin 3"
6169,1600,152,5800,7400,"Sub-basin 3"
6170,100,1,300,400,"Sub-basin 3"
6171,100,3,400,500,"Sub-basin 3"
6172,100,3,2100,2200,"Sub-basin 3"
6173,1500,101,22200,23700,"Sub-basin 3"
6174,200,3,7000,7200,"Sub-basin 3"
6175,100,4,4100,4200,"Sub-basin 3"
6176,100,2,1500,1600,"Sub-basin 3"
6177,200,7,6600,6800,"Sub-basin 3"
6178,300,146,3000,3300,"Sub-basin 3"
6179,600,14,8200,8800,"Sub-basin 3"
6180,100,3,1200,1300,"Sub-basin 3"
6181,100,2,1500,1600,"Sub-basin 3"
6182,100,1,2400,2500,"Sub-basin 3"
6183,100,1,1100,1200,"Sub-basin 3"
6184,900,41,10100,11000,"Sub-basin 3"
6185,500,18,4400,4900,"Sub-basin 3"
6186,200,2,2000,2200,"Sub-basin 3"
6187,200,5,4500,4700,"Sub-basin 3"
6188,600,17,9700,10300,"Sub-basin 3"
6189,200,3,4500,4700,"Sub-basin 3"
6190,100,3,1800,1900,"Sub-basin 3"
6191,400,10,6300,6700,"Sub-basin 3"
6192,100,1,4500,4600,"Sub-basin 3"
6193,300,4,2400,2700,"Sub-basin 3"
6194,200,14,3400,3600,"Sub-basin 3"
6195,200,5,3300,3500,"Sub-basin 3"
6196,800,31,14600,15400,"Sub-basin 3"
6197,700,19.0112,13800,14500,"Sub-basin 3"
6198,100,5,1000,1100,"Sub-basin 3"
6199,200,11,1500,1700,"Sub-basin 3"
6200,100,2,200,300,"Sub-basin 3"
6201,100,1,700,800,"Sub-basin 3"
6202,12800,1414,53000,65800,"Sub-basin 3"
6203,200,3,2500,2700,"Sub-basin 3"
6204,100,1,2000,2100,"Sub-basin 3"
6205,600,21,7000,7600,"Sub-basin 3"
6206,700,46,8900,9600,"Sub-basin 3"
6207,800,40,7000,7800,"Sub-basin 3"
6208,100,1,3700,3800,"Sub-basin 3"
6209,200,2,7400,7600,"Sub-basin 3"
6210,700,30,3400,4100,"Sub-basin 3"
6211,400,19,6500,6900,"Sub-basin 3"
6212,1000,36,12500,13500,"Sub-basin 3"
6213,3400,224,47800,51200,"Sub-basin 3"
6214,700,40,7100,7800,"Sub-basin 3"
6215,100,2,900,1000,"Sub-basin 3"
6216,100,3,1800,1900,"Sub-basin 3"
6217,800,39,8300,9100,"Sub-basin 3"
6218,100,1,800,900,"Sub-basin 3"
6219,700,83,5300,6000,"Sub-basin 3"
6220,32900,5309.67,38300,71200,"Sub-basin 3"
6221,200,6,3200,3400,"Sub-basin 3"
6222,100,1,900,1000,"Sub-basin 3"
6223,100,2,2200,2300,"Sub-basin 3"
6224,100,1,1900,2000,"Sub-basin 3"
6225,200,4,6100,6300,"Sub-basin 3"
6226,100,3,3900,4000,"Sub-basin 3"
6227,100,3,2200,2300,"Sub-basin 3"
6228,200,3,4800,5000,"Sub-basin 3"
6229,1700,52,14200,15900,"Sub-basin 3"
6230,200,4,2600,2800,"Sub-basin 3"
6231,14300,3452,32300,46600,"Sub-basin 3"
6232,300,8,2200,2500,"Sub-basin 3"
6233,100,4,1000,1100,"Sub-basin 3"
6234,100,2,2700,2800,"Sub-basin 3"
6235,700,34,7100,7800,"Sub-basin 3"
6236,100,2,1300,1400,"Sub-basin 3"
6237,1200,55,10200,11400,"Sub-basin 3"
6238,300,5,4600,4900,"Sub-basin 3"
6239,100,2,2600,2700,"Sub-basin 3"
6240,500,7,6000,6500,"Sub-basin 3"
6241,300,8,4200,4500,"Sub-basin 3"
6242,7600,383,54100,61700,"Sub-basin 3"
6243,100,1,1300,1400,"Sub-basin 3"
6244,1300,114,9000,10300,"Sub-basin 3"
6245,400,14,3900,4300,"Sub-basin 3"
6246,800,70,6700,7500,"Sub-basin 3"
6247,200,6,5600,5800,"Sub-basin 3"
6248,200,7,1900,2100,"Sub-basin 3"
6249,1000,62,8600,9600,"Sub-basin 3"
6250,100,2,2400,2500,"Sub-basin 3"
6251,100,2,1400,1500,"Sub-basin 3"
6252,300,11,4500,4800,"Sub-basin 3"
6253,200,5,5000,5200,"Sub-basin 3"
6254,100,1,2100,2200,"Sub-basin 3"
6255,100,3,1800,1900,"Sub-basin 3"
6256,1900,210,9900,11800,"Sub-basin 3"
6257,100,2,3000,3100,"Sub-basin 3"
6258,300,11,4700,5000,"Sub-basin 3"
6259,3100,195,22300,25400,"Sub-basin 3"
6260,100,2,2800,2900,"Sub-basin 3"
6261,600,23,8000,8600,"Sub-basin 3"
6262,200,6,2700,2900,"Sub-basin 3"
6263,1200,70,12200,13400,"Sub-basin 3"
6264,300,8,5800,6100,"Sub-basin 3"
6265,400,10,7800,8200,"Sub-basin 3"
6266,500,20,5200,5700,"Sub-basin 3"
6267,300,3,2500,2800,"Sub-basin 3"
6268,1400,110,10500,11900,"Sub-basin 3"
6269,1000,85,7100,8100,"Sub-basin 3"
6270,2900,274,12500,15400,"Sub-basin 3"
6271,1900,117,26500,28400,"Sub-basin 3"
6272,100,1,1700,1800,"Sub-basin 3"
6273,100,1,1300,1400,"Sub-basin 3"
6274,400,13,3400,3800,"Sub-basin 3"
6275,100,2.0001,3000,3100,"Sub-basin 3"
6276,400,7,5900,6300,"Sub-basin 3"
6277,200,2,2000,2200,"Sub-basin 3"
6278,5400,1145,18200,23600,"Sub-basin 3"
6279,500,44,1000,1500,"Sub-basin 3"
6280,400,22,5600,6000,"Sub-basin 3"
6281,900,68,3100,4000,"Sub-basin 3"
6282,100,1,1500,1600,"Sub-basin 3"
6283,2600,211,15800,18400,"Sub-basin 3"
6284,100,1,3800,3900,"Sub-basin 3"
6285,100,3,3000,3100,"Sub-basin 3"
6286,100,1,3000,3100,"Sub-basin 3"
6287,100,1,1400,1500,"Sub-basin 3"
6288,200,3,1900,2100,"Sub-basin 3"
6289,400,11,10100,10500,"Sub-basin 3"
6290,400,12,7400,7800,"Sub-basin 3"
6291,200,8,1300,1500,"Sub-basin 3"
6292,1300,63,16400,17700,"Sub-basin 3"
6293,100,1,2200,2300,"Sub-basin 3"
6294,2200,154,26700,28900,"Sub-basin 3"
6295,2500,172,13700,16200,"Sub-basin 3"
6296,2900,167,15500,18400,"Sub-basin 3"
6297,200,4.0069,5200,5400,"Sub-basin 3"
6298,200,9,1000,1200,"Sub-basin 3"
6299,2600,319,11300,13900,"Sub-basin 3"
6300,400,18,3300,3700,"Sub-basin 3"
6301,100,1,500,600,"Sub-basin 3"
6302,700,88,9000,9700,"Sub-basin 3"
6303,200,8,3500,3700,"Sub-basin 3"
6304,400,4,6300,6700,"Sub-basin 3"
6305,200,3,3000,3200,"Sub-basin 3"
6306,2000,116,15900,17900,"Sub-basin 3"
6307,300,4,5600,5900,"Sub-basin 3"
6308,200,7,3200,3400,"Sub-basin 3"
6309,1200,70,11900,13100,"Sub-basin 3"
6310,100,27,3200,3300,"Sub-basin 3"
6311,3300,674,22000,25300,"Sub-basin 3"
6312,2900,405,10200,13100,"Sub-basin 3"
6313,5600,809,22000,27600,"Sub-basin 3"
6314,6300,1590,14100,20400,"Sub-basin 3"
6315,800,110,1800,2600,"Sub-basin 3"
6316,100,1,1200,1300,"Sub-basin 3"
6317,4800,320,57100,61900,"Sub-basin 3"
6318,100,1,2700,2800,"Sub-basin 3"
6319,200,4,1800,2000,"Sub-basin 3"
6320,200,7,4800,5000,"Sub-basin 3"
6321,200,2,6200,6400,"Sub-basin 3"
6322,100,2,800,900,"Sub-basin 3"
6323,200,3,2000,2200,"Sub-basin 3"
6324,100,1,2000,2100,"Sub-basin 3"
6325,100,1,1900,2000,"Sub-basin 3"
6326,100,3,2500,2600,"Sub-basin 3"
6327,2700,139,15400,18100,"Sub-basin 3"
6328,500,29,1700,2200,"Sub-basin 3"
6329,100,6,1100,1200,"Sub-basin 3"
6330,100,1,4900,5000,"Sub-basin 3"
6331,100,4,2500,2600,"Sub-basin 3"
6332,100,1,2700,2800,"Sub-basin 3"
6333,900,40,14600,15500,"Sub-basin 3"
6334,400,5,8200,8600,"Sub-basin 3"
6335,200,5,2900,3100,"Sub-basin 3"
6336,100,1,1500,1600,"Sub-basin 3"
6337,100,2,3600,3700,"Sub-basin 3"
6338,100,2,1300,1400,"Sub-basin 3"
6339,1100,179,6300,7400,"Sub-basin 3"
6340,100,3.0019,3400,3500,"Sub-basin 3"
6341,100,1,1000,1100,"Sub-basin 3"
6342,500,38,5900,6400,"Sub-basin 3"
6343,100,1,600,700,"Sub-basin 3"
6344,1900,79,14000,15900,"Sub-basin 3"
6345,300,3,3300,3600,"Sub-basin 3"
6346,100,1,2300,2400,"Sub-basin 3"
6347,1200,40,12300,13500,"Sub-basin 3"
6348,200,3,3400,3600,"Sub-basin 3"
6349,1000,87,9300,10300,"Sub-basin 3"
6350,300,3,5000,5300,"Sub-basin 3"
6351,800,112,3700,4500,"Sub-basin 3"
6352,100,1,2300,2400,"Sub-basin 3"
6353,100,4,2100,2200,"Sub-basin 3"
6354,400,12,3000,3400,"Sub-basin 3"
6355,400,14,4300,4700,"Sub-basin 3"
6356,100,5,1700,1800,"Sub-basin 3"
6357,100,4,2000,2100,"Sub-basin 3"
6358,1100,33,27700,28800,"Sub-basin 3"
6359,100,2,2500,2600,"Sub-basin 3"
6360,200,2,3000,3200,"Sub-basin 3"
6361,200,5,3400,3600,"Sub-basin 3"
6362,300,8,4100,4400,"Sub-basin 3"
6363,3100,136,25700,28800,"Sub-basin 3"
6364,400,11,4900,5300,"Sub-basin 3"
6365,2500,84,17300,19800,"Sub-basin 3"
6366,600,25,7000,7600,"Sub-basin 3"
6367,100,3,2200,2300,"Sub-basin 3"
6368,300,11.0037,3600,3900,"Sub-basin 3"
6369,600,105,1700,2300,"Sub-basin 3"
6370,900,47,11300,12200,"Sub-basin 3"
6371,300,27,5000,5300,"Sub-basin 3"
6372,600,49,3800,4400,"Sub-basin 3"
6373,1400,49,7100,8500,"Sub-basin 3"
6374,3500,192,30700,34200,"Sub-basin 3"
6375,100,1,3200,3300,"Sub-basin 3"
6376,200,2,6300,6500,"Sub-basin 3"
6377,100,2,2200,2300,"Sub-basin 3"
6378,100,2,1500,1600,"Sub-basin 3"
6379,100,5,2500,2600,"Sub-basin 3"
6380,100,1,2600,2700,"Sub-basin 3"
6381,1200,42,9600,10800,"Sub-basin 3"
6382,100,1,2000,2100,"Sub-basin 3"
6383,400,18,15200,15600,"Sub-basin 3"
6384,100,1,1500,1600,"Sub-basin 3"
6385,2700,132,21800,24500,"Sub-basin 3"
6386,300,4,5800,6100,"Sub-basin 3"
6387,200,6,5800,6000,"Sub-basin 3"
6388,200,5,6800,7000,"Sub-basin 3"
6389,100,2,1900,2000,"Sub-basin 3"
6390,800,61,3100,3900,"Sub-basin 3"
6391,100,1,1800,1900,"Sub-basin 3"
6392,300,7,6600,6900,"Sub-basin 3"
6393,100,1,3600,3700,"Sub-basin 3"
6394,100,1,2500,2600,"Sub-basin 3"
6395,1200,101,3500,4700,"Sub-basin 3"
6396,500,14,5800,6300,"Sub-basin 3"
6397,100,2,3900,4000,"Sub-basin 3"
6398,100,1,1800,1900,"Sub-basin 3"
6399,100,4,2300,2400,"Sub-basin 3"
6400,400,15,5200,5600,"Sub-basin 3"
6401,1500,79,24600,26100,"Sub-basin 3"
6402,200,4,2200,2400,"Sub-basin 3"
6403,100,1,1600,1700,"Sub-basin 3"
6404,600,11,6800,7400,"Sub-basin 3"
6405,300,24,4000,4300,"Sub-basin 3"
6406,100,1.0013,1000,1100,"Sub-basin 3"
6407,100,1,2800,2900,"Sub-basin 3"
6408,800,31,8700,9500,"Sub-basin 3"
6409,100,3,2900,3000,"Sub-basin 3"
6410,100,1,1100,1200,"Sub-basin 3"
6411,100,1,600,700,"Sub-basin 3"
6412,300,7,7900,8200,"Sub-basin 3"
6413,300,5,9900,10200,"Sub-basin 3"
6414,100,1,3300,3400,"Sub-basin 3"
6415,200,2,4300,4500,"Sub-basin 3"
6416,5100,326,36500,41600,"Sub-basin 3"
6417,300,4,5400,5700,"Sub-basin 3"
6418,100,4,2100,2200,"Sub-basin 3"
6419,300,4,7600,7900,"Sub-basin 3"
6420,100,4,2100,2200,"Sub-basin 3"
6421,600,34,4700,5300,"Sub-basin 3"
6422,1700,149,7000,8700,"Sub-basin 3"
6423,200,3,2300,2500,"Sub-basin 3"
6424,100,1,2400,2500,"Sub-basin 3"
6425,200,3,1300,1500,"Sub-basin 3"
6426,20200,5987,31100,51300,"Sub-basin 3"
6427,3700,691,11800,15500,"Sub-basin 3"
6428,300,7,5600,5900,"Sub-basin 3"
6429,100,3,3300,3400,"Sub-basin 3"
6430,100,2,1300,1400,"Sub-basin 3"
6431,300,4,7900,8200,"Sub-basin 3"
6432,700,14,9500,10200,"Sub-basin 3"
6433,100,1,1800,1900,"Sub-basin 3"
6434,100,4,2900,3000,"Sub-basin 3"
6435,200,2,2100,2300,"Sub-basin 3"
6436,100,3,1900,2000,"Sub-basin 3"
6437,800,77,6300,7100,"Sub-basin 3"
6438,100,1.0019,2000,2100,"Sub-basin 3"
6439,400,24,2200,2600,"Sub-basin 3"
6440,100,2,800,900,"Sub-basin 3"
6441,200,3,5100,5300,"Sub-basin 3"
6442,100,3,1900,2000,"Sub-basin 3"
6443,300,4,3700,4000,"Sub-basin 3"
6444,1100,28,10500,11600,"Sub-basin 3"
6445,200,3,5800,6000,"Sub-basin 3"
6446,300,6,7900,8200,"Sub-basin 3"
6447,100,2,1300,1400,"Sub-basin 3"
6448,100,3,3500,3600,"Sub-basin 3"
6449,1600,66,23200,24800,"Sub-basin 3"
6450,100,2,2000,2100,"Sub-basin 3"
6451,1200,50,20400,21600,"Sub-basin 3"
6452,200,7,1300,1500,"Sub-basin 3"
6453,300,13,7400,7700,"Sub-basin 3"
6454,1600,297,12000,13600,"Sub-basin 3"
6455,300,8,1300,1600,"Sub-basin 3"
6456,500,34,10200,10700,"Sub-basin 3"
6457,400,11,4300,4700,"Sub-basin 3"
6458,300,5,3000,3300,"Sub-basin 3"
6459,200,4,1300,1500,"Sub-basin 3"
6460,100,1,1900,2000,"Sub-basin 3"
6461,100,1,3000,3100,"Sub-basin 3"
6462,300,6,4400,4700,"Sub-basin 3"
6463,300,10,6200,6500,"Sub-basin 3"
6464,700,40,11100,11800,"Sub-basin 3"
6465,100,2,2800,2900,"Sub-basin 3"
6466,100,2,1900,2000,"Sub-basin 3"
6467,100,1,1500,1600,"Sub-basin 3"
6468,3600,360,19600,23200,"Sub-basin 3"
6469,1000,72,5000,6000,"Sub-basin 3"
6470,400,13,4800,5200,"Sub-basin 3"
6471,700,31,12100,12800,"Sub-basin 3"
6472,700,21,7100,7800,"Sub-basin 3"
6473,200,2,2000,2200,"Sub-basin 3"
6474,100,1,2500,2600,"Sub-basin 3"
6475,200,3,3100,3300,"Sub-basin 3"
6476,100,1,1800,1900,"Sub-basin 3"
6477,100,1,1500,1600,"Sub-basin 3"
6478,100,1,1000,1100,"Sub-basin 3"
6479,100,1,300,400,"Sub-basin 3"
6480,1300,43.0273,10300,11600,"Sub-basin 3"
6481,100,1,900,1000,"Sub-basin 3"
6482,5100,1259,14700,19800,"Sub-basin 3"
6483,300,12,4000,4300,"Sub-basin 3"
6484,100,9,1800,1900,"Sub-basin 3"
6485,400,12,5800,6200,"Sub-basin 3"
6486,2300,220,20600,22900,"Sub-basin 3"
6487,200,8,4000,4200,"Sub-basin 3"
6488,300,8,8400,8700,"Sub-basin 3"
6489,100,6,2000,2100,"Sub-basin 3"
6490,100,1,2400,2500,"Sub-basin 3"
6491,700,20,8500,9200,"Sub-basin 3"
6492,1100,59,8300,9400,"Sub-basin 3"
6493,200,5,4800,5000,"Sub-basin 3"
6494,100,1,2900,3000,"Sub-basin 3"
6495,100,3,1600,1700,"Sub-basin 3"
6496,100,1,2800,2900,"Sub-basin 3"
6497,700,23,7400,8100,"Sub-basin 3"
6498,100,1,1500,1600,"Sub-basin 3"
6499,7400,2923,28600,36000,"Sub-basin 3"
6500,300,5,7300,7600,"Sub-basin 3"
6501,300,12,5200,5500,"Sub-basin 3"
6502,600,115,5100,5700,"Sub-basin 3"
6503,1100,41,11200,12300,"Sub-basin 3"
6504,100,1,700,800,"Sub-basin 3"
6505,500,24,2300,2800,"Sub-basin 3"
6506,200,3,3400,3600,"Sub-basin 3"
6507,100,2,1900,2000,"Sub-basin 3"
6508,200,2,5700,5900,"Sub-basin 3"
6509,300,4,9000,9300,"Sub-basin 3"
6510,100,1,1300,1400,"Sub-basin 3"
6511,100,1,2700,2800,"Sub-basin 3"
6512,100,4,1300,1400,"Sub-basin 3"
6513,300,21,4800,5100,"Sub-basin 3"
6514,100,1,2800,2900,"Sub-basin 3"
6515,900,60,13500,14400,"Sub-basin 3"
6516,100,2.0022,2000,2100,"Sub-basin 3"
6517,1200,49,10500,11700,"Sub-basin 3"
6518,100,3,3600,3700,"Sub-basin 3"
6519,3000,177,31000,34000,"Sub-basin 3"
6520,900,66,7600,8500,"Sub-basin 3"
6521,100,3,2300,2400,"Sub-basin 3"
6522,300,12,3300,3600,"Sub-basin 3"
6523,500,17,5800,6300,"Sub-basin 3"
6524,100,1,1800,1900,"Sub-basin 3"
6525,600,29,3100,3700,"Sub-basin 3"
6526,100,1,2100,2200,"Sub-basin 3"
6527,800,30,13100,13900,"Sub-basin 3"
6528,100,1,2600,2700,"Sub-basin 3"
6529,4500,396,27900,32400,"Sub-basin 3"
6530,4000,224,26000,30000,"Sub-basin 3"
6531,6700,336,42200,48900,"Sub-basin 3"
6532,100,3,1400,1500,"Sub-basin 3"
6533,1500,456,4800,6300,"Sub-basin 3"
6534,300,20,1700,2000,"Sub-basin 3"
6535,700,39,3800,4500,"Sub-basin 3"
6536,800,123,10600,11400,"Sub-basin 3"
6537,100,1.0025,2500,2600,"Sub-basin 3"
6538,200,5,1200,1400,"Sub-basin 3"
6539,1300,43,8300,9600,"Sub-basin 3"
6540,200,3,2100,2300,"Sub-basin 3"
6541,200,5,3700,3900,"Sub-basin 3"
6542,4900,247,40000,44900,"Sub-basin 3"
6543,100,1,3400,3500,"Sub-basin 3"
6544,400,14,13100,13500,"Sub-basin 3"
6545,100,3,2200,2300,"Sub-basin 3"
6546,100,1,2900,3000,"Sub-basin 3"
6547,100,1,3300,3400,"Sub-basin 3"
6548,100,3,3000,3100,"Sub-basin 3"
6549,200,3,4500,4700,"Sub-basin 3"
6550,2600,127,22300,24900,"Sub-basin 3"
6551,100,3.0014,300,400,"Sub-basin 3"
6552,900,37.0322,12500,13400,"Sub-basin 3"
6553,100,1,1600,1700,"Sub-basin 3"
6554,100,2,900,1000,"Sub-basin 3"
6555,100,1,1400,1500,"Sub-basin 3"
6556,400,35,1200,1600,"Sub-basin 3"
6557,100,1,1000,1100,"Sub-basin 3"
6558,100,3,2700,2800,"Sub-basin 3"
6559,200,6,3400,3600,"Sub-basin 3"
6560,200,12,4100,4300,"Sub-basin 3"
6561,100,3,1200,1300,"Sub-basin 3"
6562,500,28,5600,6100,"Sub-basin 3"
6563,200,5,1600,1800,"Sub-basin 3"
6564,4100,149,54400,58500,"Sub-basin 3"
6565,100,1,3300,3400,"Sub-basin 3"
6566,100,5,2400,2500,"Sub-basin 3"
6567,100,1,2500,2600,"Sub-basin 3"
6568,100,1,3600,3700,"Sub-basin 3"
6569,2500,293,6200,8700,"Sub-basin 3"
6570,400,40,4900,5300,"Sub-basin 3"
6571,100,1,2000,2100,"Sub-basin 3"
6572,1000,147,2900,3900,"Sub-basin 3"
6573,3000,271,10800,13800,"Sub-basin 3"
6574,1200,54,16900,18100,"Sub-basin 3"
6575,100,2,3000,3100,"Sub-basin 3"
6576,100,1,2500,2600,"Sub-basin 3"
6577,400,8,6300,6700,"Sub-basin 3"
6578,100,1,1300,1400,"Sub-basin 3"
6579,100,1,3000,3100,"Sub-basin 3"
6580,100,4,3000,3100,"Sub-basin 3"
6581,400,13,7000,7400,"Sub-basin 3"
6582,1000,77,6700,7700,"Sub-basin 3"
6583,600,21,5100,5700,"Sub-basin 3"
6584,100,3,1600,1700,"Sub-basin 3"
6585,5000,146,40600,45600,"Sub-basin 3"
6586,1000,35,16300,17300,"Sub-basin 3"
6587,200,14,2700,2900,"Sub-basin 3"
6588,300,6,4500,4800,"Sub-basin 3"
6589,400,7.0076,6600,7000,"Sub-basin 3"
6590,100,2.0017,2800,2900,"Sub-basin 3"
6591,100,2.0019,1700,1800,"Sub-basin 3"
6592,400,11.0048,2600,3000,"Sub-basin 3"
6593,200,6,1300,1500,"Sub-basin 3"
6594,400,11,5800,6200,"Sub-basin 3"
6595,1300,368,8400,9700,"Sub-basin 3"
6596,100,1,1200,1300,"Sub-basin 3"
6597,300,10,3600,3900,"Sub-basin 3"
6598,300,11,5200,5500,"Sub-basin 3"
6599,200,3,2800,3000,"Sub-basin 3"
6600,200,6,3300,3500,"Sub-basin 3"
6601,700,21,6500,7200,"Sub-basin 3"
6602,100,1,900,1000,"Sub-basin 3"
6603,500,21,6800,7300,"Sub-basin 3"
6604,200,9,5200,5400,"Sub-basin 3"
6605,200,5,1100,1300,"Sub-basin 3"
6606,1300,223,5600,6900,"Sub-basin 3"
6607,1600,157,3100,4700,"Sub-basin 3"
6608,600,37,5300,5900,"Sub-basin 3"
6609,200,2,2800,3000,"Sub-basin 3"
6610,500,17,5800,6300,"Sub-basin 3"
6611,200,9,3100,3300,"Sub-basin 3"
6612,200,5,3400,3600,"Sub-basin 3"
6613,500,34,8400,8900,"Sub-basin 3"
6614,100,2,2100,2200,"Sub-basin 3"
6615,100,2,3400,3500,"Sub-basin 3"
6616,100,1,3100,3200,"Sub-basin 3"
6617,300,7,7300,7600,"Sub-basin 3"
6618,600,14,10200,10800,"Sub-basin 3"
6619,100,2,3600,3700,"Sub-basin 3"
6620,100,2,3600,3700,"Sub-basin 3"
6621,100,3,2500,2600,"Sub-basin 3"
6622,100,1,100,200,"Sub-basin 3"
6623,100,6,600,700,"Sub-basin 3"
6624,900,281,7200,8100,"Sub-basin 3"
6625,300,8,5600,5900,"Sub-basin 3"
6626,400,58,5900,6300,"Sub-basin 3"
6627,2300,235,24000,26300,"Sub-basin 3"
6628,300,29,2600,2900,"Sub-basin 3"
6629,2600,219,11700,14300,"Sub-basin 3"
6630,200,6,3500,3700,"Sub-basin 3"
6631,100,1,4700,4800,"Sub-basin 3"
6632,100,2,4700,4800,"Sub-basin 3"
6633,2000,94,10200,12200,"Sub-basin 3"
6634,700,30,5000,5700,"Sub-basin 3"
6635,200,4,7800,8000,"Sub-basin 3"
6636,100,1,2000,2100,"Sub-basin 3"
6637,100,2,500,600,"Sub-basin 3"
6638,100,2,2100,2200,"Sub-basin 3"
6639,200,4,2100,2300,"Sub-basin 3"
6640,200,6,3600,3800,"Sub-basin 3"
6641,100,2.0019,1600,1700,"Sub-basin 3"
6642,400,9.0077,2900,3300,"Sub-basin 3"
6643,2100,106,13200,15300,"Sub-basin 3"
6644,1300,47,14700,16000,"Sub-basin 3"
6645,700,36,7300,8000,"Sub-basin 3"
6646,100,1,1000,1100,"Sub-basin 3"
6647,1000,69,5200,6200,"Sub-basin 3"
6648,500,17,1700,2200,"Sub-basin 3"
6649,1200,66,11500,12700,"Sub-basin 3"
6650,900,44,9600,10500,"Sub-basin 3"
6651,200,6,3400,3600,"Sub-basin 3"
6652,300,13,9200,9500,"Sub-basin 3"
6653,200,2,3900,4100,"Sub-basin 3"
6654,100,1,1400,1500,"Sub-basin 3"
6655,200,7,3400,3600,"Sub-basin 3"
6656,200,2,3300,3500,"Sub-basin 3"
6657,100,3,2300,2400,"Sub-basin 3"
6658,3800,304,32700,36500,"Sub-basin 3"
6659,100,1,2300,2400,"Sub-basin 3"
6660,3500,432,46200,49700,"Sub-basin 3"
6661,100,3,3100,3200,"Sub-basin 3"
6662,100,1,2900,3000,"Sub-basin 3"
6663,100,1,4100,4200,"Sub-basin 3"
6664,100,2,900,1000,"Sub-basin 3"
6665,200,5,800,1000,"Sub-basin 3"
6666,300,11,4200,4500,"Sub-basin 3"
6667,300,9.0037,4600,4900,"Sub-basin 3"
6668,100,3.0007,1600,1700,"Sub-basin 3"
6669,100,1.0013,1900,2000,"Sub-basin 3"
6670,300,4.0091,4800,5100,"Sub-basin 3"
6671,200,12,2200,2400,"Sub-basin 3"
6672,500,47,2500,3000,"Sub-basin 3"
6673,400,6,4200,4600,"Sub-basin 3"
6674,400,29,4800,5200,"Sub-basin 3"
6675,100,1,1100,1200,"Sub-basin 3"
6676,100,2,1900,2000,"Sub-basin 3"
6677,300,7,3700,4000,"Sub-basin 3"
6678,200,5,6000,6200,"Sub-basin 3"
6679,300,3,4400,4700,"Sub-basin 3"
6680,1500,97,20700,22200,"Sub-basin 3"
6681,300,4,2600,2900,"Sub-basin 3"
6682,100,1,1200,1300,"Sub-basin 3"
6683,400,13,4400,4800,"Sub-basin 3"
6684,700,11,11600,12300,"Sub-basin 3"
6685,200,3,4500,4700,"Sub-basin 3"
6686,1100,27,18100,19200,"Sub-basin 3"
6687,100,3,1700,1800,"Sub-basin 3"
6688,2000,149,13000,15000,"Sub-basin 3"
6689,600,16,6100,6700,"Sub-basin 3"
6690,100,5,1000,1100,"Sub-basin 3"
6691,1000,111,3500,4500,"Sub-basin 3"
6692,200,3,1300,1500,"Sub-basin 3"
6693,500,26,3600,4100,"Sub-basin 3"
6694,300,10,4000,4300,"Sub-basin 3"
6695,300,9,4200,4500,"Sub-basin 3"
6696,300,3,3700,4000,"Sub-basin 3"
6697,400,8,5900,6300,"Sub-basin 3"
6698,100,4,2600,2700,"Sub-basin 3"
6699,200,5,5900,6100,"Sub-basin 3"
6700,100,1,1300,1400,"Sub-basin 3"
6701,100,2,3100,3200,"Sub-basin 3"
6702,1000,118,6400,7400,"Sub-basin 3"
6703,300,10,4300,4600,"Sub-basin 3"
6704,100,1,900,1000,"Sub-basin 3"
6705,700,15,12200,12900,"Sub-basin 3"
6706,100,2,3300,3400,"Sub-basin 3"
6707,200,2,2400,2600,"Sub-basin 3"
6708,600,43,7300,7900,"Sub-basin 3"
6709,400,37,3300,3700,"Sub-basin 3"
6710,300,10,5600,5900,"Sub-basin 3"
6711,2000,110,29100,31100,"Sub-basin 3"
6712,300,5.0046,5100,5400,"Sub-basin 3"
6713,1500,353,6900,8400,"Sub-basin 3"
6714,200,4,1600,1800,"Sub-basin 3"
6715,600,17,7200,7800,"Sub-basin 3"
6716,200,6,7200,7400,"Sub-basin 3"
6717,400,5,8500,8900,"Sub-basin 3"
6718,100,3,3700,3800,"Sub-basin 3"
6719,200,3,4700,4900,"Sub-basin 3"
6720,100,1,3000,3100,"Sub-basin 3"
6721,100,3,4300,4400,"Sub-basin 3"
6722,100,1,1600,1700,"Sub-basin 3"
6723,700,12,4300,5000,"Sub-basin 3"
6724,100,1,800,900,"Sub-basin 3"
6725,200,36,2700,2900,"Sub-basin 3"
6726,500,82,6000,6500,"Sub-basin 3"
6727,2700,344,5400,8100,"Sub-basin 3"
6728,100,2,2600,2700,"Sub-basin 3"
6729,400,14,5100,5500,"Sub-basin 3"
6730,200,7,3100,3300,"Sub-basin 3"
6731,100,2,3000,3100,"Sub-basin 3"
6732,100,2,2300,2400,"Sub-basin 3"
6733,800,51,4200,5000,"Sub-basin 3"
6734,500,21,4200,4700,"Sub-basin 3"
6735,200,16,5900,6100,"Sub-basin 3"
6736,17900,1227.609,57400,75300,"Sub-basin 3"
6737,1400,33,9700,11100,"Sub-basin 3"
6738,200,7,1100,1300,"Sub-basin 3"
6739,200,9,1100,1300,"Sub-basin 3"
6740,400,26,1800,2200,"Sub-basin 3"
6741,100,2,1200,1300,"Sub-basin 3"
6742,200,5,4200,4400,"Sub-basin 3"
6743,200,6,3700,3900,"Sub-basin 3"
6744,100,1,4100,4200,"Sub-basin 3"
6745,100,4,2800,2900,"Sub-basin 3"
6746,1400,109,12600,14000,"Sub-basin 3"
6747,300,5,5300,5600,"Sub-basin 3"
6748,200,3,3100,3300,"Sub-basin 3"
6749,200,13,5600,5800,"Sub-basin 3"
6750,1500,61,17400,18900,"Sub-basin 3"
6751,1200,62,7700,8900,"Sub-basin 3"
6752,400,11,5800,6200,"Sub-basin 3"
6753,100,2,3700,3800,"Sub-basin 3"
6754,400,5,7900,8300,"Sub-basin 3"
6755,100,1,3000,3100,"Sub-basin 3"
6756,900,17,14100,15000,"Sub-basin 3"
6757,100,1,1700,1800,"Sub-basin 3"
6758,700,11,6700,7400,"Sub-basin 3"
6759,300,6,8400,8700,"Sub-basin 3"
6760,200,2,5500,5700,"Sub-basin 3"
6761,100,1,2300,2400,"Sub-basin 3"
6762,300,14,2000,2300,"Sub-basin 3"
6763,200,2,700,900,"Sub-basin 3"
6764,400,12,4600,5000,"Sub-basin 3"
6765,7700,1519,36900,44600,"Sub-basin 3"
6766,2000,724,9500,11500,"Sub-basin 3"
6767,23900,2988,107800,131700,"Sub-basin 3"
6768,600,50,3000,3600,"Sub-basin 3"
6769,1100,55,14800,15900,"Sub-basin 3"
6770,200,6,6800,7000,"Sub-basin 3"
6771,200,4,4900,5100,"Sub-basin 3"
6772,100,1,4100,4200,"Sub-basin 3"
6773,300,6,3800,4100,"Sub-basin 3"
6774,600,34,9700,10300,"Sub-basin 3"
6775,300,4,6600,6900,"Sub-basin 3"
6776,100,1,1700,1800,"Sub-basin 3"
6777,800,29,11600,12400,"Sub-basin 3"
6778,200,4,3200,3400,"Sub-basin 3"
6779,3400,239,21600,25000,"Sub-basin 3"
6780,100,4,2000,2100,"Sub-basin 3"
6781,200,11,3100,3300,"Sub-basin 3"
6782,300,40,1800,2100,"Sub-basin 3"
6783,100,4,1000,1100,"Sub-basin 3"
6784,200,12,2100,2300,"Sub-basin 3"
6785,400,49,1100,1500,"Sub-basin 3"
6786,100,2,900,1000,"Sub-basin 3"
6787,100,1,2700,2800,"Sub-basin 3"
6788,100,1,1600,1700,"Sub-basin 3"
6789,500,22,6100,6600,"Sub-basin 3"
6790,200,3,2900,3100,"Sub-basin 3"
6791,4200,654,19100,23300,"Sub-basin 3"
6792,100,1,1800,1900,"Sub-basin 3"
6793,100,3,2000,2100,"Sub-basin 3"
6794,500,23,7600,8100,"Sub-basin 3"
6795,300,9,6000,6300,"Sub-basin 3"
6796,100,1,1200,1300,"Sub-basin 3"
6797,600,37,6300,6900,"Sub-basin 3"
6798,200,14,3300,3500,"Sub-basin 3"
6799,100,1,1900,2000,"Sub-basin 3"
6800,200,5,3000,3200,"Sub-basin 3"
6801,500,10,7000,7500,"Sub-basin 3"
6802,200,4,900,1100,"Sub-basin 3"
6803,200,4,2800,3000,"Sub-basin 3"
6804,300,10,1700,2000,"Sub-basin 3"
6805,400,9,2300,2700,"Sub-basin 3"
6806,200,7,2100,2300,"Sub-basin 3"
6807,200,5,5500,5700,"Sub-basin 3"
6808,500,10,8300,8800,"Sub-basin 3"
6809,500,35,1900,2400,"Sub-basin 3"
6810,600,45,5300,5900,"Sub-basin 3"
6811,200,8,4500,4700,"Sub-basin 3"
6812,200,2,2300,2500,"Sub-basin 3"
6813,100,2,1900,2000,"Sub-basin 3"
6814,100,1,1200,1300,"Sub-basin 3"
6815,100,3,3400,3500,"Sub-basin 3"
6816,100,1,2600,2700,"Sub-basin 3"
6817,2200,57,40600,42800,"Sub-basin 3"
6818,400,11,3600,4000,"Sub-basin 3"
6819,100,1,1600,1700,"Sub-basin 3"
6820,1800,57.0929,13300,15100,"Sub-basin 3"
6821,100,1,900,1000,"Sub-basin 3"
6822,100,1,1700,1800,"Sub-basin 3"
6823,200,6,1000,1200,"Sub-basin 3"
6824,500,21,7100,7600,"Sub-basin 3"
6825,500,18,4000,4500,"Sub-basin 3"
6826,3400,347,14600,18000,"Sub-basin 3"
6827,600,28,4200,4800,"Sub-basin 3"
6828,200,6,3100,3300,"Sub-basin 3"
6829,300,6,4400,4700,"Sub-basin 3"
6830,500,21,6200,6700,"Sub-basin 3"
6831,100,3,3100,3200,"Sub-basin 3"
6832,500,29,4500,5000,"Sub-basin 3"
6833,100,1,4100,4200,"Sub-basin 3"
6834,100,1,2900,3000,"Sub-basin 3"
6835,4800,393,29000,33800,"Sub-basin 3"
6836,200,3,2600,2800,"Sub-basin 3"
6837,5600,924,18900,24500,"Sub-basin 3"
6838,100,1,3700,3800,"Sub-basin 3"
6839,1300,185,7700,9000,"Sub-basin 3"
6840,100,1,1300,1400,"Sub-basin 3"
6841,200,9,2100,2300,"Sub-basin 3"
6842,1700,306,10100,11800,"Sub-basin 3"
6843,1900,88,21900,23800,"Sub-basin 3"
6844,400,18,6200,6600,"Sub-basin 3"
6845,1700,78,14800,16500,"Sub-basin 3"
6846,100,1,1300,1400,"Sub-basin 3"
6847,100,2,2100,2200,"Sub-basin 3"
6848,100,1,2700,2800,"Sub-basin 3"
6849,900,51,6200,7100,"Sub-basin 3"
6850,1900,108,11100,13000,"Sub-basin 3"
6851,500,8,6600,7100,"Sub-basin 3"
6852,100,1,2200,2300,"Sub-basin 3"
6853,100,1,3900,4000,"Sub-basin 3"
6854,7000,329,40300,47300,"Sub-basin 3"
6855,6100,2101,31500,37600,"Sub-basin 3"
6856,1600,67,19600,21200,"Sub-basin 3"
6857,100,1.0018,1300,1400,"Sub-basin 3"
6858,100,1,800,900,"Sub-basin 3"
6859,100,4,1100,1200,"Sub-basin 3"
6860,400,13,5000,5400,"Sub-basin 3"
6861,1800,141,11500,13300,"Sub-basin 3"
6862,200,11,1800,2000,"Sub-basin 3"
6863,1300,205,6200,7500,"Sub-basin 3"
6864,1000,94,6300,7300,"Sub-basin 3"
6865,200,19,3300,3500,"Sub-basin 3"
6866,100,1,5500,5600,"Sub-basin 3"
6867,200,8,3300,3500,"Sub-basin 3"
6868,200,3,3600,3800,"Sub-basin 3"
6869,500,26,5000,5500,"Sub-basin 3"
6870,100,1,3200,3300,"Sub-basin 3"
6871,100,3,3500,3600,"Sub-basin 3"
6872,100,1,1100,1200,"Sub-basin 3"
6873,100,2,3300,3400,"Sub-basin 3"
6874,2100,101,29400,31500,"Sub-basin 3"
6875,700,15,7200,7900,"Sub-basin 3"
6876,200,3,1500,1700,"Sub-basin 3"
6877,100,1,3000,3100,"Sub-basin 3"
6878,100,1,2300,2400,"Sub-basin 3"
6879,200,4,2400,2600,"Sub-basin 3"
6880,200,10,4300,4500,"Sub-basin 3"
6881,800,19.0487,7500,8300,"Sub-basin 3"
6882,100,3.0016,1100,1200,"Sub-basin 3"
6883,100,1.0019,1200,1300,"Sub-basin 3"
6884,1800,275,9800,11600,"Sub-basin 3"
6885,1700,297,14700,16400,"Sub-basin 3"
6886,100,3,1700,1800,"Sub-basin 3"
6887,200,3,3700,3900,"Sub-basin 3"
6888,200,3,1200,1400,"Sub-basin 3"
6889,100,2,900,1000,"Sub-basin 3"
6890,100,4,900,1000,"Sub-basin 3"
6891,100,5,1100,1200,"Sub-basin 3"
6892,400,15,4800,5200,"Sub-basin 3"
6893,100,2,2400,2500,"Sub-basin 3"
6894,100,1,1400,1500,"Sub-basin 3"
6895,2800,163,35300,38100,"Sub-basin 3"
6896,100,1,1900,2000,"Sub-basin 3"
6897,400,6,9000,9400,"Sub-basin 3"
6898,100,2,1900,2000,"Sub-basin 3"
6899,400,12,3600,4000,"Sub-basin 3"
6900,200,2,6300,6500,"Sub-basin 3"
6901,100,1,900,1000,"Sub-basin 3"
6902,100,2,1800,1900,"Sub-basin 3"
6903,500,21.0114,2500,3000,"Sub-basin 3"
6904,300,9.0098,2100,2400,"Sub-basin 3"
6905,100,2,300,400,"Sub-basin 3"
6906,400,29,1900,2300,"Sub-basin 3"
6907,500,25,8400,8900,"Sub-basin 3"
6908,400,7,5600,6000,"Sub-basin 3"
6909,200,2,4100,4300,"Sub-basin 3"
6910,200,4,4200,4400,"Sub-basin 3"
6911,300,7,4200,4500,"Sub-basin 3"
6912,600,33,11200,11800,"Sub-basin 3"
6913,100,1,2100,2200,"Sub-basin 3"
6914,100,1,2700,2800,"Sub-basin 3"
6915,300,7,5400,5700,"Sub-basin 3"
6916,100,1,3800,3900,"Sub-basin 3"
6917,100,1,3300,3400,"Sub-basin 3"
6918,200,3,2700,2900,"Sub-basin 3"
6919,500,16,5900,6400,"Sub-basin 3"
6920,900,56,9700,10600,"Sub-basin 3"
6921,100,1,1300,1400,"Sub-basin 3"
6922,400,13,1400,1800,"Sub-basin 3"
6923,200,12,1400,1600,"Sub-basin 3"
6924,14800,2092,90000,104800,"Sub-basin 3"
6925,100,1,700,800,"Sub-basin 3"
6926,200,16,1400,1600,"Sub-basin 3"
6927,300,3,5500,5800,"Sub-basin 3"
6928,100,1,2600,2700,"Sub-basin 3"
6929,100,3,2800,2900,"Sub-basin 3"
6930,700,20,21000,21700,"Sub-basin 3"
6931,1000,26,18400,19400,"Sub-basin 3"
6932,100,3,1900,2000,"Sub-basin 3"
6933,700,29,12400,13100,"Sub-basin 3"
6934,100,3,2400,2500,"Sub-basin 3"
6935,100,1,1600,1700,"Sub-basin 3"
6936,6300,584,30000,36300,"Sub-basin 3"
6937,200,3,6400,6600,"Sub-basin 3"
6938,300,12,7300,7600,"Sub-basin 3"
6939,100,1,1700,1800,"Sub-basin 3"
6940,200,8,5000,5200,"Sub-basin 3"
6941,100,1,2000,2100,"Sub-basin 3"
6942,100,3,2800,2900,"Sub-basin 3"
6943,5200,370,87200,92400,"Sub-basin 3"
6944,100,1,1900,2000,"Sub-basin 3"
6945,200,4,2300,2500,"Sub-basin 3"
6946,100,1,2100,2200,"Sub-basin 3"
6947,400,8,4600,5000,"Sub-basin 3"
6948,700,21,7200,7900,"Sub-basin 3"
6949,300,6,5200,5500,"Sub-basin 3"
6950,300,12.0056,3200,3500,"Sub-basin 3"
6951,700,103,2500,3200,"Sub-basin 3"
6952,2500,179,13600,16100,"Sub-basin 3"
6953,100,2,1200,1300,"Sub-basin 3"
6954,7400,905,24600,32000,"Sub-basin 3"
6955,900,65,6400,7300,"Sub-basin 3"
6956,900,40,11100,12000,"Sub-basin 3"
6957,300,8,6300,6600,"Sub-basin 3"
6958,500,17,3600,4100,"Sub-basin 3"
6959,400,22,2000,2400,"Sub-basin 3"
6960,1000,93,8100,9100,"Sub-basin 3"
6961,100,2,100,200,"Sub-basin 3"
6962,1500,136,17500,19000,"Sub-basin 3"
6963,300,4,2500,2800,"Sub-basin 3"
6964,600,25,6400,7000,"Sub-basin 3"
6965,700,56,8000,8700,"Sub-basin 3"
6966,100,1,2800,2900,"Sub-basin 3"
6967,3300,166,30700,34000,"Sub-basin 3"
6968,700,14,14500,15200,"Sub-basin 3"
6969,200,3,3700,3900,"Sub-basin 3"
6970,100,2,1300,1400,"Sub-basin 3"
6971,200,3,3400,3600,"Sub-basin 3"
6972,2100,181,18300,20400,"Sub-basin 3"
6973,200,4,3100,3300,"Sub-basin 3"
6974,200,6,7700,7900,"Sub-basin 3"
6975,100,1,1800,1900,"Sub-basin 3"
6976,100,1,900,1000,"Sub-basin 3"
6977,200,2,3800,4000,"Sub-basin 3"
6978,300,21,2400,2700,"Sub-basin 3"
6979,1600,365,7800,9400,"Sub-basin 3"
6980,600,15.026,11300,11900,"Sub-basin 3"
6981,900,71,5800,6700,"Sub-basin 3"
6982,7700,867.5,48900,56600,"Sub-basin 3"
6983,400,38,2800,3200,"Sub-basin 3"
6984,100,1,1100,1200,"Sub-basin 3"
6985,100,11,1200,1300,"Sub-basin 3"
6986,100,2,2300,2400,"Sub-basin 3"
6987,200,4,2100,2300,"Sub-basin 3"
6988,100,1,600,700,"Sub-basin 3"
6989,200,3,3000,3200,"Sub-basin 3"
6990,100,1,3700,3800,"Sub-basin 3"
6991,200,10,3500,3700,"Sub-basin 3"
6992,100,3,2000,2100,"Sub-basin 3"
6993,500,20,5000,5500,"Sub-basin 3"
6994,200,4,2100,2300,"Sub-basin 3"
6995,100,1.0018,2400,2500,"Sub-basin 3"
6996,100,3.002,2600,2700,"Sub-basin 3"
6997,200,4,500,700,"Sub-basin 3"
6998,100,1,800,900,"Sub-basin 3"
6999,200,3,3300,3500,"Sub-basin 3"
7000,200,3,5500,5700,"Sub-basin 3"
7001,100,2,2300,2400,"Sub-basin 3"
7002,100,1,3200,3300,"Sub-basin 3"
7003,300,5,9100,9400,"Sub-basin 3"
7004,600,23,9700,10300,"Sub-basin 3"
7005,500,13,5700,6200,"Sub-basin 3"
7006,300,5,3600,3900,"Sub-basin 3"
7007,200,4.66,4000,4200,"Sub-basin 3"
7008,900,61,4400,5300,"Sub-basin 3"
7009,100,2,1400,1500,"Sub-basin 3"
7010,300,10,2700,3000,"Sub-basin 3"
7011,200,6,2500,2700,"Sub-basin 3"
7012,1500,84,11900,13400,"Sub-basin 3"
7013,100,1,2800,2900,"Sub-basin 3"
7014,700,26,5600,6300,"Sub-basin 3"
7015,300,4,5500,5800,"Sub-basin 3"
7016,1200,28,17000,18200,"Sub-basin 3"
7017,100,1,2400,2500,"Sub-basin 3"
7018,100,2,3100,3200,"Sub-basin 3"
7019,100,3,3200,3300,"Sub-basin 3"
7020,100,1,2900,3000,"Sub-basin 3"
7021,100,1,1600,1700,"Sub-basin 3"
7022,100,2,2000,2100,"Sub-basin 3"
7023,1400,175,5300,6700,"Sub-basin 3"
7024,1300,208,8200,9500,"Sub-basin 3"
7025,1000,152,2900,3900,"Sub-basin 3"
7026,100,2,1800,1900,"Sub-basin 3"
7027,1000,82,6500,7500,"Sub-basin 3"
7028,300,12,2700,3000,"Sub-basin 3"
7029,1600,135,8400,10000,"Sub-basin 3"
7030,100,1,4500,4600,"Sub-basin 3"
7031,100,2,1100,1200,"Sub-basin 3"
7032,500,39,6100,6600,"Sub-basin 3"
7033,200,8,2000,2200,"Sub-basin 3"
7034,100,2,900,1000,"Sub-basin 3"
7035,200,3,3500,3700,"Sub-basin 3"
7036,800,32,11800,12600,"Sub-basin 3"
7037,200,4,3200,3400,"Sub-basin 3"
7038,200,3,4000,4200,"Sub-basin 3"
7039,1100,40,13000,14100,"Sub-basin 3"
7040,100,1,2900,3000,"Sub-basin 3"
7041,100,2,1500,1600,"Sub-basin 3"
7042,200,5,1000,1200,"Sub-basin 3"
7043,300,7,3400,3700,"Sub-basin 3"
7044,300,4,5500,5800,"Sub-basin 3"
7045,200,2.0056,3100,3300,"Sub-basin 3"
7046,100,2,1000,1100,"Sub-basin 3"
7047,100,6,900,1000,"Sub-basin 3"
7048,100,1,1400,1500,"Sub-basin 3"
7049,100,1,1400,1500,"Sub-basin 3"
7050,800,20,9100,9900,"Sub-basin 3"
7051,2400,256,19400,21800,"Sub-basin 3"
7052,100,1,2100,2200,"Sub-basin 3"
7053,200,3,5900,6100,"Sub-basin 3"
7054,200,15,4600,4800,"Sub-basin 3"
7055,100,2,2300,2400,"Sub-basin 3"
7056,200,3,2800,3000,"Sub-basin 3"
7057,1200,39.34,9200,10400,"Sub-basin 3"
7058,1100,39,16800,17900,"Sub-basin 3"
7059,200,4,7500,7700,"Sub-basin 3"
7060,700,26,11100,11800,"Sub-basin 3"
7061,100,2,2900,3000,"Sub-basin 3"
7062,100,1,4200,4300,"Sub-basin 3"
7063,200,3,3200,3400,"Sub-basin 3"
7064,200,3,3400,3600,"Sub-basin 3"
7065,200,9,2600,2800,"Sub-basin 3"
7066,1000,79,5100,6100,"Sub-basin 3"
7067,200,5,3200,3400,"Sub-basin 3"
7068,300,29,4100,4400,"Sub-basin 3"
7069,7900,1706,33600,41500,"Sub-basin 3"
7070,700,157,3300,4000,"Sub-basin 3"
7071,300,5,800,1100,"Sub-basin 3"
7072,1100,109,4600,5700,"Sub-basin 3"
7073,200,9,2800,3000,"Sub-basin 3"
7074,300,21,2600,2900,"Sub-basin 3"
7075,900,23,7500,8400,"Sub-basin 3"
7076,700,32,4900,5600,"Sub-basin 3"
7077,200,7,2300,2500,"Sub-basin 3"
7078,100,2,2000,2100,"Sub-basin 3"
7079,4000,353,17400,21400,"Sub-basin 3"
7080,100,1,2500,2600,"Sub-basin 3"
7081,100,2,2800,2900,"Sub-basin 3"
7082,300,13,5200,5500,"Sub-basin 3"
7083,100,1,2600,2700,"Sub-basin 3"
7084,7700,594,56000,63700,"Sub-basin 3"
7085,500,9,9100,9600,"Sub-basin 3"
7086,1100,70,11300,12400,"Sub-basin 3"
7087,100,1,3000,3100,"Sub-basin 3"
7088,800,26,15700,16500,"Sub-basin 3"
7089,200,4,8700,8900,"Sub-basin 3"
7090,200,5,5500,5700,"Sub-basin 3"
7091,300,6,8600,8900,"Sub-basin 3"
7092,100,3,1400,1500,"Sub-basin 3"
7093,600,57,4800,5400,"Sub-basin 3"
7094,100,2.0017,2700,2800,"Sub-basin 3"
7095,500,34,4900,5400,"Sub-basin 3"
7096,3400,483,8700,12100,"Sub-basin 3"
7097,200,3,1500,1700,"Sub-basin 3"
7098,100,5,3100,3200,"Sub-basin 3"
7099,100,1,1900,2000,"Sub-basin 3"
7100,1200,80,11700,12900,"Sub-basin 3"
7101,100,1,1300,1400,"Sub-basin 3"
7102,100,1,2500,2600,"Sub-basin 3"
7103,100,1,3300,3400,"Sub-basin 3"
7104,100,1,600,700,"Sub-basin 3"
7105,700,43,8400,9100,"Sub-basin 3"
7106,800,77,6000,6800,"Sub-basin 3"
7107,600,88,1100,1700,"Sub-basin 3"
7108,300,11,3400,3700,"Sub-basin 3"
7109,800,36,5100,5900,"Sub-basin 3"
7110,1600,588,9400,11000,"Sub-basin 3"
7111,100,3,3800,3900,"Sub-basin 3"
7112,400,19,2300,2700,"Sub-basin 3"
7113,300,5,5500,5800,"Sub-basin 3"
7114,500,20,5500,6000,"Sub-basin 3"
7115,300,9,6900,7200,"Sub-basin 3"
7116,400,10,6300,6700,"Sub-basin 3"
7117,100,1,2300,2400,"Sub-basin 3"
7118,100,1,1100,1200,"Sub-basin 3"
7119,200,3,2600,2800,"Sub-basin 3"
7120,100,1,2800,2900,"Sub-basin 3"
7121,5800,458,38000,43800,"Sub-basin 3"
7122,6600,427,31200,37800,"Sub-basin 3"
7123,100,1,1800,1900,"Sub-basin 3"
7124,300,8.0088,5400,5700,"Sub-basin 3"
7125,100,4.0061,2500,2600,"Sub-basin 3"
7126,600,12,5900,6500,"Sub-basin 3"
7127,400,27,2600,3000,"Sub-basin 3"
7128,200,8,2900,3100,"Sub-basin 3"
7129,200,4,2400,2600,"Sub-basin 3"
7130,100,1,900,1000,"Sub-basin 3"
7131,800,62,2300,3100,"Sub-basin 3"
7132,400,12,3500,3900,"Sub-basin 3"
7133,500,20,3500,4000,"Sub-basin 3"
7134,400,25,3500,3900,"Sub-basin 3"
7135,100,1,3400,3500,"Sub-basin 3"
7136,200,6,900,1100,"Sub-basin 3"
7137,200,4,2500,2700,"Sub-basin 3"
7138,200,2,2200,2400,"Sub-basin 3"
7139,100,2,1400,1500,"Sub-basin 3"
7140,500,33,5000,5500,"Sub-basin 3"
7141,100,1,2200,2300,"Sub-basin 3"
7142,200,2,3200,3400,"Sub-basin 3"
7143,100,1,1700,1800,"Sub-basin 3"
7144,1600,73,27500,29100,"Sub-basin 3"
7145,100,2,2600,2700,"Sub-basin 3"
7146,100,1,2300,2400,"Sub-basin 3"
7147,200,3,3600,3800,"Sub-basin 3"
7148,3500,132,60400,63900,"Sub-basin 3"
7149,5100,336,25100,30200,"Sub-basin 3"
7150,400,15,2300,2700,"Sub-basin 3"
7151,100,1,500,600,"Sub-basin 3"
7152,100,1,2000,2100,"Sub-basin 3"
7153,1000,153,3800,4800,"Sub-basin 3"
7154,100,4,2000,2100,"Sub-basin 3"
7155,4300,327.6455,65000,69300,"Sub-basin 3"
7156,200,36,2400,2600,"Sub-basin 3"
7157,200,10,3400,3600,"Sub-basin 3"
7158,200,5,4400,4600,"Sub-basin 3"
7159,200,4,2800,3000,"Sub-basin 3"
7160,400,22,3800,4200,"Sub-basin 3"
7161,500,9,6800,7300,"Sub-basin 3"
7162,100,1,2100,2200,"Sub-basin 3"
7163,300,5,5300,5600,"Sub-basin 3"
7164,100,1,2200,2300,"Sub-basin 3"
7165,300,6,8000,8300,"Sub-basin 3"
7166,100,1,3200,3300,"Sub-basin 3"
7167,600,15,9700,10300,"Sub-basin 3"
7168,1100,52,9900,11000,"Sub-basin 3"
7169,100,4,1900,2000,"Sub-basin 3"
7170,500,24,5400,5900,"Sub-basin 3"
7171,1000,199,5300,6300,"Sub-basin 3"
7172,2500,186,11000,13500,"Sub-basin 3"
7173,200,7,1600,1800,"Sub-basin 3"
7174,100,2,1300,1400,"Sub-basin 3"
7175,500,22,2900,3400,"Sub-basin 3"
7176,300,19,3000,3300,"Sub-basin 3"
7177,100,1,2200,2300,"Sub-basin 3"
7178,200,4,3300,3500,"Sub-basin 3"
7179,300,8,2200,2500,"Sub-basin 3"
7180,800,64,4900,5700,"Sub-basin 3"
7181,100,1,700,800,"Sub-basin 3"
7182,100,1,1700,1800,"Sub-basin 3"
7183,100,2,2200,2300,"Sub-basin 3"
7184,100,1,1300,1400,"Sub-basin 3"
7185,1200,36,10500,11700,"Sub-basin 3"
7186,1400,93,12800,14200,"Sub-basin 3"
7187,100,1,1600,1700,"Sub-basin 3"
7188,100,2,2800,2900,"Sub-basin 3"
7189,100,1,2400,2500,"Sub-basin 3"
7190,400,15,2800,3200,"Sub-basin 3"
7191,2900,1535,6200,9100,"Sub-basin 3"
7192,200,22,3600,3800,"Sub-basin 3"
7193,3300,143,28300,31600,"Sub-basin 3"
7194,700,47,4200,4900,"Sub-basin 3"
7195,100,1,1200,1300,"Sub-basin 3"
7196,100,1,1200,1300,"Sub-basin 3"
7197,100,3,2400,2500,"Sub-basin 3"
7198,500,18,2200,2700,"Sub-basin 3"
7199,800,44,5500,6300,"Sub-basin 3"
7200,1100,139,6100,7200,"Sub-basin 3"
7201,900,42,8900,9800,"Sub-basin 3"
7202,100,1,1700,1800,"Sub-basin 3"
7203,100,1,800,900,"Sub-basin 3"
7204,600,18,2800,3400,"Sub-basin 3"
7205,100,1,2300,2400,"Sub-basin 3"
7206,900,30,10600,11500,"Sub-basin 3"
7207,600,53,6800,7400,"Sub-basin 3"
7208,200,8,3600,3800,"Sub-basin 3"
7209,100,2.5,1500,1600,"Sub-basin 3"
7210,100,1,2100,2200,"Sub-basin 3"
7211,100,3,2100,2200,"Sub-basin 3"
7212,100,1,1900,2000,"Sub-basin 3"
7213,6100,488,32300,38400,"Sub-basin 3"
7214,400,11,2400,2800,"Sub-basin 3"
7215,100,1,2200,2300,"Sub-basin 3"
7216,500,27,3600,4100,"Sub-basin 3"
7217,400,15,4900,5300,"Sub-basin 3"
7218,600,36,4100,4700,"Sub-basin 3"
7219,100,1,500,600,"Sub-basin 3"
7220,400,47,4100,4500,"Sub-basin 3"
7221,300,9,2900,3200,"Sub-basin 3"
7222,200,6,2000,2200,"Sub-basin 3"
7223,1700,108,15900,17600,"Sub-basin 3"
7224,200,3,2700,2900,"Sub-basin 3"
7225,100,1,2100,2200,"Sub-basin 3"
7226,100,1,2800,2900,"Sub-basin 3"
7227,400,17,2600,3000,"Sub-basin 3"
7228,100,1,3000,3100,"Sub-basin 3"
7229,100,1,3100,3200,"Sub-basin 3"
7230,200,4,2300,2500,"Sub-basin 3"
7231,400,12,4100,4500,"Sub-basin 3"
7232,200,4,1300,1500,"Sub-basin 3"
7233,200,7,1900,2100,"Sub-basin 3"
7234,1000,53,6700,7700,"Sub-basin 3"
7235,200,7,1900,2100,"Sub-basin 3"
7236,100,4,1400,1500,"Sub-basin 3"
7237,1700,403,9600,11300,"Sub-basin 3"
7238,200,10,2500,2700,"Sub-basin 3"
7239,700,35,10200,10900,"Sub-basin 3"
7240,300,19.16,2100,2400,"Sub-basin 3"
7241,200,7,1200,1400,"Sub-basin 3"
7242,700,21,13100,13800,"Sub-basin 3"
7243,300,3,9100,9400,"Sub-basin 3"
7244,100,1,2700,2800,"Sub-basin 3"
7245,200,5,2000,2200,"Sub-basin 3"
7246,13100,649,157200,170300,"Sub-basin 3"
7247,100,1,1600,1700,"Sub-basin 3"
7248,300,13,4400,4700,"Sub-basin 3"
7249,2500,231,30800,33300,"Sub-basin 3"
7250,100,1,1200,1300,"Sub-basin 3"
7251,500,30.66,3900,4400,"Sub-basin 3"
7252,700,31,5600,6300,"Sub-basin 3"
7253,100,1,2300,2400,"Sub-basin 3"
7254,400,28,5700,6100,"Sub-basin 3"
7255,700,48,3300,4000,"Sub-basin 3"
7256,2900,156,21400,24300,"Sub-basin 3"
7257,100,1,3000,3100,"Sub-basin 3"
7258,400,5,10500,10900,"Sub-basin 3"
7259,200,2,3500,3700,"Sub-basin 3"
7260,500,14,6500,7000,"Sub-basin 3"
7261,500,14,5400,5900,"Sub-basin 3"
7262,900,25,13600,14500,"Sub-basin 3"
7263,300,5,1600,1900,"Sub-basin 3"
7264,400,14,4100,4500,"Sub-basin 3"
7265,600,18,5600,6200,"Sub-basin 3"
7266,500,29,4600,5100,"Sub-basin 3"
7267,100,1,1100,1200,"Sub-basin 3"
7268,400,29,2600,3000,"Sub-basin 3"
7269,700,59,3600,4300,"Sub-basin 3"
7270,200,10,2500,2700,"Sub-basin 3"
7271,100,2,1400,1500,"Sub-basin 3"
7272,1100,65,6200,7300,"Sub-basin 3"
7273,1600,85,9400,11000,"Sub-basin 3"
7274,100,1,2400,2500,"Sub-basin 3"
7275,100,2,1800,1900,"Sub-basin 3"
7276,100,2,1700,1800,"Sub-basin 3"
7277,1000,151,900,1900,"Sub-basin 3"
7278,600,29,2700,3300,"Sub-basin 3"
7279,100,1,1700,1800,"Sub-basin 3"
7280,400,23,4900,5300,"Sub-basin 3"
7281,1700,140,15100,16800,"Sub-basin 3"
7282,400,21,2400,2800,"Sub-basin 3"
7283,200,3,2100,2300,"Sub-basin 3"
7284,8800,780,37900,46700,"Sub-basin 3"
7285,200,10,2100,2300,"Sub-basin 3"
7286,300,7,1400,1700,"Sub-basin 3"
7287,200,2,4700,4900,"Sub-basin 3"
7288,100,3,1900,2000,"Sub-basin 3"
7289,400,13,3200,3600,"Sub-basin 3"
7290,200,12,2100,2300,"Sub-basin 3"
7291,100,5,2800,2900,"Sub-basin 3"
7292,600,46,2700,3300,"Sub-basin 3"
7293,400,18,2600,3000,"Sub-basin 3"
7294,100,2,1700,1800,"Sub-basin 3"
7295,400,12,5100,5500,"Sub-basin 3"
7296,500,13,7500,8000,"Sub-basin 3"
7297,300,5,3200,3500,"Sub-basin 3"
7298,200,2,5300,5500,"Sub-basin 3"
7299,400,11,3100,3500,"Sub-basin 3"
7300,900,176,3100,4000,"Sub-basin 3"
7301,3000,653,15400,18400,"Sub-basin 3"
7302,900,118,9400,10300,"Sub-basin 3"
7303,100,1,1600,1700,"Sub-basin 3"
7304,100,4,1000,1100,"Sub-basin 3"
7305,100,2,1800,1900,"Sub-basin 3"
7306,200,3,1900,2100,"Sub-basin 3"
7307,200,8,1300,1500,"Sub-basin 3"
7308,400,22,1600,2000,"Sub-basin 3"
7309,100,4,600,700,"Sub-basin 3"
7310,1300,73,7000,8300,"Sub-basin 3"
7311,100,1,2200,2300,"Sub-basin 3"
7312,300,9,1800,2100,"Sub-basin 3"
7313,100,1,900,1000,"Sub-basin 3"
7314,100,1,2200,2300,"Sub-basin 3"
7315,300,3,8600,8900,"Sub-basin 3"
7316,100,1,1400,1500,"Sub-basin 3"
7317,100,4,1900,2000,"Sub-basin 3"
7318,1000,75,10700,11700,"Sub-basin 3"
7319,300,7,8500,8800,"Sub-basin 3"
7320,700,85,7100,7800,"Sub-basin 3"
7321,200,7,4700,4900,"Sub-basin 3"
7322,1900,45,17300,19200,"Sub-basin 3"
7323,400,23,5100,5500,"Sub-basin 3"
7324,900,110,8200,9100,"Sub-basin 3"
7325,600,39,3500,4100,"Sub-basin 3"
7326,400,14,5300,5700,"Sub-basin 3"
7327,100,3,900,1000,"Sub-basin 3"
7328,100,2,1300,1400,"Sub-basin 3"
7329,700,28,5300,6000,"Sub-basin 3"
7330,100,2,3400,3500,"Sub-basin 3"
7331,400,17,9200,9600,"Sub-basin 3"
7332,100,1,2700,2800,"Sub-basin 3"
7333,100,1,1300,1400,"Sub-basin 3"
7334,200,3,3100,3300,"Sub-basin 3"
7335,100,1,2900,3000,"Sub-basin 3"
7336,1100,37,4300,5400,"Sub-basin 3"
7337,100,3,1500,1600,"Sub-basin 3"
7338,100,2,2100,2200,"Sub-basin 3"
7339,100,1,1100,1200,"Sub-basin 3"
7340,600,74,3300,3900,"Sub-basin 3"
7341,100,5,1800,1900,"Sub-basin 3"
7342,900,120,2800,3700,"Sub-basin 3"
7343,900,84,2800,3700,"Sub-basin 3"
7344,200,15,6500,6700,"Sub-basin 3"
7345,3400,422,19900,23300,"Sub-basin 3"
7346,300,16,1800,2100,"Sub-basin 3"
7347,200,3,1700,1900,"Sub-basin 3"
7348,1400,123,9600,11000,"Sub-basin 3"
7349,200,3,3300,3500,"Sub-basin 3"
7350,200,7,3700,3900,"Sub-basin 3"
7351,14300,945,174000,188300,"Sub-basin 3"
7352,100,2,1600,1700,"Sub-basin 3"
7353,200,3,8600,8800,"Sub-basin 3"
7354,100,2,3300,3400,"Sub-basin 3"
7355,100,2,1800,1900,"Sub-basin 3"
7356,100,1,1900,2000,"Sub-basin 3"
7357,100,1,3000,3100,"Sub-basin 3"
7358,200,5,4700,4900,"Sub-basin 3"
7359,400,13,4200,4600,"Sub-basin 3"
7360,500,22,3700,4200,"Sub-basin 3"
7361,1900,147,10600,12500,"Sub-basin 3"
7362,200,5,1600,1800,"Sub-basin 3"
7363,200,13,2400,2600,"Sub-basin 3"
7364,800,48,5100,5900,"Sub-basin 3"
7365,300,18,1800,2100,"Sub-basin 3"
7366,100,1,1000,1100,"Sub-basin 3"
7367,400,18,2600,3000,"Sub-basin 3"
7368,100,3,1200,1300,"Sub-basin 3"
7369,100,4,1400,1500,"Sub-basin 3"
7370,200,3,2000,2200,"Sub-basin 3"
7371,100,1,2400,2500,"Sub-basin 3"
7372,300,5,3200,3500,"Sub-basin 3"
7373,100,2,2500,2600,"Sub-basin 3"
7374,100,1,2900,3000,"Sub-basin 3"
7375,200,4,1400,1600,"Sub-basin 3"
7376,4100,698,15900,20000,"Sub-basin 3"
7377,200,5,2000,2200,"Sub-basin 3"
7378,1300,282,6100,7400,"Sub-basin 3"
7379,600,56,4400,5000,"Sub-basin 3"
7380,200,3,900,1100,"Sub-basin 3"
7381,100,1,800,900,"Sub-basin 3"
7382,300,7,1100,1400,"Sub-basin 3"
7383,1100,67,9900,11000,"Sub-basin 3"
7384,200,5,2400,2600,"Sub-basin 3"
7385,200,3,4600,4800,"Sub-basin 3"
7386,200,4,8500,8700,"Sub-basin 3"
7387,100,3,2700,2800,"Sub-basin 3"
7388,600,24,7300,7900,"Sub-basin 3"
7389,1200,101,13800,15000,"Sub-basin 3"
7390,3300,174,35300,38600,"Sub-basin 3"
7391,200,3,3600,3800,"Sub-basin 3"
7392,1200,97,5900,7100,"Sub-basin 3"
7393,100,1,1100,1200,"Sub-basin 3"
7394,1100,47,14100,15200,"Sub-basin 3"
7395,1300,56.0575,20100,21400,"Sub-basin 3"
7396,1900,136.0549,20800,22700,"Sub-basin 3"
7397,400,14,2100,2500,"Sub-basin 3"
7398,100,1,600,700,"Sub-basin 3"
7399,100,2,1000,1100,"Sub-basin 3"
7400,300,14,3200,3500,"Sub-basin 3"
7401,100,2,3600,3700,"Sub-basin 3"
7402,100,1,3700,3800,"Sub-basin 3"
7403,100,1,2300,2400,"Sub-basin 3"
7404,8300,463,66300,74600,"Sub-basin 3"
7405,400,10,12300,12700,"Sub-basin 3"
7406,100,1,3300,3400,"Sub-basin 3"
7407,300,7,2500,2800,"Sub-basin 3"
7408,4000,675,14600,18600,"Sub-basin 3"
7409,1600,142,14200,15800,"Sub-basin 3"
7410,300,8,5200,5500,"Sub-basin 3"
7411,100,1,1900,2000,"Sub-basin 3"
7412,600,35,5000,5600,"Sub-basin 3"
7413,7900,1607,19900,27800,"Sub-basin 3"
7414,700,32,5000,5700,"Sub-basin 3"
7415,400,31,1300,1700,"Sub-basin 3"
7416,100,1,2900,3000,"Sub-basin 3"
7417,1300,138,6400,7700,"Sub-basin 3"
7418,200,3,1900,2100,"Sub-basin 3"
7419,200,6,2700,2900,"Sub-basin 3"
7420,100,1,2200,2300,"Sub-basin 3"
7421,2100,72,31600,33700,"Sub-basin 3"
7422,100,2,2900,3000,"Sub-basin 3"
7423,300,6,1300,1600,"Sub-basin 3"
7424,200,5,2300,2500,"Sub-basin 3"
7425,400,26,4700,5100,"Sub-basin 3"
7426,700,73,1700,2400,"Sub-basin 3"
7427,200,8,3000,3200,"Sub-basin 3"
7428,300,11,3300,3600,"Sub-basin 3"
7429,400,28,2400,2800,"Sub-basin 3"
7430,100,3,1500,1600,"Sub-basin 3"
7431,700,65,9400,10100,"Sub-basin 3"
7432,300,19,7300,7600,"Sub-basin 3"
7433,600,33,6100,6700,"Sub-basin 3"
7434,100,4,2600,2700,"Sub-basin 3"
7435,900,27,10200,11100,"Sub-basin 3"
7436,600,34,3500,4100,"Sub-basin 3"
7437,100,1,2700,2800,"Sub-basin 3"
7438,100,1,3400,3500,"Sub-basin 3"
7439,500,10,8400,8900,"Sub-basin 3"
7440,2600,123,15800,18400,"Sub-basin 3"
7441,100,1,1300,1400,"Sub-basin 3"
7442,100,1,1500,1600,"Sub-basin 3"
7443,100,1,2900,3000,"Sub-basin 3"
7444,100,1,2200,2300,"Sub-basin 3"
7445,900,25,11000,11900,"Sub-basin 3"
7446,3000,173,10700,13700,"Sub-basin 3"
7447,3200,742,18900,22100,"Sub-basin 3"
7448,100,1,600,700,"Sub-basin 3"
7449,4500,412,38600,43100,"Sub-basin 3"
7450,500,11,8100,8600,"Sub-basin 3"
7451,1900,179,10700,12600,"Sub-basin 3"
7452,400,63,3100,3500,"Sub-basin 3"
7453,200,6,2000,2200,"Sub-basin 3"
7454,300,10,2100,2400,"Sub-basin 3"
7455,1400,74,5600,7000,"Sub-basin 3"
7456,200,18,2100,2300,"Sub-basin 3"
7457,300,8,4200,4500,"Sub-basin 3"
7458,2300,223,7100,9400,"Sub-basin 3"
7459,600,31,4000,4600,"Sub-basin 3"
7460,4600,385,50600,55200,"Sub-basin 3"
7461,100,2,3500,3600,"Sub-basin 3"
7462,400,13,3700,4100,"Sub-basin 3"
7463,2200,184,19200,21400,"Sub-basin 3"
7464,200,4,4300,4500,"Sub-basin 3"
7465,500,11,7000,7500,"Sub-basin 3"
7466,300,9,2800,3100,"Sub-basin 3"
7467,300,14,3500,3800,"Sub-basin 3"
7468,600,8,1600,2200,"Sub-basin 3"
7469,400,6,5000,5400,"Sub-basin 3"
7470,800,103,7300,8100,"Sub-basin 3"
7471,500,12,3400,3900,"Sub-basin 3"
7472,100,3,1000,1100,"Sub-basin 3"
7473,500,34,11900,12400,"Sub-basin 3"
7474,100,3,1800,1900,"Sub-basin 3"
7475,200,5,2700,2900,"Sub-basin 3"
7476,600,28,3500,4100,"Sub-basin 3"
7477,100,1,1600,1700,"Sub-basin 3"
7478,1700,71,12600,14300,"Sub-basin 3"
7479,100,1,1900,2000,"Sub-basin 3"
7480,500,25,5600,6100,"Sub-basin 3"
7481,100,1,2300,2400,"Sub-basin 3"
7482,100,4,1400,1500,"Sub-basin 3"
7483,100,2,800,900,"Sub-basin 3"
7484,800,51,10500,11300,"Sub-basin 3"
7485,100,1,800,900,"Sub-basin 3"
7486,1200,34,8400,9600,"Sub-basin 3"
7487,2200,180,14800,17000,"Sub-basin 3"
7488,100,1,1200,1300,"Sub-basin 3"
7489,1300,470,6600,7900,"Sub-basin 3"
7490,100,1,1800,1900,"Sub-basin 3"
7491,600,41,4600,5200,"Sub-basin 3"
7492,400,14,3300,3700,"Sub-basin 3"
7493,400,19,4500,4900,"Sub-basin 3"
7494,100,1,700,800,"Sub-basin 3"
7495,500,34,3500,4000,"Sub-basin 3"
7496,100,1,900,1000,"Sub-basin 3"
7497,200,11,2100,2300,"Sub-basin 3"
7498,100,2,2400,2500,"Sub-basin 3"
7499,100,1,2700,2800,"Sub-basin 3"
7500,100,2,1900,2000,"Sub-basin 3"
7501,300,9,2900,3200,"Sub-basin 3"
7502,200,3,4100,4300,"Sub-basin 3"
7503,300,8,3100,3400,"Sub-basin 3"
7504,300,14,2600,2900,"Sub-basin 3"
7505,200,3,8400,8600,"Sub-basin 3"
7506,100,3,900,1000,"Sub-basin 3"
7507,1000,35,6300,7300,"Sub-basin 3"
7508,100,2,1400,1500,"Sub-basin 3"
7509,4100,334,21400,25500,"Sub-basin 3"
7510,5900,599,40400,46300,"Sub-basin 3"
7511,800,48,10100,10900,"Sub-basin 3"
7512,100,1,2700,2800,"Sub-basin 3"
7513,100,2,1700,1800,"Sub-basin 3"
7514,800,23,4200,5000,"Sub-basin 3"
7515,100,1,3700,3800,"Sub-basin 3"
7516,100,3,1700,1800,"Sub-basin 3"
7517,3700,216,40800,44500,"Sub-basin 3"
7518,300,6,4000,4300,"Sub-basin 3"
7519,800,24,9600,10400,"Sub-basin 3"
7520,200,3,4600,4800,"Sub-basin 3"
7521,100,2,2100,2200,"Sub-basin 3"
7522,100,2.0017,1700,1800,"Sub-basin 3"
7523,500,24,4300,4800,"Sub-basin 3"
7524,1500,288,4200,5700,"Sub-basin 3"
7525,100,1,1800,1900,"Sub-basin 3"
7526,300,7,3400,3700,"Sub-basin 3"
7527,200,7,3400,3600,"Sub-basin 3"
7528,300,9,3500,3800,"Sub-basin 3"
7529,700,62,3300,4000,"Sub-basin 3"
7530,2200,225,16000,18200,"Sub-basin 3"
7531,100,1,1200,1300,"Sub-basin 3"
7532,400,11,3800,4200,"Sub-basin 3"
7533,100,2,1400,1500,"Sub-basin 3"
7534,700,37,2800,3500,"Sub-basin 3"
7535,1800,63,16400,18200,"Sub-basin 3"
7536,900,25,6700,7600,"Sub-basin 3"
7537,200,5,3200,3400,"Sub-basin 3"
7538,100,1,2300,2400,"Sub-basin 3"
7539,100,3,3500,3600,"Sub-basin 3"
7540,1400,40,15200,16600,"Sub-basin 3"
7541,100,1,1300,1400,"Sub-basin 3"
7542,1500,109,5900,7400,"Sub-basin 3"
7543,100,2,2300,2400,"Sub-basin 3"
7544,2800,199,19800,22600,"Sub-basin 3"
7545,400,14,2600,3000,"Sub-basin 3"
7546,400,13,2200,2600,"Sub-basin 3"
7547,100,2,1900,2000,"Sub-basin 3"
7548,300,7,5800,6100,"Sub-basin 3"
7549,1100,77,7300,8400,"Sub-basin 3"
7550,2000,159,10400,12400,"Sub-basin 3"
7551,200,5,1600,1800,"Sub-basin 3"
7552,200,7,2100,2300,"Sub-basin 3"
7553,2600,278.33,14000,16600,"Sub-basin 3"
7554,9700,1354,56800,66500,"Sub-basin 3"
7555,100,1,500,600,"Sub-basin 3"
7556,1100,42,5000,6100,"Sub-basin 3"
7557,400,15,6700,7100,"Sub-basin 3"
7558,1000,91,9200,10200,"Sub-basin 3"
7559,100,7,1200,1300,"Sub-basin 3"
7560,400,5,6300,6700,"Sub-basin 3"
7561,300,6,9600,9900,"Sub-basin 3"
7562,700,17,10700,11400,"Sub-basin 3"
7563,100,1,1200,1300,"Sub-basin 3"
7564,100,1,2600,2700,"Sub-basin 3"
7565,100,2,1000,1100,"Sub-basin 3"
7566,200,3.0011,2300,2500,"Sub-basin 3"
7567,1800,353,4900,6700,"Sub-basin 3"
7568,800,79,3600,4400,"Sub-basin 3"
7569,300,12,800,1100,"Sub-basin 3"
7570,200,26,3500,3700,"Sub-basin 3"
7571,800,78,4300,5100,"Sub-basin 3"
7572,300,13,2800,3100,"Sub-basin 3"
7573,400,45,3100,3500,"Sub-basin 3"
7574,100,3,2900,3000,"Sub-basin 3"
7575,200,9,1800,2000,"Sub-basin 3"
7576,100,1,2400,2500,"Sub-basin 3"
7577,100,1,2700,2800,"Sub-basin 3"
7578,100,1,4200,4300,"Sub-basin 3"
7579,100,1,1800,1900,"Sub-basin 3"
7580,500,6,6000,6500,"Sub-basin 3"
7581,1700,70,15400,17100,"Sub-basin 3"
7582,300,5,3200,3500,"Sub-basin 3"
7583,200,3,3500,3700,"Sub-basin 3"
7584,300,7,5200,5500,"Sub-basin 3"
7585,800,12,9200,10000,"Sub-basin 3"
7586,100,2.004,2600,2700,"Sub-basin 3"
7587,800,84,5000,5800,"Sub-basin 3"
7588,100,1,1300,1400,"Sub-basin 3"
7589,200,8,3800,4000,"Sub-basin 3"
7590,400,19,4200,4600,"Sub-basin 3"
7591,800,22,4200,5000,"Sub-basin 3"
7592,100,2,2200,2300,"Sub-basin 3"
7593,500,18,5600,6100,"Sub-basin 3"
7594,700,183,3200,3900,"Sub-basin 3"
7595,100,2,3000,3100,"Sub-basin 3"
7596,2200,490,14900,17100,"Sub-basin 3"
7597,100,1,1300,1400,"Sub-basin 3"
7598,700,28,4100,4800,"Sub-basin 3"
7599,100,2,1800,1900,"Sub-basin 3"
7600,100,1,3200,3300,"Sub-basin 3"
7601,500,9,6500,7000,"Sub-basin 3"
7602,200,3,3500,3700,"Sub-basin 3"
7603,800,53,13800,14600,"Sub-basin 3"
7604,100,4,1600,1700,"Sub-basin 3"
7605,100,1,1500,1600,"Sub-basin 3"
7606,1500,79,9400,10900,"Sub-basin 3"
7607,500,8,4400,4900,"Sub-basin 3"
7608,100,1,0,100,"Sub-basin 3"
7609,12900,800.67,79300,92200,"Sub-basin 3"
7610,100,1,3500,3600,"Sub-basin 3"
7611,100,1,2100,2200,"Sub-basin 3"
7612,100,1,4700,4800,"Sub-basin 3"
7613,600,23,1100,1700,"Sub-basin 3"
7614,1900,147.84,7400,9300,"Sub-basin 3"
7615,300,5,700,1000,"Sub-basin 3"
7616,8400,808.5372,39100,47500,"Sub-basin 3"
7617,100,1.0017,1900,2000,"Sub-basin 3"
7618,200,6,4400,4600,"Sub-basin 3"
7619,2300,552.83,8300,10600,"Sub-basin 3"
7620,5300,774.83,35100,40400,"Sub-basin 3"
7621,300,10,3100,3400,"Sub-basin 3"
7622,1300,115,7700,9000,"Sub-basin 3"
7623,1800,189,3100,4900,"Sub-basin 3"
7624,500,12,5700,6200,"Sub-basin 3"
7625,1300,53,13300,14600,"Sub-basin 3"
7626,100,4,1100,1200,"Sub-basin 3"
7627,100,1,700,800,"Sub-basin 3"
7628,100,1,1800,1900,"Sub-basin 3"
7629,400,11,7600,8000,"Sub-basin 3"
7630,100,3,2100,2200,"Sub-basin 3"
7631,1300,64.21,3400,4700,"Sub-basin 3"
7632,100,1,2400,2500,"Sub-basin 3"
7633,1500,175.84,13400,14900,"Sub-basin 3"
7634,400,11,4200,4600,"Sub-basin 3"
7635,600,23,5100,5700,"Sub-basin 3"
7636,800,28,7500,8300,"Sub-basin 3"
7637,2100,353,6200,8300,"Sub-basin 3"
7638,3300,555.17,11400,14700,"Sub-basin 3"
7639,600,51,2500,3100,"Sub-basin 3"
7640,500,54,5200,5700,"Sub-basin 3"
7641,300,13,4500,4800,"Sub-basin 3"
7642,1000,56,6000,7000,"Sub-basin 3"
7643,200,2,3500,3700,"Sub-basin 3"
7644,100,2,3600,3700,"Sub-basin 3"
7645,400,7,8300,8700,"Sub-basin 3"
7646,100,2,400,500,"Sub-basin 3"
7647,500,17,10400,10900,"Sub-basin 3"
7648,100,2,3500,3600,"Sub-basin 3"
7649,1600,83.1017,15500,17100,"Sub-basin 3"
7650,800,49,7100,7900,"Sub-basin 3"
7651,2400,242.17,10100,12500,"Sub-basin 3"
7652,200,3,3500,3700,"Sub-basin 3"
7653,600,23,4700,5300,"Sub-basin 3"
7654,1800,235.33,4100,5900,"Sub-basin 3"
7655,5800,2137.99,16500,22300,"Sub-basin 3"
7656,500,32,3600,4100,"Sub-basin 3"
7657,300,18,4300,4600,"Sub-basin 3"
7658,600,40,6500,7100,"Sub-basin 3"
7659,200,5,1300,1500,"Sub-basin 3"
7660,100,4,2000,2100,"Sub-basin 3"
7661,100,1,3000,3100,"Sub-basin 3"
7662,900,116,6800,7700,"Sub-basin 3"
7663,100,2,1400,1500,"Sub-basin 3"
7664,300,11,4200,4500,"Sub-basin 3"
7665,100,4,600,700,"Sub-basin 3"
7666,300,10,6300,6600,"Sub-basin 3"
7667,1800,52,33800,35600,"Sub-basin 3"
7668,200,6,4200,4400,"Sub-basin 3"
7669,500,16,15400,15900,"Sub-basin 3"
7670,300,5,4600,4900,"Sub-basin 3"
7671,400,14,6500,6900,"Sub-basin 3"
7672,100,3,1800,1900,"Sub-basin 3"
7673,1900,85,9000,10900,"Sub-basin 3"
7674,200,3,4700,4900,"Sub-basin 3"
7675,1100,173.33,4600,5700,"Sub-basin 3"
7676,17800,5934,28100,45900,"Sub-basin 3"
7677,100,7,2400,2500,"Sub-basin 3"
7678,400,7,7100,7500,"Sub-basin 3"
7679,100,1,3800,3900,"Sub-basin 3"
7680,100,5,700,800,"Sub-basin 3"
7681,100,6,1000,1100,"Sub-basin 3"
7682,100,4,1300,1400,"Sub-basin 3"
7683,400,21,2900,3300,"Sub-basin 3"
7684,1300,73.67,8200,9500,"Sub-basin 3"
7685,100,2,900,1000,"Sub-basin 3"
7686,100,1,1000,1100,"Sub-basin 3"
7687,600,93.66,2100,2700,"Sub-basin 3"
7688,100,3,1000,1100,"Sub-basin 3"
7689,100,1,1000,1100,"Sub-basin 3"
7690,100,5,1300,1400,"Sub-basin 3"
7691,100,5,2500,2600,"Sub-basin 3"
7692,1700,108.33,16500,18200,"Sub-basin 3"
7693,1200,50.33,15600,16800,"Sub-basin 3"
7694,200,3,4800,5000,"Sub-basin 3"
7695,100,1,1900,2000,"Sub-basin 3"
7696,900,171,4600,5500,"Sub-basin 3"
7697,100,1,1000,1100,"Sub-basin 3"
7698,1000,74,4300,5300,"Sub-basin 3"
7699,1100,147,5700,6800,"Sub-basin 3"
7700,100,2,1500,1600,"Sub-basin 3"
7701,2900,386.07,6800,9700,"Sub-basin 3"
7702,700,73.31,3200,3900,"Sub-basin 3"
7703,200,3,3400,3600,"Sub-basin 3"
7704,500,35,3900,4400,"Sub-basin 3"
7705,700,40,5400,6100,"Sub-basin 3"
7706,300,18,1200,1500,"Sub-basin 3"
7707,600,22,7200,7800,"Sub-basin 3"
7708,200,4,2400,2600,"Sub-basin 3"
7709,1500,48,24300,25800,"Sub-basin 3"
7710,400,12,3600,4000,"Sub-basin 3"
7711,400,27.32,1900,2300,"Sub-basin 3"
7712,700,61,5800,6500,"Sub-basin 3"
7713,1200,60,7800,9000,"Sub-basin 3"
7714,300,8,8600,8900,"Sub-basin 3"
7715,200,4,1600,1800,"Sub-basin 3"
7716,900,122,3500,4400,"Sub-basin 3"
7717,100,1,1700,1800,"Sub-basin 3"
7718,2900,217,17600,20500,"Sub-basin 3"
7719,100,4,1000,1100,"Sub-basin 3"
7720,200,4,2100,2300,"Sub-basin 3"
7721,100,6,1000,1100,"Sub-basin 3"
7722,1100,19,17400,18500,"Sub-basin 3"
7723,100,1,1600,1700,"Sub-basin 3"
7724,300,6,5800,6100,"Sub-basin 3"
7725,700,51,5400,6100,"Sub-basin 3"
7726,200,3,1500,1700,"Sub-basin 3"
7727,500,13,4400,4900,"Sub-basin 3"
7728,1900,116,28600,30500,"Sub-basin 3"
7729,300,4,9200,9500,"Sub-basin 3"
7730,200,7,6700,6900,"Sub-basin 3"
7731,800,53,5300,6100,"Sub-basin 3"
7732,300,10,4400,4700,"Sub-basin 3"
7733,100,2,1600,1700,"Sub-basin 3"
7734,1800,133,10300,12100,"Sub-basin 3"
7735,100,1,3400,3500,"Sub-basin 3"
7736,300,4,5900,6200,"Sub-basin 3"
7737,200,3,2500,2700,"Sub-basin 3"
7738,300,11,5900,6200,"Sub-basin 3"
7739,200,5,4600,4800,"Sub-basin 3"
7740,200,2,5600,5800,"Sub-basin 3"
7741,1000,72,7600,8600,"Sub-basin 3"
7742,600,15,5100,5700,"Sub-basin 3"
7743,800,29,5900,6700,"Sub-basin 3"
7744,4400,657,19100,23500,"Sub-basin 3"
7745,400,30,2700,3100,"Sub-basin 3"
7746,100,2,1700,1800,"Sub-basin 3"
7747,100,5,1300,1400,"Sub-basin 3"
7748,3500,618,6800,10300,"Sub-basin 3"
7749,100,7,2200,2300,"Sub-basin 3"
7750,100,1,900,1000,"Sub-basin 3"
7751,100,1,500,600,"Sub-basin 3"
7752,300,8,7500,7800,"Sub-basin 3"
7753,300,5,5400,5700,"Sub-basin 3"
7754,1600,202,8200,9800,"Sub-basin 3"
7755,600,29,5200,5800,"Sub-basin 3"
7756,200,8,2700,2900,"Sub-basin 3"
7757,800,16,10400,11200,"Sub-basin 3"
7758,200,2,5500,5700,"Sub-basin 3"
7759,500,12,7800,8300,"Sub-basin 3"
7760,400,20,4000,4400,"Sub-basin 3"
7761,100,2,1100,1200,"Sub-basin 3"
7762,100,2,1300,1400,"Sub-basin 3"
7763,600,14,5800,6400,"Sub-basin 3"
7764,900,111,6400,7300,"Sub-basin 3"
7765,100,2,1500,1600,"Sub-basin 3"
7766,100,2,800,900,"Sub-basin 3"
7767,2700,220,11700,14400,"Sub-basin 3"
7768,100,1,1000,1100,"Sub-basin 3"
7769,400,35,4000,4400,"Sub-basin 3"
7770,600,40,8700,9300,"Sub-basin 3"
7771,200,3,2100,2300,"Sub-basin 3"
7772,700,53,9000,9700,"Sub-basin 3"
7773,100,2,1000,1100,"Sub-basin 3"
7774,700,13,13700,14400,"Sub-basin 3"
7775,200,5,5500,5700,"Sub-basin 3"
7776,300,8,4700,5000,"Sub-basin 3"
7777,100,2,1000,1100,"Sub-basin 3"
7778,200,3,5200,5400,"Sub-basin 3"
7779,100,1,2400,2500,"Sub-basin 3"
7780,4700,359,12200,16900,"Sub-basin 3"
7781,1300,74,14800,16100,"Sub-basin 3"
7782,600,24,3200,3800,"Sub-basin 3"
7783,100,2,1000,1100,"Sub-basin 3"
7784,500,93,3300,3800,"Sub-basin 3"
7785,400,22,2600,3000,"Sub-basin 3"
7786,1200,206,3200,4400,"Sub-basin 3"
7787,200,7,3600,3800,"Sub-basin 3"
7788,700,49,3500,4200,"Sub-basin 3"
7789,700,49,8300,9000,"Sub-basin 3"
7790,100,1,500,600,"Sub-basin 3"
7791,200,3,4100,4300,"Sub-basin 3"
7792,200,3,3100,3300,"Sub-basin 3"
7793,300,11,3700,4000,"Sub-basin 3"
7794,600,28,5800,6400,"Sub-basin 3"
7795,100,2,2900,3000,"Sub-basin 3"
7796,100,3,2600,2700,"Sub-basin 3"
7797,2900,161,16900,19800,"Sub-basin 3"
7798,400,20,5600,6000,"Sub-basin 3"
7799,600,14,13300,13900,"Sub-basin 3"
7800,200,4,7300,7500,"Sub-basin 3"
7801,100,2,2800,2900,"Sub-basin 3"
7802,600,90,2700,3300,"Sub-basin 3"
7803,600,17,4100,4700,"Sub-basin 3"
7804,200,5,1700,1900,"Sub-basin 3"
7805,100,1,500,600,"Sub-basin 3"
7806,600,18,4500,5100,"Sub-basin 3"
7807,1400,102,3800,5200,"Sub-basin 3"
7808,2200,153,19300,21500,"Sub-basin 3"
7809,100,1,2100,2200,"Sub-basin 3"
7810,500,9,7500,8000,"Sub-basin 3"
7811,300,12,4400,4700,"Sub-basin 3"
7812,100,2,1800,1900,"Sub-basin 3"
7813,600,36,6000,6600,"Sub-basin 3"
7814,1400,31,17400,18800,"Sub-basin 3"
7815,100,1,3900,4000,"Sub-basin 3"
7816,300,5,7400,7700,"Sub-basin 3"
7817,1200,187,4200,5400,"Sub-basin 3"
7818,100,4,700,800,"Sub-basin 3"
7819,1100,337,8000,9100,"Sub-basin 3"
7820,100,2,1000,1100,"Sub-basin 3"
7821,500,21,4700,5200,"Sub-basin 3"
7822,600,22,6600,7200,"Sub-basin 3"
7823,900,125,5000,5900,"Sub-basin 3"
7824,3800,328,30100,33900,"Sub-basin 3"
7825,300,17,2200,2500,"Sub-basin 3"
7826,100,2,1000,1100,"Sub-basin 3"
7827,400,47,1400,1800,"Sub-basin 3"
7828,400,21,3000,3400,"Sub-basin 3"
7829,300,9,2900,3200,"Sub-basin 3"
7830,1600,382,5000,6600,"Sub-basin 3"
7831,200,3,2100,2300,"Sub-basin 3"
7832,200,9,3300,3500,"Sub-basin 3"
7833,300,12,5100,5400,"Sub-basin 3"
7834,100,1,3200,3300,"Sub-basin 3"
7835,200,3,4800,5000,"Sub-basin 3"
7836,200,4,6600,6800,"Sub-basin 3"
7837,100,3,1800,1900,"Sub-basin 3"
7838,200,4,1100,1300,"Sub-basin 3"
7839,100,3,1400,1500,"Sub-basin 3"
7840,100,4,1300,1400,"Sub-basin 3"
7841,100,4,3300,3400,"Sub-basin 3"
7842,500,32,2800,3300,"Sub-basin 3"
7843,100,2,1400,1500,"Sub-basin 3"
7844,100,1,1300,1400,"Sub-basin 3"
7845,300,5,6600,6900,"Sub-basin 3"
7846,800,145,3400,4200,"Sub-basin 3"
7847,100,2,300,400,"Sub-basin 3"
7848,100,4,800,900,"Sub-basin 3"
7849,100,1,1800,1900,"Sub-basin 3"
7850,600,31,7100,7700,"Sub-basin 3"
7851,200,2,4600,4800,"Sub-basin 3"
7852,900,29,11900,12800,"Sub-basin 3"
7853,300,7,2700,3000,"Sub-basin 3"
7854,100,2,1700,1800,"Sub-basin 3"
7855,100,1,1700,1800,"Sub-basin 3"
7856,400,8,5900,6300,"Sub-basin 3"
7857,200,9,4100,4300,"Sub-basin 3"
7858,4500,264,37600,42100,"Sub-basin 3"
7859,100,1,2000,2100,"Sub-basin 3"
7860,3100,220,16200,19300,"Sub-basin 3"
7861,200,3.0018,2900,3100,"Sub-basin 3"
7862,600,77,5400,6000,"Sub-basin 3"
7863,200,2,2000,2200,"Sub-basin 3"
7864,200,9,3300,3500,"Sub-basin 3"
7865,600,52,2600,3200,"Sub-basin 3"
7866,100,4,1800,1900,"Sub-basin 3"
7867,300,7,1600,1900,"Sub-basin 3"
7868,100,6,2300,2400,"Sub-basin 3"
7869,400,6,7700,8100,"Sub-basin 3"
7870,200,5,6100,6300,"Sub-basin 3"
7871,100,2,2800,2900,"Sub-basin 3"
7872,100,1,800,900,"Sub-basin 3"
7873,1200,36,11800,13000,"Sub-basin 3"
7874,100,4,1800,1900,"Sub-basin 3"
7875,100,1,1000,1100,"Sub-basin 3"
7876,2500,411,16100,18600,"Sub-basin 3"
7877,200,7,2000,2200,"Sub-basin 3"
7878,3700,1024,5200,8900,"Sub-basin 3"
7879,1100,56,5900,7000,"Sub-basin 3"
7880,11800,1692,42400,54200,"Sub-basin 3"
7881,200,2,1700,1900,"Sub-basin 3"
7882,1400,78,4400,5800,"Sub-basin 3"
7883,500,15,2900,3400,"Sub-basin 3"
7884,200,3,4100,4300,"Sub-basin 3"
7885,200,28,2600,2800,"Sub-basin 3"
7886,1500,110,15300,16800,"Sub-basin 3"
7887,400,19,4300,4700,"Sub-basin 3"
7888,600,220,5600,6200,"Sub-basin 3"
7889,200,4,1900,2100,"Sub-basin 3"
7890,400,13,11300,11700,"Sub-basin 3"
7891,100,1,5300,5400,"Sub-basin 3"
7892,100,1,2600,2700,"Sub-basin 3"
7893,1100,56,9500,10600,"Sub-basin 3"
7894,100,3,1800,1900,"Sub-basin 3"
7895,400,22,7700,8100,"Sub-basin 3"
7896,700,13,11500,12200,"Sub-basin 3"
7897,600,35,3700,4300,"Sub-basin 3"
7898,200,9,7800,8000,"Sub-basin 3"
7899,800,27,12600,13400,"Sub-basin 3"
7900,500,41,1800,2300,"Sub-basin 3"
7901,700,141,3300,4000,"Sub-basin 3"
7902,100,1,900,1000,"Sub-basin 3"
7903,100,2,1500,1600,"Sub-basin 3"
7904,4300,396,15000,19300,"Sub-basin 3"
7905,500,28,2000,2500,"Sub-basin 3"
7906,600,68,2600,3200,"Sub-basin 3"
7907,6300,1306,14300,20600,"Sub-basin 3"
7908,500,17,3900,4400,"Sub-basin 3"
7909,100,1,1800,1900,"Sub-basin 3"
7910,400,72,3400,3800,"Sub-basin 3"
7911,2900,250,7700,10600,"Sub-basin 3"
7912,1800,627,6900,8700,"Sub-basin 3"
7913,100,1,1400,1500,"Sub-basin 3"
7914,300,4,5300,5600,"Sub-basin 3"
7915,300,6,10200,10500,"Sub-basin 3"
7916,100,2,3400,3500,"Sub-basin 3"
7917,800,18,10500,11300,"Sub-basin 3"
7918,100,2,700,800,"Sub-basin 3"
7919,3400,179,19400,22800,"Sub-basin 3"
7920,100,1,4700,4800,"Sub-basin 3"
7921,900,51.0259,6900,7800,"Sub-basin 3"
7922,1100,58,7300,8400,"Sub-basin 3"
7923,2300,262,6800,9100,"Sub-basin 3"
7924,700,19,5900,6600,"Sub-basin 3"
7925,700,137,3900,4600,"Sub-basin 3"
7926,100,2,600,700,"Sub-basin 3"
7927,100,3,2100,2200,"Sub-basin 3"
7928,300,5,5600,5900,"Sub-basin 3"
7929,200,9,1500,1700,"Sub-basin 3"
7930,300,8,2000,2300,"Sub-basin 3"
7931,300,12,3700,4000,"Sub-basin 3"
7932,1000,19,6100,7100,"Sub-basin 3"
7933,400,11,14400,14800,"Sub-basin 3"
7934,200,8,4000,4200,"Sub-basin 3"
7935,200,4,3100,3300,"Sub-basin 3"
7936,300,8,3600,3900,"Sub-basin 3"
7937,500,11,10300,10800,"Sub-basin 3"
7938,100,3,4300,4400,"Sub-basin 3"
7939,2300,220,15500,17800,"Sub-basin 3"
7940,400,54,2800,3200,"Sub-basin 3"
7941,300,9,4100,4400,"Sub-basin 3"
7942,27200,16625,47300,74500,"Sub-basin 3"
7943,200,3,1800,2000,"Sub-basin 3"
7944,1300,100,9000,10300,"Sub-basin 3"
7945,200,8,1600,1800,"Sub-basin 3"
7946,200,8,2300,2500,"Sub-basin 3"
7947,300,6,3100,3400,"Sub-basin 3"
7948,200,3,2700,2900,"Sub-basin 3"
7949,100,2,4600,4700,"Sub-basin 3"
7950,100,1,3100,3200,"Sub-basin 3"
7951,100,2,1900,2000,"Sub-basin 3"
7952,100,1,2600,2700,"Sub-basin 3"
7953,200,5,5400,5600,"Sub-basin 3"
7954,200,2,2100,2300,"Sub-basin 3"
7955,2800,194,14700,17500,"Sub-basin 3"
7956,200,3,2000,2200,"Sub-basin 3"
7957,200,8,4300,4500,"Sub-basin 3"
7958,100,3,200,300,"Sub-basin 3"
7959,700,134,1100,1800,"Sub-basin 3"
7960,300,11,1800,2100,"Sub-basin 3"
7961,100,2,1100,1200,"Sub-basin 3"
7962,100,1,1500,1600,"Sub-basin 3"
7963,3400,217,14200,17600,"Sub-basin 3"
7964,1700,426,4300,6000,"Sub-basin 3"
7965,200,5,2600,2800,"Sub-basin 3"
7966,600,62,5400,6000,"Sub-basin 3"
7967,200,7,1600,1800,"Sub-basin 3"
7968,400,22,6200,6600,"Sub-basin 3"
7969,100,2,5000,5100,"Sub-basin 3"
7970,300,8,5200,5500,"Sub-basin 3"
7971,600,22,9100,9700,"Sub-basin 3"
7972,800,46,12700,13500,"Sub-basin 3"
7973,300,9,4100,4400,"Sub-basin 3"
7974,300,3,5300,5600,"Sub-basin 3"
7975,100,1,2000,2100,"Sub-basin 3"
7976,500,13,4700,5200,"Sub-basin 3"
7977,100,1,3100,3200,"Sub-basin 3"
7978,100,1,2000,2100,"Sub-basin 3"
7979,100,1,1100,1200,"Sub-basin 3"
7980,500,44,5500,6000,"Sub-basin 3"
7981,200,7,1800,2000,"Sub-basin 3"
7982,200,16,2200,2400,"Sub-basin 3"
7983,300,24,2700,3000,"Sub-basin 3"
7984,1000,56,12200,13200,"Sub-basin 3"
7985,300,4,4300,4600,"Sub-basin 3"
7986,100,1,2700,2800,"Sub-basin 3"
7987,1100,26,18800,19900,"Sub-basin 3"
7988,200,5,5800,6000,"Sub-basin 3"
7989,100,1,3100,3200,"Sub-basin 3"
7990,800,23,11700,12500,"Sub-basin 3"
7991,7800,534,73000,80800,"Sub-basin 3"
7992,100,1,1900,2000,"Sub-basin 3"
7993,100,1,3500,3600,"Sub-basin 3"
7994,700,82,5600,6300,"Sub-basin 3"
7995,100,3,1300,1400,"Sub-basin 3"
7996,2600,780,5000,7600,"Sub-basin 3"
7997,1900,641,3600,5500,"Sub-basin 3"
7998,100,6,2400,2500,"Sub-basin 3"
7999,800,50,9700,10500,"Sub-basin 3"
8000,100,4,1300,1400,"Sub-basin 3"
8001,300,11,2900,3200,"Sub-basin 3"
8002,1500,38,20000,21500,"Sub-basin 3"
8003,200,5,7700,7900,"Sub-basin 3"
8004,100,2,2100,2200,"Sub-basin 3"
8005,500,19,9600,10100,"Sub-basin 3"
8006,500,10,8300,8800,"Sub-basin 3"
8007,400,17,2900,3300,"Sub-basin 3"
8008,400,8,8700,9100,"Sub-basin 3"
8009,2400,341,3400,5800,"Sub-basin 3"
8010,100,1.0016,1600,1700,"Sub-basin 3"
8011,2700,179.5,22400,25100,"Sub-basin 3"
8012,200,3,2300,2500,"Sub-basin 3"
8013,100,1,500,600,"Sub-basin 3"
8014,600,192,2900,3500,"Sub-basin 3"
8015,300,5,3200,3500,"Sub-basin 3"
8016,200,5,1800,2000,"Sub-basin 3"
8017,300,19,1400,1700,"Sub-basin 3"
8018,300,5,4000,4300,"Sub-basin 3"
8019,400,19,3500,3900,"Sub-basin 3"
8020,500,20,5600,6100,"Sub-basin 3"
8021,200,5,4900,5100,"Sub-basin 3"
8022,3800,289,44800,48600,"Sub-basin 3"
8023,300,8,5200,5500,"Sub-basin 3"
8024,200,4,2400,2600,"Sub-basin 3"
8025,200,5,3200,3400,"Sub-basin 3"
8026,100,1,3400,3500,"Sub-basin 3"
8027,100,3,800,900,"Sub-basin 3"
8028,100,1,2000,2100,"Sub-basin 3"
8029,400,8,4900,5300,"Sub-basin 3"
8030,200,3,1500,1700,"Sub-basin 3"
8031,600,82,2500,3100,"Sub-basin 3"
8032,100,1,1400,1500,"Sub-basin 3"
8033,1500,93,9500,11000,"Sub-basin 3"
8034,200,10,1200,1400,"Sub-basin 3"
8035,300,29,2400,2700,"Sub-basin 3"
8036,200,6,2000,2200,"Sub-basin 3"
8037,1700,142,10500,12200,"Sub-basin 3"
8038,200,3,5800,6000,"Sub-basin 3"
8039,100,1,2500,2600,"Sub-basin 3"
8040,100,1,2300,2400,"Sub-basin 3"
8041,1000,78,4500,5500,"Sub-basin 3"
8042,100,1,3300,3400,"Sub-basin 3"
8043,1100,66,9500,10600,"Sub-basin 3"
8044,200,4,1500,1700,"Sub-basin 3"
8045,300,7,2100,2400,"Sub-basin 3"
8046,100,3,1200,1300,"Sub-basin 3"
8047,300,9,2500,2800,"Sub-basin 3"
8048,100,2,1700,1800,"Sub-basin 3"
8049,1800,172,14500,16300,"Sub-basin 3"
8050,400,8,5500,5900,"Sub-basin 3"
8051,1400,45,13200,14600,"Sub-basin 3"
8052,1100,29,21000,22100,"Sub-basin 3"
8053,100,1,3200,3300,"Sub-basin 3"
8054,100,2,1300,1400,"Sub-basin 3"
8055,100,2,1900,2000,"Sub-basin 3"
8056,5200,319,27200,32400,"Sub-basin 3"
8057,200,5,4700,4900,"Sub-basin 3"
8058,700,23,10500,11200,"Sub-basin 3"
8059,100,4,1300,1400,"Sub-basin 3"
8060,100,1,4200,4300,"Sub-basin 3"
8061,1700,273,6900,8600,"Sub-basin 3"
8062,100,6,1000,1100,"Sub-basin 3"
8063,600,50,11400,12000,"Sub-basin 3"
8064,5700,568,49300,55000,"Sub-basin 3"
8065,500,27,4400,4900,"Sub-basin 3"
8066,200,6,2000,2200,"Sub-basin 3"
8067,100,3,700,800,"Sub-basin 3"
8068,400,27,2100,2500,"Sub-basin 3"
8069,300,15,2600,2900,"Sub-basin 3"
8070,100,2,1200,1300,"Sub-basin 3"
8071,500,16,5000,5500,"Sub-basin 3"
8072,200,4,2600,2800,"Sub-basin 3"
8073,1400,102,3800,5200,"Sub-basin 3"
8074,2600,172,15400,18000,"Sub-basin 3"
8075,1500,54,11800,13300,"Sub-basin 3"
8076,100,1,2300,2400,"Sub-basin 3"
8077,100,3,1100,1200,"Sub-basin 3"
8078,100,1,4000,4100,"Sub-basin 3"
8079,700,29,8000,8700,"Sub-basin 3"
8080,200,4,2500,2700,"Sub-basin 3"
8081,200,6,4000,4200,"Sub-basin 3"
8082,100,1,1900,2000,"Sub-basin 3"
8083,500,23,6000,6500,"Sub-basin 3"
8084,500,18,1500,2000,"Sub-basin 3"
8085,100,2,1200,1300,"Sub-basin 3"
8086,200,10,4000,4200,"Sub-basin 3"
8087,200,4,2600,2800,"Sub-basin 3"
8088,700,46,4600,5300,"Sub-basin 3"
8089,400,18,3100,3500,"Sub-basin 3"
8090,100,1,1000,1100,"Sub-basin 3"
8091,100,5,900,1000,"Sub-basin 3"
8092,100,1,800,900,"Sub-basin 3"
8093,200,3,4300,4500,"Sub-basin 3"
8094,100,2,1700,1800,"Sub-basin 3"
8095,100,1,1700,1800,"Sub-basin 3"
8096,700,53,1900,2600,"Sub-basin 3"
8097,300,9,3400,3700,"Sub-basin 3"
8098,400,16,6300,6700,"Sub-basin 3"
8099,100,1,2000,2100,"Sub-basin 3"
8100,200,8,3000,3200,"Sub-basin 3"
8101,100,1,2300,2400,"Sub-basin 3"
8102,100,2,3800,3900,"Sub-basin 3"
8103,700,41,8000,8700,"Sub-basin 3"
8104,1600,64,14100,15700,"Sub-basin 3"
8105,2800,136,30600,33400,"Sub-basin 3"
8106,200,9,2100,2300,"Sub-basin 3"
8107,1400,33,11100,12500,"Sub-basin 3"
8108,400,4,3900,4300,"Sub-basin 3"
8109,300,4,4800,5100,"Sub-basin 3"
8110,300,11,800,1100,"Sub-basin 3"
8111,900,61,7100,8000,"Sub-basin 3"
8112,700,62,3400,4100,"Sub-basin 3"
8113,900,79,4000,4900,"Sub-basin 3"
8114,1400,146,6100,7500,"Sub-basin 3"
8115,100,1,600,700,"Sub-basin 3"
8116,100,2,800,900,"Sub-basin 3"
8117,100,3,700,800,"Sub-basin 3"
8118,100,1,1900,2000,"Sub-basin 3"
8119,1900,144,14900,16800,"Sub-basin 3"
8120,600,104,7300,7900,"Sub-basin 3"
8121,300,15,3200,3500,"Sub-basin 3"
8122,100,1,3100,3200,"Sub-basin 3"
8123,100,2,3300,3400,"Sub-basin 3"
8124,200,7,2900,3100,"Sub-basin 3"
8125,200,5,3000,3200,"Sub-basin 3"
8126,100,1,1300,1400,"Sub-basin 3"
8127,300,5,3800,4100,"Sub-basin 3"
8128,1700,172.1409,9700,11400,"Sub-basin 3"
8129,800,64.0316,5900,6700,"Sub-basin 3"
8130,200,22,500,700,"Sub-basin 3"
8131,200,5,2700,2900,"Sub-basin 3"
8132,100,1,1400,1500,"Sub-basin 3"
8133,500,59,2400,2900,"Sub-basin 3"
8134,2400,633,7900,10300,"Sub-basin 3"
8135,100,1,800,900,"Sub-basin 3"
8136,600,78,3000,3600,"Sub-basin 3"
8137,5400,1320,10800,16200,"Sub-basin 3"
8138,100,1,1400,1500,"Sub-basin 3"
8139,200,7,1700,1900,"Sub-basin 3"
8140,300,13,1600,1900,"Sub-basin 3"
8141,400,66,2300,2700,"Sub-basin 3"
8142,200,6,2500,2700,"Sub-basin 3"
8143,100,1,2100,2200,"Sub-basin 3"
8144,400,17,3900,4300,"Sub-basin 3"
8145,1300,59,9100,10400,"Sub-basin 3"
8146,200,4,4100,4300,"Sub-basin 3"
8147,900,39,4200,5100,"Sub-basin 3"
8148,100,2,1400,1500,"Sub-basin 3"
8149,400,13,5500,5900,"Sub-basin 3"
8150,100,1,4700,4800,"Sub-basin 3"
8151,100,1,2800,2900,"Sub-basin 3"
8152,100,1,1800,1900,"Sub-basin 3"
8153,100,1,1200,1300,"Sub-basin 3"
8154,300,3,7300,7600,"Sub-basin 3"
8155,100,1,3200,3300,"Sub-basin 3"
8156,1200,72,4900,6100,"Sub-basin 3"
8157,600,43,4700,5300,"Sub-basin 3"
8158,700,20,8900,9600,"Sub-basin 3"
8159,1100,97,4200,5300,"Sub-basin 3"
8160,3900,962,8500,12400,"Sub-basin 3"
8161,100,2,500,600,"Sub-basin 3"
8162,600,24,4300,4900,"Sub-basin 3"
8163,200,4,1900,2100,"Sub-basin 3"
8164,100,1,900,1000,"Sub-basin 3"
8165,300,11,2300,2600,"Sub-basin 3"
8166,200,5,2000,2200,"Sub-basin 3"
8167,500,17,4900,5400,"Sub-basin 3"
8168,200,2,2100,2300,"Sub-basin 3"
8169,8000,980,30500,38500,"Sub-basin 3"
8170,400,12,8300,8700,"Sub-basin 3"
8171,500,10,9500,10000,"Sub-basin 3"
8172,100,3,3400,3500,"Sub-basin 3"
8173,100,2,3100,3200,"Sub-basin 3"
8174,500,14,4200,4700,"Sub-basin 3"
8175,200,3,7700,7900,"Sub-basin 3"
8176,800,23,9200,10000,"Sub-basin 3"
8177,100,1,2700,2800,"Sub-basin 3"
8178,200,3,4400,4600,"Sub-basin 3"
8179,200,5,2900,3100,"Sub-basin 3"
8180,100,3,400,500,"Sub-basin 3"
8181,200,3,3100,3300,"Sub-basin 3"
8182,400,37,3700,4100,"Sub-basin 3"
8183,6900,1918,15600,22500,"Sub-basin 3"
8184,400,22,2000,2400,"Sub-basin 3"
8185,700,120,2700,3400,"Sub-basin 3"
8186,100,1,1000,1100,"Sub-basin 3"
8187,100,1,1900,2000,"Sub-basin 3"
8188,800,50,3200,4000,"Sub-basin 3"
8189,200,14,1600,1800,"Sub-basin 3"
8190,100,1,1400,1500,"Sub-basin 3"
8191,100,2,2500,2600,"Sub-basin 3"
8192,100,1,2300,2400,"Sub-basin 3"
8193,300,5,6000,6300,"Sub-basin 3"
8194,100,1,2800,2900,"Sub-basin 3"
8195,100,3,1800,1900,"Sub-basin 3"
8196,300,4,2900,3200,"Sub-basin 3"
8197,1700,141,7400,9100,"Sub-basin 3"
8198,100,4,1500,1600,"Sub-basin 3"
8199,700,99,3100,3800,"Sub-basin 3"
8200,1300,126,4600,5900,"Sub-basin 3"
8201,100,1,400,500,"Sub-basin 3"
8202,100,4,1400,1500,"Sub-basin 3"
8203,200,4,4600,4800,"Sub-basin 3"
8204,100,3,400,500,"Sub-basin 3"
8205,400,88,4600,5000,"Sub-basin 3"
8206,200,10,1700,1900,"Sub-basin 3"
8207,300,15,3500,3800,"Sub-basin 3"
8208,100,5,500,600,"Sub-basin 3"
8209,400,38,6600,7000,"Sub-basin 3"
8210,100,1,2100,2200,"Sub-basin 3"
8211,100,1,3300,3400,"Sub-basin 3"
8212,100,3,2000,2100,"Sub-basin 3"
8213,400,43,3100,3500,"Sub-basin 3"
8214,1200,68,7700,8900,"Sub-basin 3"
8215,400,12,6100,6500,"Sub-basin 3"
8216,800,74,16100,16900,"Sub-basin 3"
8217,100,2,600,700,"Sub-basin 3"
8218,100,1,1100,1200,"Sub-basin 3"
8219,2500,632,3100,5600,"Sub-basin 3"
8220,400,29,1400,1800,"Sub-basin 3"
8221,700,52,2700,3400,"Sub-basin 3"
8222,200,5,700,900,"Sub-basin 3"
8223,700,50,2800,3500,"Sub-basin 3"
8224,1500,142,7400,8900,"Sub-basin 3"
8225,100,2,1200,1300,"Sub-basin 3"
8226,1500,145,4400,5900,"Sub-basin 3"
8227,1000,82,7300,8300,"Sub-basin 3"
8228,600,27,6900,7500,"Sub-basin 3"
8229,400,9,5800,6200,"Sub-basin 3"
8230,200,5,2600,2800,"Sub-basin 3"
8231,200,2.68,4200,4400,"Sub-basin 3"
8232,400,17,6200,6600,"Sub-basin 3"
8233,200,8,3200,3400,"Sub-basin 3"
8234,800,30,6700,7500,"Sub-basin 3"
8235,700,34,9400,10100,"Sub-basin 3"
8236,1200,109,9400,10600,"Sub-basin 3"
8237,600,12,4700,5300,"Sub-basin 3"
8238,100,1,1200,1300,"Sub-basin 3"
8239,100,5,2100,2200,"Sub-basin 3"
8240,300,21,2400,2700,"Sub-basin 3"
8241,100,1,1800,1900,"Sub-basin 3"
8242,2500,439,18500,21000,"Sub-basin 3"
8243,500,9,4900,5400,"Sub-basin 3"
8244,200,6,2000,2200,"Sub-basin 3"
8245,1500,420,6400,7900,"Sub-basin 3"
8246,600,28,5300,5900,"Sub-basin 3"
8247,100,2,1600,1700,"Sub-basin 3"
8248,100,3,800,900,"Sub-basin 3"
8249,400,38,3500,3900,"Sub-basin 3"
8250,500,18,3300,3800,"Sub-basin 3"
8251,400,35,2100,2500,"Sub-basin 3"
8252,1500,116,7000,8500,"Sub-basin 3"
8253,1400,145,6100,7500,"Sub-basin 3"
8254,700,26,6900,7600,"Sub-basin 3"
8255,200,4,2600,2800,"Sub-basin 3"
8256,800,44,10500,11300,"Sub-basin 3"
8257,400,9,7200,7600,"Sub-basin 3"
8258,100,3,2900,3000,"Sub-basin 3"
8259,1500,55,15100,16600,"Sub-basin 3"
8260,100,1,500,600,"Sub-basin 3"
8261,400,14,2700,3100,"Sub-basin 3"
8262,200,3,1600,1800,"Sub-basin 3"
8263,200,4,4300,4500,"Sub-basin 3"
8264,200,4,1500,1700,"Sub-basin 3"
8265,300,18,2300,2600,"Sub-basin 3"
8266,400,17,2400,2800,"Sub-basin 3"
8267,100,4,2000,2100,"Sub-basin 3"
8268,200,10,2200,2400,"Sub-basin 3"
8269,200,4,4400,4600,"Sub-basin 3"
8270,300,11,3700,4000,"Sub-basin 3"
8271,500,21,4700,5200,"Sub-basin 3"
8272,100,1,2500,2600,"Sub-basin 3"
8273,300,6,4500,4800,"Sub-basin 3"
8274,100,3,2900,3000,"Sub-basin 3"
8275,200,3,2600,2800,"Sub-basin 3"
8276,1300,52,13500,14800,"Sub-basin 3"
8277,1500,61,22600,24100,"Sub-basin 3"
8278,100,1,800,900,"Sub-basin 3"
8279,200,2,3300,3500,"Sub-basin 3"
8280,200,4,4800,5000,"Sub-basin 3"
8281,100,1,1500,1600,"Sub-basin 3"
8282,100,2,2500,2600,"Sub-basin 3"
8283,100,2,2100,2200,"Sub-basin 3"
8284,100,2,2900,3000,"Sub-basin 3"
8285,1900,188,6600,8500,"Sub-basin 3"
8286,1000,138,3700,4700,"Sub-basin 3"
8287,2000,145,7000,9000,"Sub-basin 3"
8288,100,9,900,1000,"Sub-basin 3"
8289,100,1,100,200,"Sub-basin 3"
8290,400,60,800,1200,"Sub-basin 3"
8291,200,3,1900,2100,"Sub-basin 3"
8292,100,1,1200,1300,"Sub-basin 3"
8293,400,24,3400,3800,"Sub-basin 3"
8294,200,2,1600,1800,"Sub-basin 3"
8295,200,3,2800,3000,"Sub-basin 3"
8296,200,5,5100,5300,"Sub-basin 3"
8297,100,3,1500,1600,"Sub-basin 3"
8298,700,28,8800,9500,"Sub-basin 3"
8299,400,13,4400,4800,"Sub-basin 3"
8300,800,22,13000,13800,"Sub-basin 3"
8301,500,12,8300,8800,"Sub-basin 3"
8302,700,14,5900,6600,"Sub-basin 3"
8303,100,3,1000,1100,"Sub-basin 3"
8304,400,97,3000,3400,"Sub-basin 3"
8305,300,53,1800,2100,"Sub-basin 3"
8306,1200,178,10900,12100,"Sub-basin 3"
8307,400,36,2800,3200,"Sub-basin 3"
8308,1600,216,9400,11000,"Sub-basin 3"
8309,100,2,1800,1900,"Sub-basin 3"
8310,1200,95.51,3100,4300,"Sub-basin 3"
8311,200,9,4200,4400,"Sub-basin 3"
8312,200,4,4500,4700,"Sub-basin 3"
8313,1100,26,20300,21400,"Sub-basin 3"
8314,700,14,7800,8500,"Sub-basin 3"
8315,100,2,2600,2700,"Sub-basin 3"
8316,300,7,4900,5200,"Sub-basin 3"
8317,100,3,1700,1800,"Sub-basin 3"
8318,3000,380,7100,10100,"Sub-basin 3"
8319,200,6,5200,5400,"Sub-basin 3"
8320,1000,442,2800,3800,"Sub-basin 3"
8321,600,88,1300,1900,"Sub-basin 3"
8322,100,1,300,400,"Sub-basin 3"
8323,100,7,500,600,"Sub-basin 3"
8324,200,6,1400,1600,"Sub-basin 3"
8325,100,7,1000,1100,"Sub-basin 3"
8326,5000,607,11300,16300,"Sub-basin 3"
8327,3900,315,12600,16500,"Sub-basin 3"
8328,100,2,1300,1400,"Sub-basin 3"
8329,100,4,1800,1900,"Sub-basin 3"
8330,15300,2240,105900,121200,"Sub-basin 3"
8331,900,20,7500,8400,"Sub-basin 3"
8332,200,6,3900,4100,"Sub-basin 3"
8333,1100,57,16100,17200,"Sub-basin 3"
8334,100,1,2800,2900,"Sub-basin 3"
8335,100,1,3400,3500,"Sub-basin 3"
8336,100,1,800,900,"Sub-basin 3"
8337,100,6,1100,1200,"Sub-basin 3"
8338,2100,140,15400,17500,"Sub-basin 3"
8339,300,5,3400,3700,"Sub-basin 3"
8340,400,36,1500,1900,"Sub-basin 3"
8341,100,1,1000,1100,"Sub-basin 3"
8342,100,1,1700,1800,"Sub-basin 3"
8343,1000,176,4800,5800,"Sub-basin 3"
8344,400,42,2900,3300,"Sub-basin 3"
8345,100,6,600,700,"Sub-basin 3"
8346,100,1,900,1000,"Sub-basin 3"
8347,100,1,1900,2000,"Sub-basin 3"
8348,700,31,5200,5900,"Sub-basin 3"
8349,1400,83,22900,24300,"Sub-basin 3"
8350,300,3,3800,4100,"Sub-basin 3"
8351,200,2,2800,3000,"Sub-basin 3"
8352,700,16,9400,10100,"Sub-basin 3"
8353,500,11,6600,7100,"Sub-basin 3"
8354,1800,180,15100,16900,"Sub-basin 3"
8355,100,1,1900,2000,"Sub-basin 3"
8356,300,15,4800,5100,"Sub-basin 3"
8357,100,1,1500,1600,"Sub-basin 3"
8358,100,1.0023,900,1000,"Sub-basin 3"
8359,2200,716,9000,11200,"Sub-basin 3"
8360,200,18,1700,1900,"Sub-basin 3"
8361,6100,702,32300,38400,"Sub-basin 3"
8362,1200,109,5600,6800,"Sub-basin 3"
8363,14600,1939,21600,36200,"Sub-basin 3"
8364,200,6,1800,2000,"Sub-basin 3"
8365,500,23,2800,3300,"Sub-basin 3"
8366,800,201,3500,4300,"Sub-basin 3"
8367,100,2,1400,1500,"Sub-basin 3"
8368,100,1,1700,1800,"Sub-basin 3"
8369,600,36,3300,3900,"Sub-basin 3"
8370,300,4,3300,3600,"Sub-basin 3"
8371,400,8,7300,7700,"Sub-basin 3"
8372,100,1,700,800,"Sub-basin 3"
8373,900,27,19000,19900,"Sub-basin 3"
8374,200,4,3800,4000,"Sub-basin 3"
8375,500,19,5700,6200,"Sub-basin 3"
8376,200,3,3100,3300,"Sub-basin 3"
8377,200,4,3400,3600,"Sub-basin 3"
8378,8200,394,114700,122900,"Sub-basin 3"
8379,700,13,8100,8800,"Sub-basin 3"
8380,200,3,3300,3500,"Sub-basin 3"
8381,400,36,700,1100,"Sub-basin 3"
8382,200,4,1700,1900,"Sub-basin 3"
8383,200,9,2400,2600,"Sub-basin 3"
8384,800,27,5100,5900,"Sub-basin 3"
8385,200,4,3300,3500,"Sub-basin 3"
8386,300,13,2900,3200,"Sub-basin 3"
8387,1000,197,4600,5600,"Sub-basin 3"
8388,1100,119,7800,8900,"Sub-basin 3"
8389,100,2,900,1000,"Sub-basin 3"
8390,100,2,1500,1600,"Sub-basin 3"
8391,400,44,2100,2500,"Sub-basin 3"
8392,3700,552,17400,21100,"Sub-basin 3"
8393,200,12,1400,1600,"Sub-basin 3"
8394,700,34,5400,6100,"Sub-basin 3"
8395,3300,332,20400,23700,"Sub-basin 3"
8396,100,2,2200,2300,"Sub-basin 3"
8397,200,2,3700,3900,"Sub-basin 3"
8398,200,2,5300,5500,"Sub-basin 3"
8399,400,17,8800,9200,"Sub-basin 3"
8400,1100,127,5700,6800,"Sub-basin 3"
8401,100,2,2300,2400,"Sub-basin 3"
8402,200,5,3800,4000,"Sub-basin 3"
8403,400,6,4500,4900,"Sub-basin 3"
8404,200,6,4000,4200,"Sub-basin 3"
8405,100,2,2000,2100,"Sub-basin 3"
8406,400,15,4100,4500,"Sub-basin 3"
8407,100,4,1200,1300,"Sub-basin 3"
8408,1100,144,4800,5900,"Sub-basin 3"
8409,700,74,4300,5000,"Sub-basin 3"
8410,900,60,7200,8100,"Sub-basin 3"
8411,1000,99,4600,5600,"Sub-basin 3"
8412,100,7,900,1000,"Sub-basin 3"
8413,300,11,1200,1500,"Sub-basin 3"
8414,600,127,2700,3300,"Sub-basin 3"
8415,600,42,3200,3800,"Sub-basin 3"
8416,4600,1335.17,19200,23800,"Sub-basin 3"
8417,1200,239,5000,6200,"Sub-basin 3"
8418,1900,296,6300,8200,"Sub-basin 3"
8419,800,41,4700,5500,"Sub-basin 3"
8420,300,26,3600,3900,"Sub-basin 3"
8421,4100,275,33100,37200,"Sub-basin 3"
8422,1300,80,11300,12600,"Sub-basin 3"
8423,400,6,8900,9300,"Sub-basin 3"
8424,400,7,5600,6000,"Sub-basin 3"
8425,2300,100,18200,20500,"Sub-basin 3"
8426,300,6,6200,6500,"Sub-basin 3"
8427,100,1,2000,2100,"Sub-basin 3"
8428,100,2,2400,2500,"Sub-basin 3"
8429,100,1,800,900,"Sub-basin 3"
8430,600,41,3600,4200,"Sub-basin 3"
8431,300,6,3100,3400,"Sub-basin 3"
8432,1900,163,9100,11000,"Sub-basin 3"
8433,200,11,2000,2200,"Sub-basin 3"
8434,1700,260,5200,6900,"Sub-basin 3"
8435,900,134,5600,6500,"Sub-basin 3"
8436,500,30,2100,2600,"Sub-basin 3"
8437,900,134,4700,5600,"Sub-basin 3"
8438,200,7,1600,1800,"Sub-basin 3"
8439,100,1,200,300,"Sub-basin 3"
8440,400,15,4000,4400,"Sub-basin 3"
8441,100,1,1100,1200,"Sub-basin 3"
8442,100,1,4100,4200,"Sub-basin 3"
8443,200,3,1300,1500,"Sub-basin 3"
8444,200,3,8000,8200,"Sub-basin 3"
8445,200,2,2500,2700,"Sub-basin 3"
8446,300,6,6200,6500,"Sub-basin 3"
8447,200,6,6200,6400,"Sub-basin 3"
8448,200,8,2300,2500,"Sub-basin 3"
8449,2600,189,14600,17200,"Sub-basin 3"
8450,800,116,1600,2400,"Sub-basin 3"
8451,300,6,2800,3100,"Sub-basin 3"
8452,900,57,6300,7200,"Sub-basin 3"
8453,100,2,700,800,"Sub-basin 3"
8454,1600,204,6000,7600,"Sub-basin 3"
8455,100,4,1100,1200,"Sub-basin 3"
8456,200,7,1000,1200,"Sub-basin 3"
8457,200,7,2200,2400,"Sub-basin 3"
8458,7100,1674.83,8700,15800,"Sub-basin 3"
8459,200,10,2300,2500,"Sub-basin 3"
8460,700,58,2200,2900,"Sub-basin 3"
8461,100,1,2500,2600,"Sub-basin 3"
8462,600,26,7600,8200,"Sub-basin 3"
8463,600,32,8700,9300,"Sub-basin 3"
8464,500,21,8200,8700,"Sub-basin 3"
8465,100,2,2800,2900,"Sub-basin 3"
8466,300,3,6000,6300,"Sub-basin 3"
8467,200,6,2700,2900,"Sub-basin 3"
8468,500,8,8000,8500,"Sub-basin 3"
8469,100,1,900,1000,"Sub-basin 3"
8470,600,14,12800,13400,"Sub-basin 3"
8471,200,3,6100,6300,"Sub-basin 3"
8472,100,2,3200,3300,"Sub-basin 3"
8473,200,4,5100,5300,"Sub-basin 3"
8474,100,1,1300,1400,"Sub-basin 3"
8475,1100,43,12800,13900,"Sub-basin 3"
8476,300,13,5500,5800,"Sub-basin 3"
8477,200,7,2300,2500,"Sub-basin 3"
8478,600,24,3400,4000,"Sub-basin 3"
8479,1800,128,9800,11600,"Sub-basin 3"
8480,2700,362,9900,12600,"Sub-basin 3"
8481,2200,704,4700,6900,"Sub-basin 3"
8482,100,1,800,900,"Sub-basin 3"
8483,500,37,4900,5400,"Sub-basin 3"
8484,300,14,2500,2800,"Sub-basin 3"
8485,800,135,3100,3900,"Sub-basin 3"
8486,300,36,2700,3000,"Sub-basin 3"
8487,200,3,2100,2300,"Sub-basin 3"
8488,300,15,2600,2900,"Sub-basin 3"
8489,100,9,500,600,"Sub-basin 3"
8490,300,46,2500,2800,"Sub-basin 3"
8491,2700,265,6200,8900,"Sub-basin 3"
8492,600,90,3900,4500,"Sub-basin 3"
8493,1200,330,4200,5400,"Sub-basin 3"
8494,200,16,4000,4200,"Sub-basin 3"
8495,100,1,1900,2000,"Sub-basin 3"
8496,100,1,2800,2900,"Sub-basin 3"
8497,200,9,2100,2300,"Sub-basin 3"
8498,1200,100,6200,7400,"Sub-basin 3"
8499,100,3,3300,3400,"Sub-basin 3"
8500,100,1,3000,3100,"Sub-basin 3"
8501,400,9,5900,6300,"Sub-basin 3"
8502,100,2,1700,1800,"Sub-basin 3"
8503,1000,17,19400,20400,"Sub-basin 3"
8504,2400,506,6100,8500,"Sub-basin 3"
8505,700,32,5100,5800,"Sub-basin 3"
8506,500,9,6200,6700,"Sub-basin 3"
8507,300,15,1900,2200,"Sub-basin 3"
8508,100,3,2600,2700,"Sub-basin 3"
8509,300,4,3900,4200,"Sub-basin 3"
8510,300,11,1500,1800,"Sub-basin 3"
8511,7600,824,24300,31900,"Sub-basin 3"
8512,500,14,3000,3500,"Sub-basin 3"
8513,1700,215,2800,4500,"Sub-basin 3"
8514,700,119,3600,4300,"Sub-basin 3"
8515,100,1,1100,1200,"Sub-basin 3"
8516,500,20,2700,3200,"Sub-basin 3"
8517,100,2,2300,2400,"Sub-basin 3"
8518,100,2,3000,3100,"Sub-basin 3"
8519,100,1,1700,1800,"Sub-basin 3"
8520,600,25,4500,5100,"Sub-basin 3"
8521,300,3,6200,6500,"Sub-basin 3"
8522,300,3,2700,3000,"Sub-basin 3"
8523,300,13,3400,3700,"Sub-basin 3"
8524,100,2,1500,1600,"Sub-basin 3"
8525,100,1,800,900,"Sub-basin 3"
8526,100,1,1800,1900,"Sub-basin 3"
8527,2000,589,6200,8200,"Sub-basin 3"
8528,1300,276,6300,7600,"Sub-basin 3"
8529,1000,86,2800,3800,"Sub-basin 3"
8530,300,15,2900,3200,"Sub-basin 3"
8531,1400,96,6100,7500,"Sub-basin 3"
8532,500,31,4300,4800,"Sub-basin 3"
8533,1000,147,3900,4900,"Sub-basin 3"
8534,100,2,1400,1500,"Sub-basin 3"
8535,800,119,3500,4300,"Sub-basin 3"
8536,400,93,1600,2000,"Sub-basin 3"
8537,800,142,3600,4400,"Sub-basin 3"
8538,400,42,2600,3000,"Sub-basin 3"
8539,600,24,10400,11000,"Sub-basin 3"
8540,100,4,2300,2400,"Sub-basin 3"
8541,800,33,12900,13700,"Sub-basin 3"
8542,200,4,2600,2800,"Sub-basin 3"
8543,100,3,2400,2500,"Sub-basin 3"
8544,100,1,900,1000,"Sub-basin 3"
8545,100,1.0023,1800,1900,"Sub-basin 3"
8546,400,25,4100,4500,"Sub-basin 3"
8547,300,11,4800,5100,"Sub-basin 3"
8548,500,22,3600,4100,"Sub-basin 3"
8549,300,23,2200,2500,"Sub-basin 3"
8550,100,2,1200,1300,"Sub-basin 3"
8551,100,1,2100,2200,"Sub-basin 3"
8552,200,13,1800,2000,"Sub-basin 3"
8553,200,11,900,1100,"Sub-basin 3"
8554,1200,49,4000,5200,"Sub-basin 3"
8555,100,3,1100,1200,"Sub-basin 3"
8556,2200,558,9100,11300,"Sub-basin 3"
8557,100,2,1500,1600,"Sub-basin 3"
8558,200,12,4000,4200,"Sub-basin 3"
8559,100,1,2100,2200,"Sub-basin 3"
8560,200,4,4900,5100,"Sub-basin 3"
8561,600,31,7000,7600,"Sub-basin 3"
8562,300,6,1400,1700,"Sub-basin 3"
8563,100,2,2700,2800,"Sub-basin 3"
8564,500,17,3100,3600,"Sub-basin 3"
8565,200,7,1700,1900,"Sub-basin 3"
8566,600,67,3500,4100,"Sub-basin 3"
8567,400,84,2000,2400,"Sub-basin 3"
8568,100,4,1200,1300,"Sub-basin 3"
8569,100,4,700,800,"Sub-basin 3"
8570,800,55,2700,3500,"Sub-basin 3"
8571,200,9,1000,1200,"Sub-basin 3"
8572,200,5,2900,3100,"Sub-basin 3"
8573,3200,169,24400,27600,"Sub-basin 3"
8574,200,2,2500,2700,"Sub-basin 3"
8575,300,6,6400,6700,"Sub-basin 3"
8576,300,4,3300,3600,"Sub-basin 3"
8577,400,9,4400,4800,"Sub-basin 3"
8578,200,3,3100,3300,"Sub-basin 3"
8579,200,3,5000,5200,"Sub-basin 3"
8580,700,13,11300,12000,"Sub-basin 3"
8581,1000,85,4100,5100,"Sub-basin 3"
8582,500,32,4000,4500,"Sub-basin 3"
8583,1400,178,6100,7500,"Sub-basin 3"
8584,400,14,2100,2500,"Sub-basin 3"
8585,100,1,1300,1400,"Sub-basin 3"
8586,400,61,3200,3600,"Sub-basin 3"
8587,500,22,4100,4600,"Sub-basin 3"
8588,1700,267,5300,7000,"Sub-basin 3"
8589,24800,5716,27300,52100,"Sub-basin 3"
8590,700,48,4000,4700,"Sub-basin 3"
8591,300,7,2200,2500,"Sub-basin 3"
8592,800,36,2200,3000,"Sub-basin 3"
8593,600,12,4300,4900,"Sub-basin 3"
8594,100,1,1800,1900,"Sub-basin 3"
8595,200,2,2400,2600,"Sub-basin 3"
8596,600,21,4900,5500,"Sub-basin 3"
8597,8500,547,67900,76400,"Sub-basin 3"
8598,100,1,2600,2700,"Sub-basin 3"
8599,400,15,1900,2300,"Sub-basin 3"
8600,100,1,1800,1900,"Sub-basin 3"
8601,500,23,6400,6900,"Sub-basin 3"
8602,300,7,4300,4600,"Sub-basin 3"
8603,200,10,2000,2200,"Sub-basin 3"
8604,1700,174.0235,12300,14000,"Sub-basin 3"
8605,5400,2147,29900,35300,"Sub-basin 3"
8606,500,27,4000,4500,"Sub-basin 3"
8607,400,15,3900,4300,"Sub-basin 3"
8608,4100,668,20100,24200,"Sub-basin 3"
8609,100,3,400,500,"Sub-basin 3"
8610,7000,916,23600,30600,"Sub-basin 3"
8611,400,13,3400,3800,"Sub-basin 3"
8612,400,25,1000,1400,"Sub-basin 3"
8613,700,28,4200,4900,"Sub-basin 3"
8614,300,12,2600,2900,"Sub-basin 3"
8615,900,43,9200,10100,"Sub-basin 3"
8616,100,1,1300,1400,"Sub-basin 3"
8617,100,2,900,1000,"Sub-basin 3"
8618,200,2,3300,3500,"Sub-basin 3"
8619,100,1,1300,1400,"Sub-basin 3"
8620,400,11,7900,8300,"Sub-basin 3"
8621,100,1,400,500,"Sub-basin 3"
8622,200,6,2000,2200,"Sub-basin 3"
8623,400,11,3600,4000,"Sub-basin 3"
8624,100,3,1300,1400,"Sub-basin 3"
8625,500,51,4300,4800,"Sub-basin 3"
8626,2300,147,12200,14500,"Sub-basin 3"
8627,100,1,1700,1800,"Sub-basin 3"
8628,200,11,2200,2400,"Sub-basin 3"
8629,1200,216,3700,4900,"Sub-basin 3"
8630,200,4,2700,2900,"Sub-basin 3"
8631,800,80,1100,1900,"Sub-basin 3"
8632,400,34,3600,4000,"Sub-basin 3"
8633,300,6,3000,3300,"Sub-basin 3"
8634,1000,35,19600,20600,"Sub-basin 3"
8635,400,10,4100,4500,"Sub-basin 3"
8636,500,16,6700,7200,"Sub-basin 3"
8637,900,45,3700,4600,"Sub-basin 3"
8638,300,14,2100,2400,"Sub-basin 3"
8639,300,5,3300,3600,"Sub-basin 3"
8640,200,4,1400,1600,"Sub-basin 3"
8641,2300,507,7200,9500,"Sub-basin 3"
8642,200,7,3300,3500,"Sub-basin 3"
8643,400,36,3400,3800,"Sub-basin 3"
8644,1200,183,5000,6200,"Sub-basin 3"
8645,500,42,4200,4700,"Sub-basin 3"
8646,700,70,4900,5600,"Sub-basin 3"
8647,300,39,5200,5500,"Sub-basin 3"
8648,200,2,4000,4200,"Sub-basin 3"
8649,800,24,8200,9000,"Sub-basin 3"
8650,200,3,2800,3000,"Sub-basin 3"
8651,100,1,1700,1800,"Sub-basin 3"
8652,45400,2726,192200,237600,"Sub-basin 3"
8653,2700,127,19600,22300,"Sub-basin 3"
8654,400,16,7400,7800,"Sub-basin 3"
8655,100,2,1400,1500,"Sub-basin 3"
8656,200,17,1300,1500,"Sub-basin 3"
8657,6000,244,48200,54200,"Sub-basin 3"
8658,100,3,2200,2300,"Sub-basin 3"
8659,100,2,1100,1200,"Sub-basin 3"
8660,3000,1168,15100,18100,"Sub-basin 3"
8661,100,2,1400,1500,"Sub-basin 3"
8662,4200,394,10900,15100,"Sub-basin 3"
8663,700,22,3400,4100,"Sub-basin 3"
8664,400,34,3300,3700,"Sub-basin 3"
8665,200,22,1200,1400,"Sub-basin 3"
8666,100,4,1800,1900,"Sub-basin 3"
8667,1000,136,3600,4600,"Sub-basin 3"
8668,800,144,3800,4600,"Sub-basin 3"
8669,1100,135,3200,4300,"Sub-basin 3"
8670,8400,1367,14500,22900,"Sub-basin 3"
8671,200,7,1200,1400,"Sub-basin 3"
8672,200,7,1600,1800,"Sub-basin 3"
8673,200,19,2400,2600,"Sub-basin 3"
8674,900,27,14100,15000,"Sub-basin 3"
8675,900,57,9800,10700,"Sub-basin 3"
8676,500,21,4200,4700,"Sub-basin 3"
8677,200,3,1100,1300,"Sub-basin 3"
8678,900,54,3800,4700,"Sub-basin 3"
8679,100,1,1900,2000,"Sub-basin 3"
8680,500,93,5800,6300,"Sub-basin 3"
8681,300,15,3200,3500,"Sub-basin 3"
8682,100,1,900,1000,"Sub-basin 3"
8683,2300,394,5900,8200,"Sub-basin 3"
8684,100,1,2000,2100,"Sub-basin 3"
8685,1000,58,7000,8000,"Sub-basin 3"
8686,100,3,1100,1200,"Sub-basin 3"
8687,300,10,4600,4900,"Sub-basin 3"
8688,2000,136,22200,24200,"Sub-basin 3"
8689,400,10,5800,6200,"Sub-basin 3"
8690,100,2,1300,1400,"Sub-basin 3"
8691,3200,261,26100,29300,"Sub-basin 3"
8692,1100,18,9800,10900,"Sub-basin 3"
8693,200,8,7000,7200,"Sub-basin 3"
8694,400,4,4700,5100,"Sub-basin 3"
8695,1200,97,7200,8400,"Sub-basin 3"
8696,500,13,5600,6100,"Sub-basin 3"
8697,1800,33,20300,22100,"Sub-basin 3"
8698,100,3,1000,1100,"Sub-basin 3"
8699,1800,128,12900,14700,"Sub-basin 3"
8700,1400,65,11200,12600,"Sub-basin 3"
8701,100,1,1000,1100,"Sub-basin 3"
8702,2100,138,7900,10000,"Sub-basin 3"
8703,400,13,4100,4500,"Sub-basin 3"
8704,1800,138,6700,8500,"Sub-basin 3"
8705,400,40,1300,1700,"Sub-basin 3"
8706,400,27,4400,4800,"Sub-basin 3"
8707,800,42,3800,4600,"Sub-basin 3"
8708,500,22,7200,7700,"Sub-basin 3"
8709,8200,998,46800,55000,"Sub-basin 3"
8710,1200,93,7800,9000,"Sub-basin 3"
8711,200,5,2400,2600,"Sub-basin 3"
8712,1000,66,6500,7500,"Sub-basin 3"
8713,200,3,2500,2700,"Sub-basin 3"
8714,600,28,7200,7800,"Sub-basin 3"
8715,300,7,4800,5100,"Sub-basin 3"
8716,2300,257,9300,11600,"Sub-basin 3"
8717,13400,2103,37200,50600,"Sub-basin 3"
8718,200,5,2700,2900,"Sub-basin 3"
8719,100,1,500,600,"Sub-basin 3"
8720,5300,1728,12600,17900,"Sub-basin 3"
8721,300,5,3000,3300,"Sub-basin 3"
8722,100,2,1000,1100,"Sub-basin 3"
8723,100,1,900,1000,"Sub-basin 3"
8724,100,1,1600,1700,"Sub-basin 3"
8725,2500,163,34800,37300,"Sub-basin 3"
8726,500,43,7200,7700,"Sub-basin 3"
8727,100,1,2800,2900,"Sub-basin 3"
8728,100,2,1900,2000,"Sub-basin 3"
8729,100,3,2800,2900,"Sub-basin 3"
8730,3100,273,10400,13500,"Sub-basin 3"
8731,100,2,800,900,"Sub-basin 3"
8732,100,2,1400,1500,"Sub-basin 3"
8733,2100,192,9500,11600,"Sub-basin 3"
8734,800,38,8500,9300,"Sub-basin 3"
8735,600,21,3500,4100,"Sub-basin 3"
8736,100,3,1200,1300,"Sub-basin 3"
8737,600,28,4700,5300,"Sub-basin 3"
8738,1000,187,3700,4700,"Sub-basin 3"
8739,100,2,1700,1800,"Sub-basin 3"
8740,900,100,2600,3500,"Sub-basin 3"
8741,500,29,3600,4100,"Sub-basin 3"
8742,200,2,2700,2900,"Sub-basin 3"
8743,200,10,3300,3500,"Sub-basin 3"
8744,200,7,4500,4700,"Sub-basin 3"
8745,500,30,10700,11200,"Sub-basin 3"
8746,300,7,2600,2900,"Sub-basin 3"
8747,100,1,1200,1300,"Sub-basin 3"
8748,1100,57,17900,19000,"Sub-basin 3"
8749,200,4,5800,6000,"Sub-basin 3"
8750,4800,362.17,22300,27100,"Sub-basin 3"
8751,600,24,4500,5100,"Sub-basin 3"
8752,400,8,3900,4300,"Sub-basin 3"
8753,100,1,1700,1800,"Sub-basin 3"
8754,5600,990,10000,15600,"Sub-basin 3"
8755,700,39,6600,7300,"Sub-basin 3"
8756,700,35,4700,5400,"Sub-basin 3"
8757,100,1,1100,1200,"Sub-basin 3"
8758,300,6,6100,6400,"Sub-basin 3"
8759,900,20,4500,5400,"Sub-basin 3"
8760,300,6,5100,5400,"Sub-basin 3"
8761,100,1,2600,2700,"Sub-basin 3"
8762,600,17,6500,7100,"Sub-basin 3"
8763,200,3,4200,4400,"Sub-basin 3"
8764,100,1,900,1000,"Sub-basin 3"
8765,100,1,1600,1700,"Sub-basin 3"
8766,100,2,200,300,"Sub-basin 3"
8767,100,1,1000,1100,"Sub-basin 3"
8768,1300,79,13500,14800,"Sub-basin 3"
8769,3100,322,16500,19600,"Sub-basin 3"
8770,200,5,3300,3500,"Sub-basin 3"
8771,300,6,1600,1900,"Sub-basin 3"
8772,100,1,700,800,"Sub-basin 3"
8773,1100,112,6400,7500,"Sub-basin 3"
8774,500,32,3800,4300,"Sub-basin 3"
8775,2300,287,4300,6600,"Sub-basin 3"
8776,600,33.33,2100,2700,"Sub-basin 3"
8777,600,19,2100,2700,"Sub-basin 3"
8778,1300,125,4000,5300,"Sub-basin 3"
8779,4800,1358,4500,9300,"Sub-basin 3"
8780,5200,1429,5500,10700,"Sub-basin 3"
8781,100,1,1300,1400,"Sub-basin 3"
8782,100,2,800,900,"Sub-basin 3"
8783,100,2,1300,1400,"Sub-basin 3"
8784,400,24,2400,2800,"Sub-basin 3"
8785,400,12,2800,3200,"Sub-basin 3"
8786,300,9,4800,5100,"Sub-basin 3"
8787,1000,32,11700,12700,"Sub-basin 3"
8788,200,5,3300,3500,"Sub-basin 3"
8789,200,3,2400,2600,"Sub-basin 3"
8790,300,5,3500,3800,"Sub-basin 3"
8791,100,4,2400,2500,"Sub-basin 3"
8792,1400,74,8600,10000,"Sub-basin 3"
8793,200,8,600,800,"Sub-basin 3"
8794,500,21,3400,3900,"Sub-basin 3"
8795,200,14,1400,1600,"Sub-basin 3"
8796,300,20,1100,1400,"Sub-basin 3"
8797,100,1,500,600,"Sub-basin 3"
8798,400,16,2100,2500,"Sub-basin 3"
8799,100,1,2600,2700,"Sub-basin 3"
8800,100,1,1400,1500,"Sub-basin 3"
8801,300,7,2700,3000,"Sub-basin 3"
8802,300,15,4900,5200,"Sub-basin 3"
8803,200,3,2200,2400,"Sub-basin 3"
8804,100,2,3300,3400,"Sub-basin 3"
8805,200,6,4500,4700,"Sub-basin 3"
8806,200,6,3100,3300,"Sub-basin 3"
8807,100,2,1400,1500,"Sub-basin 3"
8808,100,3,1400,1500,"Sub-basin 3"
8809,100,1,3600,3700,"Sub-basin 3"
8810,700,17,6800,7500,"Sub-basin 3"
8811,100,1,1200,1300,"Sub-basin 3"
8812,1900,221,11600,13500,"Sub-basin 3"
8813,200,2.0035,2700,2900,"Sub-basin 3"
8814,1000,73,8000,9000,"Sub-basin 3"
8815,1400,149,5500,6900,"Sub-basin 3"
8816,600,87,4900,5500,"Sub-basin 3"
8817,100,11,1100,1200,"Sub-basin 3"
8818,200,7,2300,2500,"Sub-basin 3"
8819,400,21,1800,2200,"Sub-basin 3"
8820,800,130,2700,3500,"Sub-basin 3"
8821,1600,230,4100,5700,"Sub-basin 3"
8822,700,42,3400,4100,"Sub-basin 3"
8823,400,25,2400,2800,"Sub-basin 3"
8824,400,8,4000,4400,"Sub-basin 3"
8825,100,1,1100,1200,"Sub-basin 3"
8826,400,7,5800,6200,"Sub-basin 3"
8827,100,6,2600,2700,"Sub-basin 3"
8828,20900,1616.5,113600,134500,"Sub-basin 3"
8829,100,2,1600,1700,"Sub-basin 3"
8830,1200,97,6300,7500,"Sub-basin 3"
8831,400,18,2300,2700,"Sub-basin 3"
8832,400,29,4000,4400,"Sub-basin 3"
8833,200,3,3400,3600,"Sub-basin 3"
8834,1100,78,3300,4400,"Sub-basin 3"
8835,100,1,1100,1200,"Sub-basin 3"
8836,100,3,2900,3000,"Sub-basin 3"
8837,500,35,1800,2300,"Sub-basin 3"
8838,100,2,500,600,"Sub-basin 3"
8839,900,70,10400,11300,"Sub-basin 3"
8840,400,17,4000,4400,"Sub-basin 3"
8841,100,1,1000,1100,"Sub-basin 3"
8842,200,2,3100,3300,"Sub-basin 3"
8843,900,82,10000,10900,"Sub-basin 3"
8844,100,3,1200,1300,"Sub-basin 3"
8845,600,33,6800,7400,"Sub-basin 3"
8846,200,4,4700,4900,"Sub-basin 3"
8847,300,6,2800,3100,"Sub-basin 3"
8848,100,1,2900,3000,"Sub-basin 3"
8849,700,40,6200,6900,"Sub-basin 3"
8850,200,4,3100,3300,"Sub-basin 3"
8851,100,1,2100,2200,"Sub-basin 3"
8852,1000,36,4600,5600,"Sub-basin 3"
8853,100,3,1200,1300,"Sub-basin 3"
8854,1300,144,4700,6000,"Sub-basin 3"
8855,2600,629,5800,8400,"Sub-basin 3"
8856,400,20,1200,1600,"Sub-basin 3"
8857,900,93,3500,4400,"Sub-basin 3"
8858,1000,62,4100,5100,"Sub-basin 3"
8859,200,11,2600,2800,"Sub-basin 3"
8860,300,8,4200,4500,"Sub-basin 3"
8861,100,1,3300,3400,"Sub-basin 3"
8862,300,4,5900,6200,"Sub-basin 3"
8863,300,9.0018,5100,5400,"Sub-basin 3"
8864,100,1.0021,1100,1200,"Sub-basin 3"
8865,100,3,1300,1400,"Sub-basin 3"
8866,1200,58,14600,15800,"Sub-basin 3"
8867,5100,1618,13000,18100,"Sub-basin 3"
8868,900,50,3800,4700,"Sub-basin 3"
8869,300,20,1600,1900,"Sub-basin 3"
8870,1800,183,9600,11400,"Sub-basin 3"
8871,1600,132,7000,8600,"Sub-basin 3"
8872,500,27,3600,4100,"Sub-basin 3"
8873,2200,216,14300,16500,"Sub-basin 3"
8874,2800,398,21000,23800,"Sub-basin 3"
8875,1000,43,10800,11800,"Sub-basin 3"
8876,400,6,3600,4000,"Sub-basin 3"
8877,300,5,4100,4400,"Sub-basin 3"
8878,100,5,2100,2200,"Sub-basin 3"
8879,500,32,3800,4300,"Sub-basin 3"
8880,400,18,3200,3600,"Sub-basin 3"
8881,300,24,2900,3200,"Sub-basin 3"
8882,100,2,900,1000,"Sub-basin 3"
8883,300,7,2500,2800,"Sub-basin 3"
8884,1200,44,8800,10000,"Sub-basin 3"
8885,400,15,1700,2100,"Sub-basin 3"
8886,300,15,1200,1500,"Sub-basin 3"
8887,200,3,1500,1700,"Sub-basin 3"
8888,700,62,5700,6400,"Sub-basin 3"
8889,100,1,1000,1100,"Sub-basin 3"
8890,200,6,2100,2300,"Sub-basin 3"
8891,400,40,1600,2000,"Sub-basin 3"
8892,400,9,2000,2400,"Sub-basin 3"
8893,800,43,4900,5700,"Sub-basin 3"
8894,800,70,2900,3700,"Sub-basin 3"
8895,100,1,1400,1500,"Sub-basin 3"
8896,100,2,1900,2000,"Sub-basin 3"
8897,300,6,2800,3100,"Sub-basin 3"
8898,200,3,2000,2200,"Sub-basin 3"
8899,200,3,3600,3800,"Sub-basin 3"
8900,200,3,3400,3600,"Sub-basin 3"
8901,400,11,7700,8100,"Sub-basin 3"
8902,1100,33,22000,23100,"Sub-basin 3"
8903,100,2,1700,1800,"Sub-basin 3"
8904,100,3,2400,2500,"Sub-basin 3"
8905,400,13,4800,5200,"Sub-basin 3"
8906,100,1.0018,1600,1700,"Sub-basin 3"
8907,300,11,5300,5600,"Sub-basin 3"
8908,900,101,5900,6800,"Sub-basin 3"
8909,200,8,1600,1800,"Sub-basin 3"
8910,100,2,800,900,"Sub-basin 3"
8911,1300,102,6000,7300,"Sub-basin 3"
8912,2200,164,6800,9000,"Sub-basin 3"
8913,900,62,2400,3300,"Sub-basin 3"
8914,1700,239,4500,6200,"Sub-basin 3"
8915,900,38,4700,5600,"Sub-basin 3"
8916,200,6,3800,4000,"Sub-basin 3"
8917,200,10,3300,3500,"Sub-basin 3"
8918,400,26,1700,2100,"Sub-basin 3"
8919,400,17,2900,3300,"Sub-basin 3"
8920,600,12,14900,15500,"Sub-basin 3"
8921,100,2,2700,2800,"Sub-basin 3"
8922,100,1,800,900,"Sub-basin 3"
8923,1200,40,5900,7100,"Sub-basin 3"
8924,200,7,1700,1900,"Sub-basin 3"
8925,100,4,600,700,"Sub-basin 3"
8926,200,5,2100,2300,"Sub-basin 3"
8927,200,11,900,1100,"Sub-basin 3"
8928,200,2,2400,2600,"Sub-basin 3"
8929,400,12,4500,4900,"Sub-basin 3"
8930,800,66,4500,5300,"Sub-basin 3"
8931,500,48,3800,4300,"Sub-basin 3"
8932,8000,1137,9300,17300,"Sub-basin 3"
8933,600,41,5300,5900,"Sub-basin 3"
8934,100,2,1600,1700,"Sub-basin 3"
8935,600,29,5600,6200,"Sub-basin 3"
8936,100,2,1700,1800,"Sub-basin 3"
8937,800,123,7300,8100,"Sub-basin 3"
8938,700,72,5200,5900,"Sub-basin 3"
8939,200,2,2900,3100,"Sub-basin 3"
8940,2700,513,5000,7700,"Sub-basin 3"
8941,3900,250,37900,41800,"Sub-basin 3"
8942,5500,1034,31000,36500,"Sub-basin 3"
8943,3600,320,8600,12200,"Sub-basin 3"
8944,3100,386,9400,12500,"Sub-basin 3"
8945,1800,67,9000,10800,"Sub-basin 3"
8946,1200,84,6500,7700,"Sub-basin 3"
8947,100,1,1800,1900,"Sub-basin 3"
8948,200,2,2700,2900,"Sub-basin 3"
8949,800,17,4900,5700,"Sub-basin 3"
8950,1000,41,10800,11800,"Sub-basin 3"
8951,500,10,10600,11100,"Sub-basin 3"
8952,400,10,11300,11700,"Sub-basin 3"
8953,1100,33,2600,3700,"Sub-basin 3"
8954,300,8,2400,2700,"Sub-basin 3"
8955,400,20,2000,2400,"Sub-basin 3"
8956,300,11,1400,1700,"Sub-basin 3"
8957,1100,78,8500,9600,"Sub-basin 3"
8958,200,14,3000,3200,"Sub-basin 3"
8959,700,96,5600,6300,"Sub-basin 3"
8960,1000,71,7900,8900,"Sub-basin 3"
8961,200,4,1300,1500,"Sub-basin 3"
8962,500,42,1900,2400,"Sub-basin 3"
8963,1000,139,4400,5400,"Sub-basin 3"
8964,1200,93,8200,9400,"Sub-basin 3"
8965,1600,368,4900,6500,"Sub-basin 3"
8966,100,1,1000,1100,"Sub-basin 3"
8967,2000,149,11700,13700,"Sub-basin 3"
8968,300,19,3700,4000,"Sub-basin 3"
8969,200,8,3000,3200,"Sub-basin 3"
8970,100,1,2700,2800,"Sub-basin 3"
8971,100,1,2100,2200,"Sub-basin 3"
8972,3600,761,27400,31000,"Sub-basin 3"
8973,100,1,1700,1800,"Sub-basin 3"
8974,1400,46.0132,7100,8500,"Sub-basin 3"
8975,800,387,9200,10000,"Sub-basin 3"
8976,300,9,5800,6100,"Sub-basin 3"
8977,200,6,2000,2200,"Sub-basin 3"
8978,1700,144,9200,10900,"Sub-basin 3"
8979,600,94,1500,2100,"Sub-basin 3"
8980,100,5,400,500,"Sub-basin 3"
8981,1500,134,6000,7500,"Sub-basin 3"
8982,2000,156,20100,22100,"Sub-basin 3"
8983,300,6,4200,4500,"Sub-basin 3"
8984,100,1,1100,1200,"Sub-basin 3"
8985,200,2,3500,3700,"Sub-basin 3"
8986,500,10,5300,5800,"Sub-basin 3"
8987,200,2,2600,2800,"Sub-basin 3"
8988,300,3,1500,1800,"Sub-basin 3"
8989,2800,165,22900,25700,"Sub-basin 3"
8990,200,3,1800,2000,"Sub-basin 3"
8991,1300,66,11100,12400,"Sub-basin 3"
8992,100,1,2000,2100,"Sub-basin 3"
8993,500,57,5000,5500,"Sub-basin 3"
8994,700,28,9900,10600,"Sub-basin 3"
8995,600,16,5800,6400,"Sub-basin 3"
8996,2700,751,11300,14000,"Sub-basin 3"
8997,300,25,1800,2100,"Sub-basin 3"
8998,300,17,4500,4800,"Sub-basin 3"
8999,200,7,2700,2900,"Sub-basin 3"
9000,900,23,3300,4200,"Sub-basin 3"
9001,800,86,6700,7500,"Sub-basin 3"
9002,400,38,3400,3800,"Sub-basin 3"
9003,200,6,1800,2000,"Sub-basin 3"
9004,400,15,3100,3500,"Sub-basin 3"
9005,3700,397,30500,34200,"Sub-basin 3"
9006,300,9,8100,8400,"Sub-basin 3"
9007,200,3,4600,4800,"Sub-basin 3"
9008,100,2,1300,1400,"Sub-basin 3"
9009,400,10.0036,3500,3900,"Sub-basin 3"
9010,100,3.0019,1400,1500,"Sub-basin 3"
9011,100,2,900,1000,"Sub-basin 3"
9012,3700,1194,6600,10300,"Sub-basin 3"
9013,1100,80,5400,6500,"Sub-basin 3"
9014,100,5,2700,2800,"Sub-basin 3"
9015,100,1,2200,2300,"Sub-basin 3"
9016,400,26,1700,2100,"Sub-basin 3"
9017,100,1,800,900,"Sub-basin 3"
9018,100,1,1200,1300,"Sub-basin 3"
9019,400,19,2500,2900,"Sub-basin 3"
9020,300,23,1400,1700,"Sub-basin 3"
9021,300,27,2600,2900,"Sub-basin 3"
9022,400,18,2400,2800,"Sub-basin 3"
9023,100,4,1800,1900,"Sub-basin 3"
9024,100,2,2200,2300,"Sub-basin 3"
9025,300,9,4300,4600,"Sub-basin 3"
9026,2800,115,32600,35400,"Sub-basin 3"
9027,300,6,6500,6800,"Sub-basin 3"
9028,300,6,2300,2600,"Sub-basin 3"
9029,100,1,2400,2500,"Sub-basin 3"
9030,300,9.0027,3200,3500,"Sub-basin 3"
9031,500,33,9000,9500,"Sub-basin 3"
9032,100,1,2800,2900,"Sub-basin 3"
9033,100,1,1000,1100,"Sub-basin 3"
9034,200,6,2200,2400,"Sub-basin 3"
9035,900,73,3500,4400,"Sub-basin 3"
9036,21500,2520.17,65100,86600,"Sub-basin 3"
9037,1000,109,2400,3400,"Sub-basin 3"
9038,200,5,3000,3200,"Sub-basin 3"
9039,200,5,3200,3400,"Sub-basin 3"
9040,400,10,4500,4900,"Sub-basin 3"
9041,200,3,3400,3600,"Sub-basin 3"
9042,500,15,3600,4100,"Sub-basin 3"
9043,1700,158,9800,11500,"Sub-basin 3"
9044,500,53,5900,6400,"Sub-basin 3"
9045,100,3,1100,1200,"Sub-basin 3"
9046,200,8,500,700,"Sub-basin 3"
9047,400,15,2700,3100,"Sub-basin 3"
9048,100,1,800,900,"Sub-basin 3"
9049,900,44,5400,6300,"Sub-basin 3"
9050,5300,519,24600,29900,"Sub-basin 3"
9051,400,64,1400,1800,"Sub-basin 3"
9052,100,1,1200,1300,"Sub-basin 3"
9053,3900,406,14200,18100,"Sub-basin 3"
9054,100,4,1000,1100,"Sub-basin 3"
9055,1700,132,4200,5900,"Sub-basin 3"
9056,100,3,2700,2800,"Sub-basin 3"
9057,200,2,2000,2200,"Sub-basin 3"
9058,100,1,1800,1900,"Sub-basin 3"
9059,400,25,3400,3800,"Sub-basin 3"
9060,1000,98,7900,8900,"Sub-basin 3"
9061,600,44,2000,2600,"Sub-basin 3"
9062,1200,154,6400,7600,"Sub-basin 3"
9063,900,31,7200,8100,"Sub-basin 3"
9064,600,39,3800,4400,"Sub-basin 3"
9065,1600,87,16000,17600,"Sub-basin 3"
9066,5000,684,13800,18800,"Sub-basin 3"
9067,100,2,1300,1400,"Sub-basin 3"
9068,1100,52,4600,5700,"Sub-basin 3"
9069,400,9,1700,2100,"Sub-basin 3"
9070,100,2,400,500,"Sub-basin 3"
9071,300,7,1700,2000,"Sub-basin 3"
9072,200,3,1200,1400,"Sub-basin 3"
9073,1600,122,9700,11300,"Sub-basin 3"
9074,100,1,1400,1500,"Sub-basin 3"
9075,1500,74.83,8800,10300,"Sub-basin 3"
9076,100,4,400,500,"Sub-basin 3"
9077,100,1.0005,1000,1100,"Sub-basin 3"
9078,100,1,400,500,"Sub-basin 3"
9079,1400,251,3500,4900,"Sub-basin 3"
9080,200,6,2600,2800,"Sub-basin 3"
9081,4500,604,20700,25200,"Sub-basin 3"
9082,400,6,4300,4700,"Sub-basin 3"
9083,100,2,1000,1100,"Sub-basin 3"
9084,200,12,1400,1600,"Sub-basin 3"
9085,200,3,1500,1700,"Sub-basin 3"
9086,600,117,1500,2100,"Sub-basin 3"
9087,1100,49,5600,6700,"Sub-basin 3"
9088,900,48,4100,5000,"Sub-basin 3"
9089,300,11,3500,3800,"Sub-basin 3"
9090,300,21,2500,2800,"Sub-basin 3"
9091,100,4,1100,1200,"Sub-basin 3"
9092,1100,77,23300,24400,"Sub-basin 3"
9093,500,10,10600,11100,"Sub-basin 3"
9094,200,9,2900,3100,"Sub-basin 3"
9095,600,12,14600,15200,"Sub-basin 3"
9096,100,1,2300,2400,"Sub-basin 3"
9097,900,27,4600,5500,"Sub-basin 3"
9098,1200,89,4500,5700,"Sub-basin 3"
9099,600,34,2700,3300,"Sub-basin 3"
9100,300,15,1700,2000,"Sub-basin 3"
9101,100,1,1400,1500,"Sub-basin 3"
9102,100,3,700,800,"Sub-basin 3"
9103,500,31,3600,4100,"Sub-basin 3"
9104,800,50,5300,6100,"Sub-basin 3"
9105,4100,1031,5900,10000,"Sub-basin 3"
9106,900,128,2900,3800,"Sub-basin 3"
9107,200,8,2400,2600,"Sub-basin 3"
9108,200,6,3700,3900,"Sub-basin 3"
9109,300,6,4800,5100,"Sub-basin 3"
9110,300,4,7700,8000,"Sub-basin 3"
9111,400,11,2600,3000,"Sub-basin 3"
9112,3500,198,20100,23600,"Sub-basin 3"
9113,1700,429,6600,8300,"Sub-basin 3"
9114,300,12,2600,2900,"Sub-basin 3"
9115,1000,206,2500,3500,"Sub-basin 3"
9116,9100,2623,16100,25200,"Sub-basin 3"
9117,100,2,1100,1200,"Sub-basin 3"
9118,900,35,5700,6600,"Sub-basin 3"
9119,300,9,3500,3800,"Sub-basin 3"
9120,1300,72,6700,8000,"Sub-basin 3"
9121,200,4,2100,2300,"Sub-basin 3"
9122,100,2,1100,1200,"Sub-basin 3"
9123,10500,1102,105100,115600,"Sub-basin 3"
9124,200,4,1500,1700,"Sub-basin 3"
9125,300,5,7900,8200,"Sub-basin 3"
9126,500,32,4600,5100,"Sub-basin 3"
9127,200,6,2600,2800,"Sub-basin 3"
9128,300,8,3900,4200,"Sub-basin 3"
9129,600,21,7200,7800,"Sub-basin 3"
9130,300,14,1800,2100,"Sub-basin 3"
9131,400,21,2100,2500,"Sub-basin 3"
9132,100,1,0,100,"Sub-basin 3"
9133,100,1,1100,1200,"Sub-basin 3"
9134,100,2,1400,1500,"Sub-basin 3"
9135,1900,158,13800,15700,"Sub-basin 3"
9136,1200,152,5300,6500,"Sub-basin 3"
9137,1100,71,4100,5200,"Sub-basin 3"
9138,9900,1114,40100,50000,"Sub-basin 3"
9139,700,97,3000,3700,"Sub-basin 3"
9140,200,4,1100,1300,"Sub-basin 3"
9141,28500,3359,98100,126600,"Sub-basin 3"
9142,400,13,4700,5100,"Sub-basin 3"
9143,400,10,1700,2100,"Sub-basin 3"
9144,400,9,2100,2500,"Sub-basin 3"
9145,100,3,1100,1200,"Sub-basin 3"
9146,300,6,3300,3600,"Sub-basin 3"
9147,100,2,2100,2200,"Sub-basin 3"
9148,800,29,6800,7600,"Sub-basin 3"
9149,100,1,1900,2000,"Sub-basin 3"
9150,600,25,5800,6400,"Sub-basin 3"
9151,600,59,3800,4400,"Sub-basin 3"
9152,200,8,2300,2500,"Sub-basin 3"
9153,4000,586,7900,11900,"Sub-basin 3"
9154,100,2,1000,1100,"Sub-basin 3"
9155,100,3,2000,2100,"Sub-basin 3"
9156,600,16,6700,7300,"Sub-basin 3"
9157,400,23,2800,3200,"Sub-basin 3"
9158,200,4,4400,4600,"Sub-basin 3"
9159,200,3,2800,3000,"Sub-basin 3"
9160,200,6,2000,2200,"Sub-basin 3"
9161,700,16,16200,16900,"Sub-basin 3"
9162,100,4,2000,2100,"Sub-basin 3"
9163,4800,173,60600,65400,"Sub-basin 3"
9164,100,1,3300,3400,"Sub-basin 3"
9165,200,10,3500,3700,"Sub-basin 3"
9166,3900,538,16700,20600,"Sub-basin 3"
9167,600,41,3800,4400,"Sub-basin 3"
9168,100,2,2100,2200,"Sub-basin 3"
9169,400,28,3300,3700,"Sub-basin 3"
9170,700,87,3900,4600,"Sub-basin 3"
9171,100,1,1100,1200,"Sub-basin 3"
9172,100,1,800,900,"Sub-basin 3"
9173,3300,553,6200,9500,"Sub-basin 3"
9174,900,112,3100,4000,"Sub-basin 3"
9175,2600,179,8200,10800,"Sub-basin 3"
9176,200,9,1600,1800,"Sub-basin 3"
9177,800,55,13100,13900,"Sub-basin 3"
9178,400,10,8600,9000,"Sub-basin 3"
9179,100,2,1800,1900,"Sub-basin 3"
9180,100,1,600,700,"Sub-basin 3"
9181,100,2,2200,2300,"Sub-basin 3"
9182,100,1,1000,1100,"Sub-basin 3"
9183,100,2,400,500,"Sub-basin 3"
9184,700,16.0047,7400,8100,"Sub-basin 3"
9185,100,2,800,900,"Sub-basin 3"
9186,11600,3492,32100,43700,"Sub-basin 3"
9187,300,9,1900,2200,"Sub-basin 3"
9188,500,37,5900,6400,"Sub-basin 3"
9189,500,21,3000,3500,"Sub-basin 3"
9190,700,36,2900,3600,"Sub-basin 3"
9191,600,47,3300,3900,"Sub-basin 3"
9192,700,25,6400,7100,"Sub-basin 3"
9193,200,19,2800,3000,"Sub-basin 3"
9194,1200,52,7000,8200,"Sub-basin 3"
9195,400,6,2800,3200,"Sub-basin 3"
9196,300,10,2900,3200,"Sub-basin 3"
9197,5600,1028.16,13400,19000,"Sub-basin 3"
9198,600,34,5300,5900,"Sub-basin 3"
9199,700,21,14400,15100,"Sub-basin 3"
9200,1100,65,10500,11600,"Sub-basin 3"
9201,100,1,800,900,"Sub-basin 3"
9202,200,14,3400,3600,"Sub-basin 3"
9203,100,3,1800,1900,"Sub-basin 3"
9204,1700,225,13000,14700,"Sub-basin 3"
9205,100,2,800,900,"Sub-basin 3"
9206,900,80,13300,14200,"Sub-basin 3"
9207,1100,81,3700,4800,"Sub-basin 3"
9208,3100,656,7400,10500,"Sub-basin 3"
9209,100,6,700,800,"Sub-basin 3"
9210,700,95,3400,4100,"Sub-basin 3"
9211,600,20,3400,4000,"Sub-basin 3"
9212,200,6,1000,1200,"Sub-basin 3"
9213,100,1,400,500,"Sub-basin 3"
9214,300,8,3500,3800,"Sub-basin 3"
9215,100,1,700,800,"Sub-basin 3"
9216,200,3,1300,1500,"Sub-basin 3"
9217,200,4,5000,5200,"Sub-basin 3"
9218,100,1,3700,3800,"Sub-basin 3"
9219,100,1,1700,1800,"Sub-basin 3"
9220,200,9,800,1000,"Sub-basin 3"
9221,200,11,2000,2200,"Sub-basin 3"
9222,600,14,5900,6500,"Sub-basin 3"
9223,500,48,2000,2500,"Sub-basin 3"
9224,1000,77,5400,6400,"Sub-basin 3"
9225,700,29,3300,4000,"Sub-basin 3"
9226,200,3,2000,2200,"Sub-basin 3"
9227,700,12,5900,6600,"Sub-basin 3"
9228,200,11,900,1100,"Sub-basin 3"
9229,800,34,6600,7400,"Sub-basin 3"
9230,100,1,1600,1700,"Sub-basin 3"
9231,100,3,2400,2500,"Sub-basin 3"
9232,200,6,5600,5800,"Sub-basin 3"
9233,400,8,8700,9100,"Sub-basin 3"
9234,300,22,4200,4500,"Sub-basin 3"
9235,2300,111,17300,19600,"Sub-basin 3"
9236,300,10,4000,4300,"Sub-basin 3"
9237,100,1.0004,2000,2100,"Sub-basin 3"
9238,1300,171,6100,7400,"Sub-basin 3"
9239,5900,463,41700,47600,"Sub-basin 3"
9240,200,7,2500,2700,"Sub-basin 3"
9241,2100,414,8300,10400,"Sub-basin 3"
9242,100,3,600,700,"Sub-basin 3"
9243,300,11,500,800,"Sub-basin 3"
9244,4400,671,12900,17300,"Sub-basin 3"
9245,100,1,800,900,"Sub-basin 3"
9246,100,1,1200,1300,"Sub-basin 3"
9247,100,3,1000,1100,"Sub-basin 3"
9248,100,2,1200,1300,"Sub-basin 3"
9249,200,6,1600,1800,"Sub-basin 3"
9250,100,2,5600,5700,"Sub-basin 3"
9251,200,2,2400,2600,"Sub-basin 3"
9252,200,3,1500,1700,"Sub-basin 3"
9253,300,20,1700,2000,"Sub-basin 3"
9254,300,7,4300,4600,"Sub-basin 3"
9255,100,1,1700,1800,"Sub-basin 3"
9256,400,28,1500,1900,"Sub-basin 3"
9257,2400,332,6100,8500,"Sub-basin 3"
9258,200,18,2800,3000,"Sub-basin 3"
9259,500,31,1300,1800,"Sub-basin 3"
9260,500,55,2200,2700,"Sub-basin 3"
9261,1800,372,3900,5700,"Sub-basin 3"
9262,3200,960,5200,8400,"Sub-basin 3"
9263,100,2,1000,1100,"Sub-basin 3"
9264,7500,922,59200,66700,"Sub-basin 3"
9265,200,4,1500,1700,"Sub-basin 3"
9266,300,12,2700,3000,"Sub-basin 3"
9267,100,2,1000,1100,"Sub-basin 3"
9268,400,6,7500,7900,"Sub-basin 3"
9269,200,2,4800,5000,"Sub-basin 3"
9270,200,3,5400,5600,"Sub-basin 3"
9271,1300,155,4900,6200,"Sub-basin 3"
9272,2200,116,16100,18300,"Sub-basin 3"
9273,100,2,700,800,"Sub-basin 3"
9274,2000,98,7400,9400,"Sub-basin 3"
9275,200,6,1700,1900,"Sub-basin 3"
9276,100,3,1000,1100,"Sub-basin 3"
9277,100,4,1100,1200,"Sub-basin 3"
9278,400,51,1500,1900,"Sub-basin 3"
9279,500,51,1300,1800,"Sub-basin 3"
9280,100,3,1500,1600,"Sub-basin 3"
9281,100,2,1500,1600,"Sub-basin 3"
9282,1300,66,14000,15300,"Sub-basin 3"
9283,300,6,8100,8400,"Sub-basin 3"
9284,400,7,7300,7700,"Sub-basin 3"
9285,200,2,4100,4300,"Sub-basin 3"
9286,1700,106,10500,12200,"Sub-basin 3"
9287,100,2.0012,2100,2200,"Sub-basin 3"
9288,200,5,1700,1900,"Sub-basin 3"
9289,1500,392,5200,6700,"Sub-basin 3"
9290,100,2,2700,2800,"Sub-basin 3"
9291,1100,57,9000,10100,"Sub-basin 3"
9292,200,5,2700,2900,"Sub-basin 3"
9293,200,8,1200,1400,"Sub-basin 3"
9294,600,43,3400,4000,"Sub-basin 3"
9295,100,1,900,1000,"Sub-basin 3"
9296,400,54,1600,2000,"Sub-basin 3"
9297,300,17,3300,3600,"Sub-basin 3"
9298,200,3,2400,2600,"Sub-basin 3"
9299,600,29,7000,7600,"Sub-basin 3"
9300,3300,362,19600,22900,"Sub-basin 3"
9301,400,19,3000,3400,"Sub-basin 3"
9302,400,9,12600,13000,"Sub-basin 3"
9303,700,71,2000,2700,"Sub-basin 3"
9304,3000,498,9900,12900,"Sub-basin 3"
9305,143200,35302.6415,203900,347100,"Sub-basin 3"
9306,100,1,1400,1500,"Sub-basin 3"
9307,4400,451,33300,37700,"Sub-basin 3"
9308,600,34,4800,5400,"Sub-basin 3"
9309,500,39,2800,3300,"Sub-basin 3"
9310,100,1,600,700,"Sub-basin 3"
9311,700,39,5400,6100,"Sub-basin 3"
9312,2200,316,5500,7700,"Sub-basin 3"
9313,1000,76,5300,6300,"Sub-basin 3"
9314,1000,103,5700,6700,"Sub-basin 3"
9315,200,4,2700,2900,"Sub-basin 3"
9316,200,4,2400,2600,"Sub-basin 3"
9317,200,3,5800,6000,"Sub-basin 3"
9318,8500,462,25900,34400,"Sub-basin 3"
9319,400,15,8100,8500,"Sub-basin 3"
9320,400,21,4300,4700,"Sub-basin 3"
9321,200,3,2700,2900,"Sub-basin 3"
9322,400,14,2500,2900,"Sub-basin 3"
9323,900,96,4200,5100,"Sub-basin 3"
9324,1100,68,6000,7100,"Sub-basin 3"
9325,500,11,3400,3900,"Sub-basin 3"
9326,100,1,2600,2700,"Sub-basin 3"
9327,200,13,3400,3600,"Sub-basin 3"
9328,200,3,3400,3600,"Sub-basin 3"
9329,100,2,2500,2600,"Sub-basin 3"
9330,100,1,2000,2100,"Sub-basin 3"
9331,1000,256,5300,6300,"Sub-basin 3"
9332,400,14,4300,4700,"Sub-basin 3"
9333,300,6,4800,5100,"Sub-basin 3"
9334,200,6,2700,2900,"Sub-basin 3"
9335,1600,104,15700,17300,"Sub-basin 3"
9336,400,20,2300,2700,"Sub-basin 3"
9337,4400,328,20900,25300,"Sub-basin 3"
9338,100,1,1200,1300,"Sub-basin 3"
9339,1100,51,4000,5100,"Sub-basin 3"
9340,600,32,4400,5000,"Sub-basin 3"
9341,200,3,1600,1800,"Sub-basin 3"
9342,700,154,1500,2200,"Sub-basin 3"
9343,500,20,6600,7100,"Sub-basin 3"
9344,2000,87,15500,17500,"Sub-basin 3"
9345,400,18,3400,3800,"Sub-basin 3"
9346,200,13,3000,3200,"Sub-basin 3"
9347,200,4,4500,4700,"Sub-basin 3"
9348,100,2,2700,2800,"Sub-basin 3"
9349,100,1,5000,5100,"Sub-basin 3"
9350,500,9,9300,9800,"Sub-basin 3"
9351,400,17,3000,3400,"Sub-basin 3"
9352,100,1,1400,1500,"Sub-basin 3"
9353,600,19,1500,2100,"Sub-basin 3"
9354,8200,660.34,26200,34400,"Sub-basin 3"
9355,200,3,1900,2100,"Sub-basin 3"
9356,400,24,1900,2300,"Sub-basin 3"
9357,900,133,2400,3300,"Sub-basin 3"
9358,200,8,1300,1500,"Sub-basin 3"
9359,1000,103,7400,8400,"Sub-basin 3"
9360,100,1,1100,1200,"Sub-basin 3"
9361,100,1,2600,2700,"Sub-basin 3"
9362,100,5,2100,2200,"Sub-basin 3"
9363,1800,41,9600,11400,"Sub-basin 3"
9364,600,36,4700,5300,"Sub-basin 3"
9365,200,13,3500,3700,"Sub-basin 3"
9366,100,2,1100,1200,"Sub-basin 3"
9367,1200,105,9000,10200,"Sub-basin 3"
9368,600,22,4500,5100,"Sub-basin 3"
9369,200,5,1400,1600,"Sub-basin 3"
9370,200,4,2200,2400,"Sub-basin 3"
9371,300,5,2600,2900,"Sub-basin 3"
9372,300,11,1900,2200,"Sub-basin 3"
9373,1000,41,10000,11000,"Sub-basin 3"
9374,300,7,5000,5300,"Sub-basin 3"
9375,800,52,5800,6600,"Sub-basin 3"
9376,200,3,5400,5600,"Sub-basin 3"
9377,200,5,3400,3600,"Sub-basin 3"
9378,300,7,4100,4400,"Sub-basin 3"
9379,3400,387,16200,19600,"Sub-basin 3"
9380,2200,162,14700,16900,"Sub-basin 3"
9381,200,9,1300,1500,"Sub-basin 3"
9382,600,18,5700,6300,"Sub-basin 3"
9383,200,5,600,800,"Sub-basin 3"
9384,1100,73,5500,6600,"Sub-basin 3"
9385,200,5,600,800,"Sub-basin 3"
9386,100,1,300,400,"Sub-basin 3"
9387,3400,463,7100,10500,"Sub-basin 3"
9388,100,5,2100,2200,"Sub-basin 3"
9389,400,18,2700,3100,"Sub-basin 3"
9390,1300,96,11800,13100,"Sub-basin 3"
9391,100,1,2000,2100,"Sub-basin 3"
9392,200,2,5300,5500,"Sub-basin 3"
9393,200,9,1400,1600,"Sub-basin 3"
9394,200,6,2800,3000,"Sub-basin 3"
9395,200,5,3300,3500,"Sub-basin 3"
9396,100,2,1500,1600,"Sub-basin 3"
9397,600,129,4100,4700,"Sub-basin 3"
9398,100,1,700,800,"Sub-basin 3"
9399,700,69,4200,4900,"Sub-basin 3"
9400,400,25,900,1300,"Sub-basin 3"
9401,100,2,1100,1200,"Sub-basin 3"
9402,400,9,2500,2900,"Sub-basin 3"
9403,900,51,6100,7000,"Sub-basin 3"
9404,800,209,2000,2800,"Sub-basin 3"
9405,100,1,600,700,"Sub-basin 3"
9406,200,4,2900,3100,"Sub-basin 3"
9407,200,6,3500,3700,"Sub-basin 3"
9408,1700,54,14400,16100,"Sub-basin 3"
9409,100,3,1500,1600,"Sub-basin 3"
9410,1200,114,5700,6900,"Sub-basin 3"
9411,1400,158,10100,11500,"Sub-basin 3"
9412,100,1,1800,1900,"Sub-basin 3"
9413,7000,2451,14200,21200,"Sub-basin 3"
9414,1100,88,4700,5800,"Sub-basin 3"
9415,100,3,800,900,"Sub-basin 3"
9416,600,20,4800,5400,"Sub-basin 3"
9417,600,34,2600,3200,"Sub-basin 3"
9418,100,3,1900,2000,"Sub-basin 3"
9419,200,8,6400,6600,"Sub-basin 3"
9420,500,15,7800,8300,"Sub-basin 3"
9421,100,1,600,700,"Sub-basin 3"
9422,400,5,9300,9700,"Sub-basin 3"
9423,300,7,4200,4500,"Sub-basin 3"
9424,400,25,3100,3500,"Sub-basin 3"
9425,1800,204,14700,16500,"Sub-basin 3"
9426,5900,546,42000,47900,"Sub-basin 3"
9427,300,7,1500,1800,"Sub-basin 3"
9428,500,57,5100,5600,"Sub-basin 3"
9429,300,6,2600,2900,"Sub-basin 3"
9430,700,53,5300,6000,"Sub-basin 3"
9431,8100,1865.18,21400,29500,"Sub-basin 3"
9432,200,5,2000,2200,"Sub-basin 3"
9433,200,4,2600,2800,"Sub-basin 3"
9434,1200,117,7600,8800,"Sub-basin 3"
9435,6300,653.17,39900,46200,"Sub-basin 3"
9436,100,0.16,2300,2400,"Sub-basin 3"
9437,100,1,2300,2400,"Sub-basin 3"
9438,200,5,3700,3900,"Sub-basin 3"
9439,100,1,1800,1900,"Sub-basin 3"
9440,700,36,4600,5300,"Sub-basin 3"
9441,16100,4531.91,26800,42900,"Sub-basin 3"
9442,400,47,3700,4100,"Sub-basin 3"
9443,200,5,2200,2400,"Sub-basin 3"
9444,100,3,1400,1500,"Sub-basin 3"
9445,1100,193,5600,6700,"Sub-basin 3"
9446,400,20,1900,2300,"Sub-basin 3"
9447,200,6,1400,1600,"Sub-basin 3"
9448,2800,515.83,4000,6800,"Sub-basin 3"
9449,800,44,3600,4400,"Sub-basin 3"
9450,400,10,1700,2100,"Sub-basin 3"
9451,300,8,2000,2300,"Sub-basin 3"
9452,200,5,1500,1700,"Sub-basin 3"
9453,1900,112,21700,23600,"Sub-basin 3"
9454,100,3,2000,2100,"Sub-basin 3"
9455,100,1,1100,1200,"Sub-basin 3"
9456,100,3,2500,2600,"Sub-basin 3"
9457,500,13,9000,9500,"Sub-basin 3"
9458,300,16,3800,4100,"Sub-basin 3"
9459,100,2,1300,1400,"Sub-basin 3"
9460,100,1,1600,1700,"Sub-basin 3"
9461,2600,321,11000,13600,"Sub-basin 3"
9462,300,10,7200,7500,"Sub-basin 3"
9463,100,1,2400,2500,"Sub-basin 3"
9464,600,55,4400,5000,"Sub-basin 3"
9465,1100,112,5000,6100,"Sub-basin 3"
9466,1700,134,4600,6300,"Sub-basin 3"
9467,4500,688.17,8800,13300,"Sub-basin 3"
9468,600,86,3400,4000,"Sub-basin 3"
9469,7200,978.67,11400,18600,"Sub-basin 3"
9470,100,1,1500,1600,"Sub-basin 3"
9471,200,5,2100,2300,"Sub-basin 3"
9472,200,3,1400,1600,"Sub-basin 3"
9473,100,1,100,200,"Sub-basin 3"
9474,100,5,1600,1700,"Sub-basin 3"
9475,100,2,2800,2900,"Sub-basin 3"
9476,100,1,2900,3000,"Sub-basin 3"
9477,400,10,9200,9600,"Sub-basin 3"
9478,200,7,2100,2300,"Sub-basin 3"
9479,200,10,2200,2400,"Sub-basin 3"
9480,100,1.0019,2200,2300,"Sub-basin 3"
9481,400,28,4100,4500,"Sub-basin 3"
9482,3500,577.17,7200,10700,"Sub-basin 3"
9483,100,1,1000,1100,"Sub-basin 3"
9484,100,1,700,800,"Sub-basin 3"
9485,100,1,600,700,"Sub-basin 3"
9486,800,70,3900,4700,"Sub-basin 3"
9487,100,4,700,800,"Sub-basin 3"
9488,900,67,4000,4900,"Sub-basin 3"
9489,400,12,2800,3200,"Sub-basin 3"
9490,200,6,2600,2800,"Sub-basin 3"
9491,100,5,1400,1500,"Sub-basin 3"
9492,600,42,2000,2600,"Sub-basin 3"
9493,100,2,1700,1800,"Sub-basin 3"
9494,200,2,5500,5700,"Sub-basin 3"
9495,100,1,1700,1800,"Sub-basin 3"
9496,100,1,2400,2500,"Sub-basin 3"
9497,100,2,1100,1200,"Sub-basin 3"
9498,300,16,2900,3200,"Sub-basin 3"
9499,1400,50,6500,7900,"Sub-basin 3"
9500,400,14,3100,3500,"Sub-basin 3"
9501,200,9,600,800,"Sub-basin 3"
9502,100,2,1900,2000,"Sub-basin 3"
9503,200,2,1700,1900,"Sub-basin 3"
9504,100,2,900,1000,"Sub-basin 3"
9505,1500,102,6600,8100,"Sub-basin 3"
9506,800,46,3200,4000,"Sub-basin 3"
9507,500,30,2100,2600,"Sub-basin 3"
9508,100,2,1500,1600,"Sub-basin 3"
9509,600,13,8100,8700,"Sub-basin 3"
9510,100,1,1000,1100,"Sub-basin 3"
9511,100,1,3500,3600,"Sub-basin 3"
9512,300,4,6200,6500,"Sub-basin 3"
9513,200,2,3100,3300,"Sub-basin 3"
9514,100,2,2200,2300,"Sub-basin 3"
9515,200,4.0066,2700,2900,"Sub-basin 3"
9516,200,2,1600,1800,"Sub-basin 3"
9517,200,5,2900,3100,"Sub-basin 3"
9518,22700,10296.5,23400,46100,"Sub-basin 3"
9519,2000,101,9800,11800,"Sub-basin 3"
9520,1200,157,3100,4300,"Sub-basin 3"
9521,200,5.66,1300,1500,"Sub-basin 3"
9522,100,1,1200,1300,"Sub-basin 3"
9523,600,34,3500,4100,"Sub-basin 3"
9524,400,14,3900,4300,"Sub-basin 3"
9525,400,24,11600,12000,"Sub-basin 3"
9526,300,16,6100,6400,"Sub-basin 3"
9527,200,2,1900,2100,"Sub-basin 3"
9528,700,48,5800,6500,"Sub-basin 3"
9529,400,16,4400,4800,"Sub-basin 3"
9530,800,109,2500,3300,"Sub-basin 3"
9531,100,2,2200,2300,"Sub-basin 3"
9532,200,4,2000,2200,"Sub-basin 3"
9533,1100,71.33,4000,5100,"Sub-basin 3"
9534,100,1,700,800,"Sub-basin 3"
9535,4500,438,13300,17800,"Sub-basin 3"
9536,400,26,2000,2400,"Sub-basin 3"
9537,300,13,1400,1700,"Sub-basin 3"
9538,10300,1335.16,61800,72100,"Sub-basin 3"
9539,100,3,1900,2000,"Sub-basin 3"
9540,300,3,7200,7500,"Sub-basin 3"
9541,300,7,2200,2500,"Sub-basin 3"
9542,100,2,900,1000,"Sub-basin 3"
9543,100,2,1200,1300,"Sub-basin 3"
9544,900,70,3200,4100,"Sub-basin 3"
9545,100,4,700,800,"Sub-basin 3"
9546,200,12,1000,1200,"Sub-basin 3"
9547,1300,79.5,7100,8400,"Sub-basin 3"
9548,5100,1158,12900,18000,"Sub-basin 3"
9549,200,6,3100,3300,"Sub-basin 3"
9550,100,2,2400,2500,"Sub-basin 3"
9551,200,16,2600,2800,"Sub-basin 3"
9552,100,1,900,1000,"Sub-basin 3"
9553,500,62.83,1300,1800,"Sub-basin 3"
9554,100,1,800,900,"Sub-basin 3"
9555,300,4,900,1200,"Sub-basin 3"
9556,200,3,2600,2800,"Sub-basin 3"
9557,300,10.33,5200,5500,"Sub-basin 3"
9558,100,1,1200,1300,"Sub-basin 3"
9559,100,1,800,900,"Sub-basin 3"
9560,100,0.67,1800,1900,"Sub-basin 3"
9561,400,20,6400,6800,"Sub-basin 3"
9562,200,3,3000,3200,"Sub-basin 3"
9563,100,1,3400,3500,"Sub-basin 3"
9564,100,1,900,1000,"Sub-basin 3"
9565,3200,356,5600,8800,"Sub-basin 3"
9566,1600,544,2900,4500,"Sub-basin 3"
9567,200,8,1200,1400,"Sub-basin 3"
9568,100,2,300,400,"Sub-basin 3"
9569,200,0.66,2400,2600,"Sub-basin 3"
9570,200,4,3300,3500,"Sub-basin 3"
9571,100,1,700,800,"Sub-basin 3"
9572,200,3,1400,1600,"Sub-basin 3"
9573,100,5,1200,1300,"Sub-basin 3"
9574,300,3,2200,2500,"Sub-basin 3"
9575,200,2,1600,1800,"Sub-basin 3"
9576,400,44,1900,2300,"Sub-basin 3"
9577,1500,921,6300,7800,"Sub-basin 3"
9578,200,5,2600,2800,"Sub-basin 3"
9579,500,39,1800,2300,"Sub-basin 3"
9580,100,2,400,500,"Sub-basin 3"
9581,400,25,4200,4600,"Sub-basin 3"
9582,600,61,1100,1700,"Sub-basin 3"
9583,600,21,2500,3100,"Sub-basin 3"
9584,800,54,3300,4100,"Sub-basin 3"
9585,800,31,8200,9000,"Sub-basin 3"
9586,100,1,1700,1800,"Sub-basin 3"
9587,800,19,7300,8100,"Sub-basin 3"
9588,500,28,3300,3800,"Sub-basin 3"
9589,100,11,2400,2500,"Sub-basin 3"
9590,300,11,3500,3800,"Sub-basin 3"
9591,300,5,2100,2400,"Sub-basin 3"
9592,400,12,3300,3700,"Sub-basin 3"
9593,200,8,3700,3900,"Sub-basin 3"
9594,1100,65,9100,10200,"Sub-basin 3"
9595,1500,112,4300,5800,"Sub-basin 3"
9596,800,159,6200,7000,"Sub-basin 3"
9597,100,2,1500,1600,"Sub-basin 3"
9598,600,58.34,3000,3600,"Sub-basin 3"
9599,100,5,1400,1500,"Sub-basin 3"
9600,800,76,3200,4000,"Sub-basin 3"
9601,400,24,2800,3200,"Sub-basin 3"
9602,6800,1203,7700,14500,"Sub-basin 3"
9603,100,3,500,600,"Sub-basin 3"
9604,100,1,500,600,"Sub-basin 3"
9605,400,47,3800,4200,"Sub-basin 3"
9606,300,10,1600,1900,"Sub-basin 3"
9607,300,17,6000,6300,"Sub-basin 3"
9608,200,7,5400,5600,"Sub-basin 3"
9609,100,2,2900,3000,"Sub-basin 3"
9610,3700,314,25000,28700,"Sub-basin 3"
9611,900,47,4200,5100,"Sub-basin 3"
9612,100,8,1400,1500,"Sub-basin 3"
9613,1800,224,3800,5600,"Sub-basin 3"
9614,3100,111,13600,16700,"Sub-basin 3"
9615,400,14,3000,3400,"Sub-basin 3"
9616,100,3,800,900,"Sub-basin 3"
9617,100,2,500,600,"Sub-basin 3"
9618,100,1,500,600,"Sub-basin 3"
9619,300,7,3100,3400,"Sub-basin 3"
9620,200,4,1800,2000,"Sub-basin 3"
9621,1600,265,2500,4100,"Sub-basin 3"
9622,400,27,1700,2100,"Sub-basin 3"
9623,14400,1455,40800,55200,"Sub-basin 3"
9624,600,44,3000,3600,"Sub-basin 3"
9625,100,2,2400,2500,"Sub-basin 3"
9626,100,3,1300,1400,"Sub-basin 3"
9627,300,6,4100,4400,"Sub-basin 3"
9628,300,5,4600,4900,"Sub-basin 3"
9629,400,13,5900,6300,"Sub-basin 3"
9630,300,4,2500,2800,"Sub-basin 3"
9631,100,2.0023,1200,1300,"Sub-basin 3"
9632,100,3,1300,1400,"Sub-basin 3"
9633,1100,31,7300,8400,"Sub-basin 3"
9634,900,61,7500,8400,"Sub-basin 3"
9635,200,2,1900,2100,"Sub-basin 3"
9636,200,3,2400,2600,"Sub-basin 3"
9637,1300,114,3500,4800,"Sub-basin 3"
9638,200,4,700,900,"Sub-basin 3"
9639,3800,326,10600,14400,"Sub-basin 3"
9640,3100,304,11200,14300,"Sub-basin 3"
9641,200,2,3600,3800,"Sub-basin 3"
9642,400,28,1700,2100,"Sub-basin 3"
9643,200,3,2100,2300,"Sub-basin 3"
9644,200,10,3800,4000,"Sub-basin 3"
9645,100,2,2700,2800,"Sub-basin 3"
9646,600,8,6700,7300,"Sub-basin 3"
9647,100,2,1200,1300,"Sub-basin 3"
9648,12000,1674,17800,29800,"Sub-basin 3"
9649,1300,155,7000,8300,"Sub-basin 3"
9650,400,14,4500,4900,"Sub-basin 3"
9651,100,4,2700,2800,"Sub-basin 3"
9652,100,4,1200,1300,"Sub-basin 3"
9653,100,6,700,800,"Sub-basin 3"
9654,600,64,3100,3700,"Sub-basin 3"
9655,1300,51,4400,5700,"Sub-basin 3"
9656,1200,119,7100,8300,"Sub-basin 3"
9657,400,19,2000,2400,"Sub-basin 3"
9658,2100,249,6200,8300,"Sub-basin 3"
9659,700,30,2300,3000,"Sub-basin 3"
9660,900,92,3600,4500,"Sub-basin 3"
9661,200,3,2100,2300,"Sub-basin 3"
9662,300,7,1900,2200,"Sub-basin 3"
9663,100,4,1200,1300,"Sub-basin 3"
9664,100,2,1900,2000,"Sub-basin 3"
9665,100,2,800,900,"Sub-basin 3"
9666,200,6,2600,2800,"Sub-basin 3"
9667,100,1,1700,1800,"Sub-basin 3"
9668,100,3,1400,1500,"Sub-basin 3"
9669,100,2,2200,2300,"Sub-basin 3"
9670,3500,335.67,15600,19100,"Sub-basin 3"
9671,1000,68,11200,12200,"Sub-basin 3"
9672,800,62,7200,8000,"Sub-basin 3"
9673,1100,18,21900,23000,"Sub-basin 3"
9674,100,1,1300,1400,"Sub-basin 3"
9675,200,2,4100,4300,"Sub-basin 3"
9676,100,4,1200,1300,"Sub-basin 3"
9677,300,14,3800,4100,"Sub-basin 3"
9678,500,28,4300,4800,"Sub-basin 3"
9679,500,48,2100,2600,"Sub-basin 3"
9680,200,7,600,800,"Sub-basin 3"
9681,1800,329,3900,5700,"Sub-basin 3"
9682,2300,178,6400,8700,"Sub-basin 3"
9683,1000,131,1700,2700,"Sub-basin 3"
9684,400,25,3100,3500,"Sub-basin 3"
9685,100,3,1700,1800,"Sub-basin 3"
9686,1800,81,17600,19400,"Sub-basin 3"
9687,800,15,12700,13500,"Sub-basin 3"
9688,100,1,3000,3100,"Sub-basin 3"
9689,300,5,4600,4900,"Sub-basin 3"
9690,100,3.0017,1800,1900,"Sub-basin 3"
9691,500,14,1700,2200,"Sub-basin 3"
9692,300,9,1500,1800,"Sub-basin 3"
9693,4000,711,12200,16200,"Sub-basin 3"
9694,100,1,200,300,"Sub-basin 3"
9695,100,1,1300,1400,"Sub-basin 3"
9696,2200,142,9500,11700,"Sub-basin 3"
9697,300,35,1400,1700,"Sub-basin 3"
9698,3100,1326,3700,6800,"Sub-basin 3"
9699,100,5,1300,1400,"Sub-basin 3"
9700,3600,340,21100,24700,"Sub-basin 3"
9701,3200,198,16400,19600,"Sub-basin 3"
9702,100,3,1900,2000,"Sub-basin 3"
9703,400,10,4600,5000,"Sub-basin 3"
9704,100,5,1000,1100,"Sub-basin 3"
9705,100,2,1000,1100,"Sub-basin 3"
9706,3100,860,6800,9900,"Sub-basin 3"
9707,1200,312,4400,5600,"Sub-basin 3"
9708,500,13,4900,5400,"Sub-basin 3"
9709,7000,1125,10500,17500,"Sub-basin 3"
9710,1900,229,4600,6500,"Sub-basin 3"
9711,800,89,2100,2900,"Sub-basin 3"
9712,200,10,2300,2500,"Sub-basin 3"
9713,100,3,2400,2500,"Sub-basin 3"
9714,100,5,2100,2200,"Sub-basin 3"
9715,200,4,2000,2200,"Sub-basin 3"
9716,400,24,4000,4400,"Sub-basin 3"
9717,500,16,3100,3600,"Sub-basin 3"
9718,100,4,500,600,"Sub-basin 3"
9719,2700,567,4100,6800,"Sub-basin 3"
9720,100,2,1200,1300,"Sub-basin 3"
9721,200,16,3400,3600,"Sub-basin 3"
9722,800,67,2900,3700,"Sub-basin 3"
9723,300,10,2700,3000,"Sub-basin 3"
9724,100,1,2600,2700,"Sub-basin 3"
9725,800,31,9000,9800,"Sub-basin 3"
9726,300,8,4500,4800,"Sub-basin 3"
9727,400,27,2200,2600,"Sub-basin 3"
9728,500,8,4800,5300,"Sub-basin 3"
9729,200,2,2200,2400,"Sub-basin 3"
9730,4200,678,7500,11700,"Sub-basin 3"
9731,6900,827,17200,24100,"Sub-basin 3"
9732,100,1,1500,1600,"Sub-basin 3"
9733,5400,2127,9100,14500,"Sub-basin 3"
9734,600,40,4300,4900,"Sub-basin 3"
9735,500,33,1600,2100,"Sub-basin 3"
9736,100,2,900,1000,"Sub-basin 3"
9737,200,3,2200,2400,"Sub-basin 3"
9738,300,5,1400,1700,"Sub-basin 3"
9739,1000,340,7100,8100,"Sub-basin 3"
9740,900,56,6300,7200,"Sub-basin 3"
9741,3700,399,31000,34700,"Sub-basin 3"
9742,100,1,4800,4900,"Sub-basin 3"
9743,100,1,1700,1800,"Sub-basin 3"
9744,100,2,2000,2100,"Sub-basin 3"
9745,100,2,2000,2100,"Sub-basin 3"
9746,100,1,1800,1900,"Sub-basin 3"
9747,100,1,400,500,"Sub-basin 3"
9748,100,1.0011,1900,2000,"Sub-basin 3"
9749,400,18,2400,2800,"Sub-basin 3"
9750,600,42,5400,6000,"Sub-basin 3"
9751,200,9,300,500,"Sub-basin 3"
9752,100,1,800,900,"Sub-basin 3"
9753,600,44,2000,2600,"Sub-basin 3"
9754,200,6,900,1100,"Sub-basin 3"
9755,900,47,5200,6100,"Sub-basin 3"
9756,100,1,1900,2000,"Sub-basin 3"
9757,200,9,2100,2300,"Sub-basin 3"
9758,200,2,200,400,"Sub-basin 3"
9759,300,3,3600,3900,"Sub-basin 3"
9760,300,17,3100,3400,"Sub-basin 3"
9761,200,4,3200,3400,"Sub-basin 3"
9762,100,1,3900,4000,"Sub-basin 3"
9763,100,1,3200,3300,"Sub-basin 3"
9764,300,11,4200,4500,"Sub-basin 3"
9765,400,8,3700,4100,"Sub-basin 3"
9766,100,4,100,200,"Sub-basin 3"
9767,400,51,2300,2700,"Sub-basin 3"
9768,3500,2079,5400,8900,"Sub-basin 3"
9769,500,23,6300,6800,"Sub-basin 3"
9770,1100,104,7200,8300,"Sub-basin 3"
9771,700,53,7100,7800,"Sub-basin 3"
9772,100,1,800,900,"Sub-basin 3"
9773,500,12,8500,9000,"Sub-basin 3"
9774,200,4,1800,2000,"Sub-basin 3"
9775,300,3,3500,3800,"Sub-basin 3"
9776,4500,498,14300,18800,"Sub-basin 3"
9777,200,3,2300,2500,"Sub-basin 3"
9778,300,40,3800,4100,"Sub-basin 3"
9779,100,1.0071,1300,1400,"Sub-basin 3"
9780,1000,142,3100,4100,"Sub-basin 3"
9781,900,226,2700,3600,"Sub-basin 3"
9782,200,6,1900,2100,"Sub-basin 3"
9783,100,2,1400,1500,"Sub-basin 3"
9784,700,48,2300,3000,"Sub-basin 3"
9785,1300,138,1100,2400,"Sub-basin 3"
9786,100,2,1600,1700,"Sub-basin 3"
9787,100,1,700,800,"Sub-basin 3"
9788,400,6,5900,6300,"Sub-basin 3"
9789,200,4,2400,2600,"Sub-basin 3"
9790,200,4,2200,2400,"Sub-basin 3"
9791,200,5,4700,4900,"Sub-basin 3"
9792,800,123,4000,4800,"Sub-basin 3"
9793,13500,2169,28600,42100,"Sub-basin 3"
9794,100,1,100,200,"Sub-basin 3"
9795,500,35,1900,2400,"Sub-basin 3"
9796,1100,129,1400,2500,"Sub-basin 3"
9797,6500,1096,15400,21900,"Sub-basin 3"
9798,200,10,2200,2400,"Sub-basin 3"
9799,200,5,3100,3300,"Sub-basin 3"
9800,100,2,1800,1900,"Sub-basin 3"
9801,200,3,4400,4600,"Sub-basin 3"
9802,100,1,900,1000,"Sub-basin 3"
9803,300,5,1000,1300,"Sub-basin 3"
9804,600,62,2900,3500,"Sub-basin 3"
9805,100,1,1000,1100,"Sub-basin 3"
9806,800,24.0299,5800,6600,"Sub-basin 3"
9807,100,1,700,800,"Sub-basin 3"
9808,9200,2998,13600,22800,"Sub-basin 3"
9809,100,1,300,400,"Sub-basin 3"
9810,1900,830,3200,5100,"Sub-basin 3"
9811,200,12,1400,1600,"Sub-basin 3"
9812,600,18,4700,5300,"Sub-basin 3"
9813,200,4,500,700,"Sub-basin 3"
9814,1600,68,17800,19400,"Sub-basin 3"
9815,100,2,900,1000,"Sub-basin 3"
9816,300,4,3600,3900,"Sub-basin 3"
9817,100,4,1500,1600,"Sub-basin 3"
9818,600,35,5100,5700,"Sub-basin 3"
9819,100,1,3000,3100,"Sub-basin 3"
9820,100,2,2200,2300,"Sub-basin 3"
9821,200,3,4300,4500,"Sub-basin 3"
9822,100,1,800,900,"Sub-basin 3"
9823,3700,972,6300,10000,"Sub-basin 3"
9824,1500,185,2900,4400,"Sub-basin 3"
9825,19700,5895,16800,36500,"Sub-basin 3"
9826,200,5,1100,1300,"Sub-basin 3"
9827,100,1,2100,2200,"Sub-basin 3"
9828,100,1,3800,3900,"Sub-basin 3"
9829,500,6,11700,12200,"Sub-basin 3"
9830,100,1,2900,3000,"Sub-basin 3"
9831,100,1,900,1000,"Sub-basin 3"
9832,700,26,8300,9000,"Sub-basin 3"
9833,100,4,1600,1700,"Sub-basin 3"
9834,100,2,1200,1300,"Sub-basin 3"
9835,300,25,1600,1900,"Sub-basin 3"
9836,400,53,2200,2600,"Sub-basin 3"
9837,400,73,500,900,"Sub-basin 3"
9838,1400,288,1700,3100,"Sub-basin 3"
9839,1100,98,2900,4000,"Sub-basin 3"
9840,300,32,800,1100,"Sub-basin 3"
9841,200,5,1300,1500,"Sub-basin 3"
9842,200,17,1600,1800,"Sub-basin 3"
9843,100,1,2000,2100,"Sub-basin 3"
9844,200,8,2200,2400,"Sub-basin 3"
9845,1000,54,12200,13200,"Sub-basin 3"
9846,100,1,2000,2100,"Sub-basin 3"
9847,100,1,2100,2200,"Sub-basin 3"
9848,600,14,9300,9900,"Sub-basin 3"
9849,200,5,3400,3600,"Sub-basin 3"
9850,400,21,3400,3800,"Sub-basin 3"
9851,700,12,7300,8000,"Sub-basin 3"
9852,5000,220,16400,21400,"Sub-basin 3"
9853,900,49,3900,4800,"Sub-basin 3"
9854,400,70,3500,3900,"Sub-basin 3"
9855,100,1,800,900,"Sub-basin 3"
9856,500,21,400,900,"Sub-basin 3"
9857,100,1,1900,2000,"Sub-basin 3"
9858,1100,122,5800,6900,"Sub-basin 3"
9859,200,5,1500,1700,"Sub-basin 3"
9860,200,8,4000,4200,"Sub-basin 3"
9861,100,2,1200,1300,"Sub-basin 3"
9862,100,1,2300,2400,"Sub-basin 3"
9863,100,2,1200,1300,"Sub-basin 3"
9864,100,1,1000,1100,"Sub-basin 3"
9865,100,1,1100,1200,"Sub-basin 3"
9866,2700,454,5600,8300,"Sub-basin 3"
9867,100,1,1600,1700,"Sub-basin 3"
9868,3800,2158,4800,8600,"Sub-basin 3"
9869,900,149.34,3200,4100,"Sub-basin 3"
9870,1000,67,6900,7900,"Sub-basin 3"
9871,300,9,3600,3900,"Sub-basin 3"
9872,100,8,1100,1200,"Sub-basin 3"
9873,900,164,5200,6100,"Sub-basin 3"
9874,100,1,3200,3300,"Sub-basin 3"
9875,100,1,1000,1100,"Sub-basin 3"
9876,1900,416,7900,9800,"Sub-basin 3"
9877,300,33,2400,2700,"Sub-basin 3"
9878,100,6,1800,1900,"Sub-basin 3"
9879,200,4,3400,3600,"Sub-basin 3"
9880,100,1,1400,1500,"Sub-basin 3"
9881,200,4,3000,3200,"Sub-basin 3"
9882,3200,317,11200,14400,"Sub-basin 3"
9883,500,65,2000,2500,"Sub-basin 3"
9884,5900,2102,7800,13700,"Sub-basin 3"
9885,200,13,1800,2000,"Sub-basin 3"
9886,100,1,1600,1700,"Sub-basin 3"
9887,100,1,1100,1200,"Sub-basin 3"
9888,100,2,1000,1100,"Sub-basin 3"
9889,3300,187,17500,20800,"Sub-basin 3"
9890,400,16,4300,4700,"Sub-basin 3"
9891,100,1,1800,1900,"Sub-basin 3"
9892,500,10.0112,5600,6100,"Sub-basin 3"
9893,1000,283,1400,2400,"Sub-basin 3"
9894,500,43,2400,2900,"Sub-basin 3"
9895,2600,293,8700,11300,"Sub-basin 3"
9896,10000,2288,16700,26700,"Sub-basin 3"
9897,500,30,1200,1700,"Sub-basin 3"
9898,200,5,1600,1800,"Sub-basin 3"
9899,100,3,1300,1400,"Sub-basin 3"
9900,200,2,2100,2300,"Sub-basin 3"
9901,100,5,1200,1300,"Sub-basin 3"
9902,8300,858,53500,61800,"Sub-basin 3"
9903,600,31,4600,5200,"Sub-basin 3"
9904,100,1,3200,3300,"Sub-basin 3"
9905,100,1,1800,1900,"Sub-basin 3"
9906,500,22,4500,5000,"Sub-basin 3"
9907,800,164,1400,2200,"Sub-basin 3"
9908,800,68,4900,5700,"Sub-basin 3"
9909,400,9,600,1000,"Sub-basin 3"
9910,1600,137,3700,5300,"Sub-basin 3"
9911,600,47,2000,2600,"Sub-basin 3"
9912,3900,358,23000,26900,"Sub-basin 3"
9913,100,2,1200,1300,"Sub-basin 3"
9914,200,3,4600,4800,"Sub-basin 3"
9915,400,10,3200,3600,"Sub-basin 3"
9916,300,5,2400,2700,"Sub-basin 3"
9917,100,5,1800,1900,"Sub-basin 3"
9918,600,45,5100,5700,"Sub-basin 3"
9919,100,1,900,1000,"Sub-basin 3"
9920,100,4,1800,1900,"Sub-basin 3"
9921,1000,67,6600,7600,"Sub-basin 3"
9922,100,1,400,500,"Sub-basin 3"
9923,500,35,7400,7900,"Sub-basin 3"
9924,100,1,2500,2600,"Sub-basin 3"
9925,800,99,3700,4500,"Sub-basin 3"
9926,1500,560,3200,4700,"Sub-basin 3"
9927,1100,53,4400,5500,"Sub-basin 3"
9928,100,0.5,1300,1400,"Sub-basin 3"
9929,500,16,5700,6200,"Sub-basin 3"
9930,1700,90,9000,10700,"Sub-basin 3"
9931,100,2,2700,2800,"Sub-basin 3"
9932,2400,125,6700,9100,"Sub-basin 3"
9933,7500,2838,6900,14400,"Sub-basin 3"
9934,2800,283,11400,14200,"Sub-basin 3"
9935,1100,40,8700,9800,"Sub-basin 3"
9936,6600,782,19900,26500,"Sub-basin 3"
9937,3600,558,10000,13600,"Sub-basin 3"
9938,100,2,600,700,"Sub-basin 3"
9939,100,1,1700,1800,"Sub-basin 3"
9940,100,1,4300,4400,"Sub-basin 3"
9941,1400,459,2600,4000,"Sub-basin 3"
9942,2100,385,4700,6800,"Sub-basin 3"
9943,200,8,1700,1900,"Sub-basin 3"
9944,200,4,2600,2800,"Sub-basin 3"
9945,400,23,4500,4900,"Sub-basin 3"
9946,100,3,600,700,"Sub-basin 3"
9947,300,8,5300,5600,"Sub-basin 3"
9948,600,45,4600,5200,"Sub-basin 3"
9949,100,1,1800,1900,"Sub-basin 3"
9950,200,3,1400,1600,"Sub-basin 3"
9951,400,9,2300,2700,"Sub-basin 3"
9952,700,46,3000,3700,"Sub-basin 3"
9953,1000,44,5300,6300,"Sub-basin 3"
9954,1700,379,4100,5800,"Sub-basin 3"
9955,2300,374,5900,8200,"Sub-basin 3"
9956,5400,583,12300,17700,"Sub-basin 3"
9957,1200,120,5900,7100,"Sub-basin 3"
9958,3000,300,11800,14800,"Sub-basin 3"
9959,500,18,6400,6900,"Sub-basin 3"
9960,100,1,1900,2000,"Sub-basin 3"
9961,1100,120,6700,7800,"Sub-basin 3"
9962,1000,139,7800,8800,"Sub-basin 3"
9963,100,1,2200,2300,"Sub-basin 3"
9964,200,16,1000,1200,"Sub-basin 3"
9965,300,7,3400,3700,"Sub-basin 3"
9966,300,5,2300,2600,"Sub-basin 3"
9967,100,3,500,600,"Sub-basin 3"
9968,300,15,1100,1400,"Sub-basin 3"
9969,100,1,900,1000,"Sub-basin 3"
9970,100,2,1600,1700,"Sub-basin 3"
9971,4900,1905,10300,15200,"Sub-basin 3"
9972,4700,391,14100,18800,"Sub-basin 3"
9973,100,1,1300,1400,"Sub-basin 3"
9974,200,7,1900,2100,"Sub-basin 3"
9975,600,49,2900,3500,"Sub-basin 3"
9976,300,19,3900,4200,"Sub-basin 3"
9977,100,2,800,900,"Sub-basin 3"
9978,800,211,5900,6700,"Sub-basin 3"
9979,300,15,2600,2900,"Sub-basin 3"
9980,200,7,3200,3400,"Sub-basin 3"
9981,900,69,8300,9200,"Sub-basin 3"
9982,100,7,900,1000,"Sub-basin 3"
9983,100,1,2100,2200,"Sub-basin 3"
9984,200,6,1500,1700,"Sub-basin 3"
9985,400,8.0139,2900,3300,"Sub-basin 3"
9986,100,2.0006,500,600,"Sub-basin 3"
9987,3400,356,7700,11100,"Sub-basin 3"
9988,100,15,1300,1400,"Sub-basin 3"
9989,100,7,1000,1100,"Sub-basin 3"
9990,100,4,1300,1400,"Sub-basin 3"
9991,700,94,2500,3200,"Sub-basin 3"
9992,200,6,400,600,"Sub-basin 3"
9993,200,5,1200,1400,"Sub-basin 3"
9994,200,5,2000,2200,"Sub-basin 3"
9995,900,39,5100,6000,"Sub-basin 3"
9996,200,3,2200,2400,"Sub-basin 3"
9997,100,1,1000,1100,"Sub-basin 3"
9998,500,46,4100,4600,"Sub-basin 3"
9999,600,28,6600,7200,"Sub-basin 3"
10000,1700,147,7300,9000,"Sub-basin 3"
10001,100,1,200,300,"Sub-basin 3"
10002,200,4,3300,3500,"Sub-basin 3"
10003,1800,127,4700,6500,"Sub-basin 3"
10004,1000,89,2600,3600,"Sub-basin 3"
10005,6100,1580,5300,11400,"Sub-basin 3"
10006,100,4,800,900,"Sub-basin 3"
10007,200,13,1400,1600,"Sub-basin 3"
10008,500,8,4200,4700,"Sub-basin 3"
10009,500,35,4900,5400,"Sub-basin 3"
10010,1300,225,9200,10500,"Sub-basin 3"
10011,2000,475,3900,5900,"Sub-basin 3"
10012,10100,2529,16500,26600,"Sub-basin 3"
10013,700,75,4100,4800,"Sub-basin 3"
10014,100,2,1500,1600,"Sub-basin 3"
10015,100,1,2300,2400,"Sub-basin 3"
10016,100,2,1300,1400,"Sub-basin 3"
10017,800,49,3900,4700,"Sub-basin 3"
10018,300,6,3600,3900,"Sub-basin 3"
10019,400,13.007,4600,5000,"Sub-basin 3"
10020,3700,98.0629,23600,27300,"Sub-basin 3"
10021,2200,57.0926,16500,18700,"Sub-basin 3"
10022,400,15,3600,4000,"Sub-basin 3"
10023,400,19,2700,3100,"Sub-basin 3"
10024,300,5,900,1200,"Sub-basin 3"
10025,100,2,1500,1600,"Sub-basin 3"
10026,100,1,700,800,"Sub-basin 3"
10027,200,9,1600,1800,"Sub-basin 3"
10028,200,5,1300,1500,"Sub-basin 3"
10029,800,13.0244,7800,8600,"Sub-basin 3"
10030,400,24.0027,4200,4600,"Sub-basin 3"
10031,800,139,1500,2300,"Sub-basin 3"
10032,10400,5391,16300,26700,"Sub-basin 3"
10033,2100,910,2700,4800,"Sub-basin 3"
10034,300,19,2300,2600,"Sub-basin 3"
10035,100,4,1900,2000,"Sub-basin 3"
10036,200,4,1100,1300,"Sub-basin 3"
10037,400,11,3400,3800,"Sub-basin 3"
10038,500,12,5600,6100,"Sub-basin 3"
10039,700,54,4300,5000,"Sub-basin 3"
10040,100,3,2000,2100,"Sub-basin 3"
10041,500,30,6100,6600,"Sub-basin 3"
10042,600,45,4800,5400,"Sub-basin 3"
10043,900,21.0076,5800,6700,"Sub-basin 3"
10044,200,9,800,1000,"Sub-basin 3"
10045,600,37,800,1400,"Sub-basin 3"
10046,500,52,1000,1500,"Sub-basin 3"
10047,400,30,2300,2700,"Sub-basin 3"
10048,1000,150,4600,5600,"Sub-basin 3"
10049,2200,214.41,4300,6500,"Sub-basin 3"
10050,500,5,5500,6000,"Sub-basin 3"
10051,100,2,1900,2000,"Sub-basin 3"
10052,300,21,1500,1800,"Sub-basin 3"
10053,200,4.0012,2600,2800,"Sub-basin 3"
10054,8000,1495,17300,25300,"Sub-basin 3"
10055,300,9,1300,1600,"Sub-basin 3"
10056,600,46,5300,5900,"Sub-basin 3"
10057,500,72,1900,2400,"Sub-basin 3"
10058,26500,12482.15,14700,41200,"Sub-basin 3"
10059,2000,71,15900,17900,"Sub-basin 3"
10060,300,9,800,1100,"Sub-basin 3"
10061,600,20,1700,2300,"Sub-basin 3"
10062,1500,217,4100,5600,"Sub-basin 3"
10063,1000,50,4900,5900,"Sub-basin 3"
10064,100,4,800,900,"Sub-basin 3"
10065,400,9,3900,4300,"Sub-basin 3"
10066,100,2,1200,1300,"Sub-basin 3"
10067,100,2.0022,1500,1600,"Sub-basin 3"
10068,3900,660,11700,15600,"Sub-basin 3"
10069,100,1,1300,1400,"Sub-basin 3"
10070,400,16,2300,2700,"Sub-basin 3"
10071,1600,101,12400,14000,"Sub-basin 3"
10072,100,5,1700,1800,"Sub-basin 3"
10073,100,1,2200,2300,"Sub-basin 3"
10074,400,15,3200,3600,"Sub-basin 3"
10075,500,14,2400,2900,"Sub-basin 3"
10076,100,2,800,900,"Sub-basin 3"
10077,200,4,1600,1800,"Sub-basin 3"
10078,100,1,1200,1300,"Sub-basin 3"
10079,1300,61,2700,4000,"Sub-basin 3"
10080,5800,1495,6200,12000,"Sub-basin 3"
10081,1500,255,4000,5500,"Sub-basin 3"
10082,13800,4429,17900,31700,"Sub-basin 3"
10083,100,2,800,900,"Sub-basin 3"
10084,5900,547,23400,29300,"Sub-basin 3"
10085,6100,940,11500,17600,"Sub-basin 3"
10086,1400,241,7000,8400,"Sub-basin 3"
10087,100,1,1600,1700,"Sub-basin 3"
10088,100,1.0027,2300,2400,"Sub-basin 3"
10089,3500,368,10300,13800,"Sub-basin 3"
10090,200,3,300,500,"Sub-basin 3"
10091,600,30,3000,3600,"Sub-basin 3"
10092,200,3,2800,3000,"Sub-basin 3"
10093,100,1,1400,1500,"Sub-basin 3"
10094,7600,2186,17600,25200,"Sub-basin 3"
10095,800,82,2100,2900,"Sub-basin 3"
10096,9900,4342,5900,15800,"Sub-basin 3"
10097,1800,194,7800,9600,"Sub-basin 3"
10098,600,70,1200,1800,"Sub-basin 3"
10099,1400,250,7500,8900,"Sub-basin 3"
10100,600,11,8800,9400,"Sub-basin 3"
10101,200,5,2500,2700,"Sub-basin 3"
10102,200,4.0072,1900,2100,"Sub-basin 3"
10103,100,1,1700,1800,"Sub-basin 3"
10104,3800,811,5500,9300,"Sub-basin 3"
10105,3900,275,12600,16500,"Sub-basin 3"
10106,100,5,700,800,"Sub-basin 3"
10107,100,1,1100,1200,"Sub-basin 3"
10108,100,2,1400,1500,"Sub-basin 3"
10109,100,4.0023,700,800,"Sub-basin 3"
10110,1700,183,4400,6100,"Sub-basin 3"
10111,1600,399,3900,5500,"Sub-basin 3"
10112,100,1,800,900,"Sub-basin 3"
10113,700,29,8200,8900,"Sub-basin 3"
10114,100,1.0014,300,400,"Sub-basin 3"
10115,100,1,1800,1900,"Sub-basin 3"
10116,30500,10072,28200,58700,"Sub-basin 3"
10117,200,10,1200,1400,"Sub-basin 3"
10118,600,96,1800,2400,"Sub-basin 3"
10119,6300,1146,12300,18600,"Sub-basin 3"
10120,100,1,1400,1500,"Sub-basin 3"
10121,100,6.0022,700,800,"Sub-basin 3"
10122,9300,4457,7300,16600,"Sub-basin 3"
10123,23500,10170.65,25900,49400,"Sub-basin 3"
10124,800,59,1400,2200,"Sub-basin 3"
10125,1600,104,8800,10400,"Sub-basin 3"
10126,100,1,1500,1600,"Sub-basin 3"
10127,3100,1067,8800,11900,"Sub-basin 3"
10128,1200,140,4200,5400,"Sub-basin 3"
10129,100,1,1500,1600,"Sub-basin 3"
10130,1600,209,4300,5900,"Sub-basin 3"
10131,800,59,2400,3200,"Sub-basin 3"
10132,100,2,1200,1300,"Sub-basin 3"
10133,300,9,2300,2600,"Sub-basin 3"
10134,100,3,1700,1800,"Sub-basin 3"
10135,800,29,7800,8600,"Sub-basin 3"
10136,300,11,3100,3400,"Sub-basin 3"
10137,300,4.0107,1500,1800,"Sub-basin 3"
10138,100,1,300,400,"Sub-basin 3"
10139,100,1,800,900,"Sub-basin 3"
10140,2000,251,3700,5700,"Sub-basin 3"
10141,1400,220,4000,5400,"Sub-basin 3"
10142,1400,304,3000,4400,"Sub-basin 3"
10143,1600,224,8100,9700,"Sub-basin 3"
10144,200,3,2200,2400,"Sub-basin 3"
10145,3100,478,5600,8700,"Sub-basin 3"
10146,9300,2904,16300,25600,"Sub-basin 3"
10147,300,43,1000,1300,"Sub-basin 3"
10148,1100,77,6600,7700,"Sub-basin 3"
10149,500,51,3300,3800,"Sub-basin 3"
10150,100,2,900,1000,"Sub-basin 3"
10151,2000,93,12500,14500,"Sub-basin 3"
10152,400,71,1100,1500,"Sub-basin 3"
10153,600,76,2000,2600,"Sub-basin 3"
10154,800,145,1300,2100,"Sub-basin 3"
10155,500,30,1500,2000,"Sub-basin 3"
10156,500,20,3700,4200,"Sub-basin 3"
10157,300,11,900,1200,"Sub-basin 3"
10158,5000,817,13300,18300,"Sub-basin 3"
10159,400,30,2600,3000,"Sub-basin 3"
10160,300,12,900,1200,"Sub-basin 3"
10161,600,19,1600,2200,"Sub-basin 3"
10162,200,6,2600,2800,"Sub-basin 3"
10163,4500,960,6100,10600,"Sub-basin 3"
10164,700,116,3100,3800,"Sub-basin 3"
10165,3200,326,21200,24400,"Sub-basin 3"
10166,300,15,4600,4900,"Sub-basin 3"
10167,100,3,1800,1900,"Sub-basin 3"
10168,500,15,6800,7300,"Sub-basin 3"
10169,200,4,2300,2500,"Sub-basin 3"
10170,100,4,1200,1300,"Sub-basin 3"
10171,400,20,1700,2100,"Sub-basin 3"
10172,900,93,3500,4400,"Sub-basin 3"
10173,700,34,4000,4700,"Sub-basin 3"
10174,1100,146,4000,5100,"Sub-basin 3"
10175,1700,345,5600,7300,"Sub-basin 3"
10176,900,89.5,2200,3100,"Sub-basin 3"
10177,2000,204,4000,6000,"Sub-basin 3"
10178,4000,277,12900,16900,"Sub-basin 3"
10179,2400,400,6200,8600,"Sub-basin 3"
10180,600,30,3400,4000,"Sub-basin 3"
10181,1100,59,7200,8300,"Sub-basin 3"
10182,300,15,1200,1500,"Sub-basin 3"
10183,900,77,5900,6800,"Sub-basin 3"
10184,1100,85,3900,5000,"Sub-basin 3"
10185,5200,1029,7300,12500,"Sub-basin 3"
10186,2600,801,3800,6400,"Sub-basin 3"
10187,700,159,5100,5800,"Sub-basin 3"
10188,100,4,2000,2100,"Sub-basin 3"
10189,100,2,1600,1700,"Sub-basin 3"
10190,100,5,800,900,"Sub-basin 3"
10191,400,13,4500,4900,"Sub-basin 3"
10192,800,69,4100,4900,"Sub-basin 3"
10193,700,59,2400,3100,"Sub-basin 3"
10194,1200,106,5500,6700,"Sub-basin 3"
10195,3100,346,10900,14000,"Sub-basin 3"
10196,700,55,1500,2200,"Sub-basin 3"
10197,200,3,1000,1200,"Sub-basin 3"
10198,100,1,1600,1700,"Sub-basin 3"
10199,1000,67,8700,9700,"Sub-basin 3"
10200,100,1,600,700,"Sub-basin 3"
10201,300,19,2300,2600,"Sub-basin 3"
10202,200,7,1700,1900,"Sub-basin 3"
10203,100,5,1300,1400,"Sub-basin 3"
10204,3400,885,2800,6200,"Sub-basin 3"
10205,1900,279,16000,17900,"Sub-basin 3"
10206,800,81,1800,2600,"Sub-basin 3"
10207,100,2,400,500,"Sub-basin 3"
10208,2100,262,2900,5000,"Sub-basin 3"
10209,10400,2850.49,9700,20100,"Sub-basin 3"
10210,500,12,4300,4800,"Sub-basin 3"
10211,400,15,2100,2500,"Sub-basin 3"
10212,1400,76,7900,9300,"Sub-basin 3"
10213,1400,223,4600,6000,"Sub-basin 3"
10214,100,2,600,700,"Sub-basin 3"
10215,2200,277,11300,13500,"Sub-basin 3"
10216,100,2,800,900,"Sub-basin 3"
10217,5000,1069,8200,13200,"Sub-basin 3"
10218,100,1,1200,1300,"Sub-basin 3"
10219,800,63,3300,4100,"Sub-basin 3"
10220,600,50,1800,2400,"Sub-basin 3"
10221,100,1,1100,1200,"Sub-basin 3"
10222,400,45,1300,1700,"Sub-basin 3"
10223,100,2,1100,1200,"Sub-basin 3"
10224,100,2,1800,1900,"Sub-basin 3"
10225,700,184,1300,2000,"Sub-basin 3"
10226,2000,530,4200,6200,"Sub-basin 3"
10227,15700,1838,34500,50200,"Sub-basin 3"
10228,100,3,1900,2000,"Sub-basin 3"
10229,100,2,300,400,"Sub-basin 3"
10230,800,67,4300,5100,"Sub-basin 3"
10231,200,4,700,900,"Sub-basin 3"
10232,300,11,800,1100,"Sub-basin 3"
10233,100,3,1700,1800,"Sub-basin 3"
10234,200,3,1500,1700,"Sub-basin 3"
10235,6900,1044,7700,14600,"Sub-basin 3"
10236,200,6,1400,1600,"Sub-basin 3"
10237,800,78,2700,3500,"Sub-basin 3"
10238,200,4,2700,2900,"Sub-basin 3"
10239,5600,1274,7500,13100,"Sub-basin 3"
10240,500,79,2400,2900,"Sub-basin 3"
10241,700,39,1800,2500,"Sub-basin 3"
10242,3800,893,7500,11300,"Sub-basin 3"
10243,600,79,3000,3600,"Sub-basin 3"
10244,400,19,800,1200,"Sub-basin 3"
10245,100,1,400,500,"Sub-basin 3"
10246,100,2,1800,1900,"Sub-basin 3"
10247,100,2,300,400,"Sub-basin 3"
10248,1700,305,4500,6200,"Sub-basin 3"
10249,4800,689,8000,12800,"Sub-basin 3"
10250,1000,69,1900,2900,"Sub-basin 3"
10251,100,2,1500,1600,"Sub-basin 3"
10252,7600,1832,8700,16300,"Sub-basin 3"
10253,3700,1217,6400,10100,"Sub-basin 3"
10254,400,15,3100,3500,"Sub-basin 3"
10255,1200,208,3400,4600,"Sub-basin 3"
10256,100,1,600,700,"Sub-basin 3"
10257,500,15,2300,2800,"Sub-basin 3"
10258,1700,202,5200,6900,"Sub-basin 3"
10259,100,5,900,1000,"Sub-basin 3"
10260,100,2,1600,1700,"Sub-basin 3"
10261,500,14,800,1300,"Sub-basin 3"
10262,1500,117,10300,11800,"Sub-basin 3"
10263,800,63,300,1100,"Sub-basin 3"
10264,300,23,1500,1800,"Sub-basin 3"
10265,4000,909,4800,8800,"Sub-basin 3"
10266,2400,183,11400,13800,"Sub-basin 3"
10267,2100,412,2200,4300,"Sub-basin 3"
10268,900,41,4800,5700,"Sub-basin 3"
10269,200,5,800,1000,"Sub-basin 3"
10270,100,2,1100,1200,"Sub-basin 3"
10271,200,9.17,300,500,"Sub-basin 3"
10272,2700,516,2300,5000,"Sub-basin 3"
10273,200,7,400,600,"Sub-basin 3"
10274,2300,341,2400,4700,"Sub-basin 3"
10275,400,36,500,900,"Sub-basin 3"
10276,100,3,600,700,"Sub-basin 3"
10277,2200,309,6400,8600,"Sub-basin 3"
10278,2500,359,2300,4800,"Sub-basin 3"
10279,1000,134,2200,3200,"Sub-basin 3"
10280,2800,598,4400,7200,"Sub-basin 3"
10281,100,2,900,1000,"Sub-basin 3"
10282,200,26,200,400,"Sub-basin 3"
1,800,111,1900,2700,"Sub-basin 4"
2,200,20,1100,1300,"Sub-basin 4"
3,9800,5139,12600,22400,"Sub-basin 4"
4,70300,24882.84,68800,139100,"Sub-basin 4"
5,1000,308,1200,2200,"Sub-basin 4"
6,200,22,100,300,"Sub-basin 4"
7,400,151,900,1300,"Sub-basin 4"
8,100,2,1100,1200,"Sub-basin 4"
9,5600,2480,7700,13300,"Sub-basin 4"
10,1100,212,1000,2100,"Sub-basin 4"
11,300,22,1700,2000,"Sub-basin 4"
12,100,4,800,900,"Sub-basin 4"
13,600,217,4600,5200,"Sub-basin 4"
14,800,134,5000,5800,"Sub-basin 4"
15,2000,880,8500,10500,"Sub-basin 4"
16,2100,721.07,3500,5600,"Sub-basin 4"
17,400,74,1700,2100,"Sub-basin 4"
18,900,136,2100,3000,"Sub-basin 4"
19,400,43,2100,2500,"Sub-basin 4"
20,1000,216,4900,5900,"Sub-basin 4"
21,2300,772,4600,6900,"Sub-basin 4"
22,500,109,2700,3200,"Sub-basin 4"
23,900,269,4500,5400,"Sub-basin 4"
24,900,244,5500,6400,"Sub-basin 4"
25,1400,512,3000,4400,"Sub-basin 4"
26,7500,1022,23600,31100,"Sub-basin 4"
27,1800,505,6900,8700,"Sub-basin 4"
28,100,4,0,100,"Sub-basin 4"
29,400,54,2300,2700,"Sub-basin 4"
30,3600,2711.2316,6600,10200,"Sub-basin 4"
31,1000,196,4100,5100,"Sub-basin 4"
32,400,62,1900,2300,"Sub-basin 4"
33,300,25,400,700,"Sub-basin 4"
34,145700,49153.34,124600,270300,"Sub-basin 4"
35,100,2,1200,1300,"Sub-basin 4"
36,400,42,1600,2000,"Sub-basin 4"
37,1000,216,3700,4700,"Sub-basin 4"
38,1200,522,5500,6700,"Sub-basin 4"
39,300,33,1900,2200,"Sub-basin 4"
40,1700,322,7300,9000,"Sub-basin 4"
41,1100,454,1000,2100,"Sub-basin 4"
42,300,41,1800,2100,"Sub-basin 4"
43,400,53,1800,2200,"Sub-basin 4"
44,100,1,500,600,"Sub-basin 4"
45,100,6,1200,1300,"Sub-basin 4"
46,200,8,500,700,"Sub-basin 4"
47,200,10,900,1100,"Sub-basin 4"
48,2400,790,4700,7100,"Sub-basin 4"
49,11500,2847,12200,23700,"Sub-basin 4"
50,400,31,1500,1900,"Sub-basin 4"
51,200,10,600,800,"Sub-basin 4"
52,100,1,100,200,"Sub-basin 4"
53,100,3,500,600,"Sub-basin 4"
54,45800,4438,72700,118500,"Sub-basin 4"
55,5700,2000,14700,20400,"Sub-basin 4"
56,200,4,1700,1900,"Sub-basin 4"
57,2100,642,3400,5500,"Sub-basin 4"
58,4900,1974,7500,12400,"Sub-basin 4"
59,800,79,700,1500,"Sub-basin 4"
60,500,32,2300,2800,"Sub-basin 4"
61,4200,2311,10400,14600,"Sub-basin 4"
62,2200,727,6300,8500,"Sub-basin 4"
63,100,4,700,800,"Sub-basin 4"
64,100,1,1700,1800,"Sub-basin 4"
65,800,168,1400,2200,"Sub-basin 4"
66,3900,644,7400,11300,"Sub-basin 4"
67,2600,755,5500,8100,"Sub-basin 4"
68,12100,3976,27200,39300,"Sub-basin 4"
69,800,112,3400,4200,"Sub-basin 4"
70,1300,262,5600,6900,"Sub-basin 4"
71,1400,645,4300,5700,"Sub-basin 4"
72,100,3,1000,1100,"Sub-basin 4"
73,3000,537,8000,11000,"Sub-basin 4"
74,400,30,900,1300,"Sub-basin 4"
75,300,32,1200,1500,"Sub-basin 4"
76,1300,207,6400,7700,"Sub-basin 4"
77,500,52,1800,2300,"Sub-basin 4"
78,1400,170,2900,4300,"Sub-basin 4"
79,100,1,700,800,"Sub-basin 4"
80,100,9,900,1000,"Sub-basin 4"
81,300,20,2000,2300,"Sub-basin 4"
82,4700,990,7700,12400,"Sub-basin 4"
83,400,37,1900,2300,"Sub-basin 4"
84,400,24,2600,3000,"Sub-basin 4"
85,10000,3392,18700,28700,"Sub-basin 4"
86,200,12,1000,1200,"Sub-basin 4"
87,100,3,300,400,"Sub-basin 4"
88,100,19,1000,1100,"Sub-basin 4"
89,100,4,400,500,"Sub-basin 4"
90,200,6,1000,1200,"Sub-basin 4"
91,1700,390,5500,7200,"Sub-basin 4"
92,1300,396,3000,4300,"Sub-basin 4"
93,7600,4539,8900,16500,"Sub-basin 4"
94,100,3,500,600,"Sub-basin 4"
95,200,11,1400,1600,"Sub-basin 4"
96,800,76,1500,2300,"Sub-basin 4"
97,1300,135,4100,5400,"Sub-basin 4"
98,100,3,700,800,"Sub-basin 4"
99,1000,249,2100,3100,"Sub-basin 4"
100,400,91,1900,2300,"Sub-basin 4"
101,200,6,2400,2600,"Sub-basin 4"
102,2500,304,13800,16300,"Sub-basin 4"
103,100,3,500,600,"Sub-basin 4"
104,200,16,300,500,"Sub-basin 4"
105,200,18,1400,1600,"Sub-basin 4"
106,300,41,500,800,"Sub-basin 4"
107,900,252,3100,4000,"Sub-basin 4"
108,4800,1480,9600,14400,"Sub-basin 4"
109,300,4,1200,1500,"Sub-basin 4"
110,100,9,800,900,"Sub-basin 4"
111,1800,1009,4600,6400,"Sub-basin 4"
112,700,145,2400,3100,"Sub-basin 4"
113,100,4,1100,1200,"Sub-basin 4"
114,61400,16814,84100,145500,"Sub-basin 4"
115,300,15,700,1000,"Sub-basin 4"
116,200,17,900,1100,"Sub-basin 4"
117,900,117,2700,3600,"Sub-basin 4"
118,600,92,3700,4300,"Sub-basin 4"
119,300,17,1500,1800,"Sub-basin 4"
120,100,3,400,500,"Sub-basin 4"
121,300,30,2400,2700,"Sub-basin 4"
122,700,177,2100,2800,"Sub-basin 4"
123,800,133,6200,7000,"Sub-basin 4"
124,100,1,900,1000,"Sub-basin 4"
125,2700,784,7100,9800,"Sub-basin 4"
126,100,6,600,700,"Sub-basin 4"
127,300,12,3400,3700,"Sub-basin 4"
128,800,229,2700,3500,"Sub-basin 4"
129,500,53,2100,2600,"Sub-basin 4"
130,300,21,1500,1800,"Sub-basin 4"
131,300,19,1500,1800,"Sub-basin 4"
132,1600,408,2300,3900,"Sub-basin 4"
133,200,9,1400,1600,"Sub-basin 4"
134,1100,246,5200,6300,"Sub-basin 4"
135,35200,13209.5,48000,83200,"Sub-basin 4"
136,1500,503,3400,4900,"Sub-basin 4"
137,200,17,700,900,"Sub-basin 4"
138,300,30,3300,3600,"Sub-basin 4"
139,500,81,2300,2800,"Sub-basin 4"
140,700,98,2200,2900,"Sub-basin 4"
141,700,145,1800,2500,"Sub-basin 4"
142,400,48,2500,2900,"Sub-basin 4"
143,1000,244,2200,3200,"Sub-basin 4"
144,300,39,2100,2400,"Sub-basin 4"
145,600,136,2000,2600,"Sub-basin 4"
146,400,16,3400,3800,"Sub-basin 4"
147,1100,422,1900,3000,"Sub-basin 4"
148,300,25,2400,2700,"Sub-basin 4"
149,1600,663,3300,4900,"Sub-basin 4"
150,600,111,2000,2600,"Sub-basin 4"
151,1000,268,1400,2400,"Sub-basin 4"
152,300,27,1400,1700,"Sub-basin 4"
153,2100,573.5,8600,10700,"Sub-basin 4"
154,600,73,1100,1700,"Sub-basin 4"
155,1400,283,3900,5300,"Sub-basin 4"
156,700,62,2000,2700,"Sub-basin 4"
157,600,64,2000,2600,"Sub-basin 4"
158,300,22,1900,2200,"Sub-basin 4"
159,400,37,1400,1800,"Sub-basin 4"
160,4000,2021,2900,6900,"Sub-basin 4"
161,2400,720,4700,7100,"Sub-basin 4"
162,8400,4194,18000,26400,"Sub-basin 4"
163,900,259,2500,3400,"Sub-basin 4"
164,3000,1048,6300,9300,"Sub-basin 4"
165,800,37,2000,2800,"Sub-basin 4"
166,400,57,1700,2100,"Sub-basin 4"
167,200,8,600,800,"Sub-basin 4"
168,200,7,800,1000,"Sub-basin 4"
169,600,164,2500,3100,"Sub-basin 4"
170,200,13,1300,1500,"Sub-basin 4"
171,9300,4383,13400,22700,"Sub-basin 4"
172,1600,308,6000,7600,"Sub-basin 4"
173,900,183,3000,3900,"Sub-basin 4"
174,100,1,1000,1100,"Sub-basin 4"
175,200,15,200,400,"Sub-basin 4"
176,1600,379,2700,4300,"Sub-basin 4"
177,400,69,1900,2300,"Sub-basin 4"
178,5500,2460,9300,14800,"Sub-basin 4"
179,700,96,2500,3200,"Sub-basin 4"
180,1500,334,4800,6300,"Sub-basin 4"
181,1800,328.17,7600,9400,"Sub-basin 4"
182,1500,285,6900,8400,"Sub-basin 4"
183,600,16,2600,3200,"Sub-basin 4"
184,100,1,1900,2000,"Sub-basin 4"
185,42700,20465,38400,81100,"Sub-basin 4"
186,200,13,1600,1800,"Sub-basin 4"
187,100,1.83,900,1000,"Sub-basin 4"
188,100,1,1300,1400,"Sub-basin 4"
189,700,102,1100,1800,"Sub-basin 4"
190,4000,1388,6500,10500,"Sub-basin 4"
191,800,153,4000,4800,"Sub-basin 4"
192,200,6,2300,2500,"Sub-basin 4"
193,35600,10322,56700,92300,"Sub-basin 4"
194,700,68,5600,6300,"Sub-basin 4"
195,200,14,1000,1200,"Sub-basin 4"
196,200,2,600,800,"Sub-basin 4"
197,100,1,300,400,"Sub-basin 4"
198,400,39,100,500,"Sub-basin 4"
199,900,191,2500,3400,"Sub-basin 4"
200,200,6,300,500,"Sub-basin 4"
201,200,19,800,1000,"Sub-basin 4"
202,2800,907,4800,7600,"Sub-basin 4"
203,5200,1958,4100,9300,"Sub-basin 4"
204,100,8,1100,1200,"Sub-basin 4"
205,300,24,2600,2900,"Sub-basin 4"
206,1000,216,1400,2400,"Sub-basin 4"
207,900,256,2600,3500,"Sub-basin 4"
208,200,3,800,1000,"Sub-basin 4"
209,900,67,2000,2900,"Sub-basin 4"
210,22600,9003,36600,59200,"Sub-basin 4"
211,1800,335,5100,6900,"Sub-basin 4"
212,2700,1421,5700,8400,"Sub-basin 4"
213,200,6,600,800,"Sub-basin 4"
214,6400,1829,6400,12800,"Sub-basin 4"
215,6100,2272,7600,13700,"Sub-basin 4"
216,400,49,1000,1400,"Sub-basin 4"
217,100,2,400,500,"Sub-basin 4"
218,400,46,1500,1900,"Sub-basin 4"
219,400,92,300,700,"Sub-basin 4"
220,1000,105,2500,3500,"Sub-basin 4"
221,6100,1588,6000,12100,"Sub-basin 4"
222,300,24,1500,1800,"Sub-basin 4"
223,3100,1083,4600,7700,"Sub-basin 4"
224,2200,799,3100,5300,"Sub-basin 4"
225,200,13,1100,1300,"Sub-basin 4"
226,100,4,1000,1100,"Sub-basin 4"
227,800,181,3000,3800,"Sub-basin 4"
228,600,101,6400,7000,"Sub-basin 4"
229,200,5,1300,1500,"Sub-basin 4"
230,6800,1186,9400,16200,"Sub-basin 4"
231,13900,8151,23300,37200,"Sub-basin 4"
232,500,66,2200,2700,"Sub-basin 4"
233,400,42,1900,2300,"Sub-basin 4"
234,16900,8756,25200,42100,"Sub-basin 4"
235,100,7,1000,1100,"Sub-basin 4"
236,300,28,2800,3100,"Sub-basin 4"
237,100,1,500,600,"Sub-basin 4"
238,100,2,200,300,"Sub-basin 4"
239,200,14,1800,2000,"Sub-basin 4"
240,200,3,200,400,"Sub-basin 4"
241,200,15,1600,1800,"Sub-basin 4"
242,600,84,1400,2000,"Sub-basin 4"
243,400,70.01,2400,2800,"Sub-basin 4"
244,600,55,2200,2800,"Sub-basin 4"
245,3500,778,9400,12900,"Sub-basin 4"
246,2000,159.34,6600,8600,"Sub-basin 4"
247,7200,2470,9900,17100,"Sub-basin 4"
248,500,67,2900,3400,"Sub-basin 4"
249,200,8,1400,1600,"Sub-basin 4"
250,11400,3974,16600,28000,"Sub-basin 4"
251,11200,4351,14900,26100,"Sub-basin 4"
252,100,1,0,100,"Sub-basin 4"
253,600,109,1600,2200,"Sub-basin 4"
254,600,95,3700,4300,"Sub-basin 4"
255,100,2,100,200,"Sub-basin 4"
256,100,6,800,900,"Sub-basin 4"
257,1500,515,5400,6900,"Sub-basin 4"
258,200,54,500,700,"Sub-basin 4"
259,3100,238,8000,11100,"Sub-basin 4"
260,200,46,1400,1600,"Sub-basin 4"
261,1500,646,1900,3400,"Sub-basin 4"
262,600,152,2200,2800,"Sub-basin 4"
263,200,31,700,900,"Sub-basin 4"
264,900,40,2400,3300,"Sub-basin 4"
265,100,2,900,1000,"Sub-basin 4"
266,300,21,1200,1500,"Sub-basin 4"
267,500,37,1400,1900,"Sub-basin 4"
268,500,68,1600,2100,"Sub-basin 4"
269,8200,2673.67,13700,21900,"Sub-basin 4"
270,1000,148,3100,4100,"Sub-basin 4"
271,32600,9118,46100,78700,"Sub-basin 4"
272,600,48,1900,2500,"Sub-basin 4"
273,2000,241.67,4900,6900,"Sub-basin 4"
274,400,10,1800,2200,"Sub-basin 4"
275,3100,812,5100,8200,"Sub-basin 4"
276,1000,298,800,1800,"Sub-basin 4"
277,4300,1195,7900,12200,"Sub-basin 4"
278,100,2,700,800,"Sub-basin 4"
279,500,102,900,1400,"Sub-basin 4"
280,1200,467,1800,3000,"Sub-basin 4"
281,600,57,3600,4200,"Sub-basin 4"
282,900,107,4600,5500,"Sub-basin 4"
283,47500,24845,53100,100600,"Sub-basin 4"
284,1600,302,3400,5000,"Sub-basin 4"
285,4900,2218,6900,11800,"Sub-basin 4"
286,100,3,1400,1500,"Sub-basin 4"
287,400,32,1700,2100,"Sub-basin 4"
288,700,95,3500,4200,"Sub-basin 4"
289,400,54,2900,3300,"Sub-basin 4"
290,600,62,1100,1700,"Sub-basin 4"
291,22100,6004,23000,45100,"Sub-basin 4"
292,1000,290,1200,2200,"Sub-basin 4"
293,200,12,1400,1600,"Sub-basin 4"
294,1000,221,2900,3900,"Sub-basin 4"
295,900,86,3600,4500,"Sub-basin 4"
296,100,1,500,600,"Sub-basin 4"
297,400,17,2700,3100,"Sub-basin 4"
298,600,48,3300,3900,"Sub-basin 4"
299,400,135,2700,3100,"Sub-basin 4"
300,29300,6289,33900,63200,"Sub-basin 4"
301,71100,20624,64000,135100,"Sub-basin 4"
302,100,1,400,500,"Sub-basin 4"
303,7000,3095,10700,17700,"Sub-basin 4"
304,200,5,1700,1900,"Sub-basin 4"
305,600,62,1800,2400,"Sub-basin 4"
306,1700,457,3100,4800,"Sub-basin 4"
307,7300,2810,11700,19000,"Sub-basin 4"
308,200,5,1400,1600,"Sub-basin 4"
309,200,13,300,500,"Sub-basin 4"
310,1300,287,4600,5900,"Sub-basin 4"
311,800,172,4200,5000,"Sub-basin 4"
312,1800,767,3600,5400,"Sub-basin 4"
313,1700,628,8000,9700,"Sub-basin 4"
314,500,42,1700,2200,"Sub-basin 4"
315,4100,701,11500,15600,"Sub-basin 4"
316,1000,81,3700,4700,"Sub-basin 4"
317,100,3,900,1000,"Sub-basin 4"
318,5000,1712,8200,13200,"Sub-basin 4"
319,700,104,2900,3600,"Sub-basin 4"
320,600,221,2700,3300,"Sub-basin 4"
321,200,5,1000,1200,"Sub-basin 4"
322,4800,901,8000,12800,"Sub-basin 4"
323,1600,468,5700,7300,"Sub-basin 4"
324,100,11,1400,1500,"Sub-basin 4"
325,700,144,3900,4600,"Sub-basin 4"
326,1700,619,3700,5400,"Sub-basin 4"
327,1500,236,5300,6800,"Sub-basin 4"
328,400,43,2400,2800,"Sub-basin 4"
329,300,14,1400,1700,"Sub-basin 4"
330,200,32,1400,1600,"Sub-basin 4"
331,1000,164,2100,3100,"Sub-basin 4"
332,100,3,1000,1100,"Sub-basin 4"
333,45400,13323,48200,93600,"Sub-basin 4"
334,300,6,2000,2300,"Sub-basin 4"
335,200,18,1800,2000,"Sub-basin 4"
336,700,85,5200,5900,"Sub-basin 4"
337,400,81,2300,2700,"Sub-basin 4"
338,1100,160,3900,5000,"Sub-basin 4"
339,100,3,1400,1500,"Sub-basin 4"
340,1100,224,3700,4800,"Sub-basin 4"
341,378900,257747.9486,185900,564800,"Sub-basin 4"
342,10100,3018,10600,20700,"Sub-basin 4"
343,100,3,800,900,"Sub-basin 4"
344,1800,644,5600,7400,"Sub-basin 4"
345,100,6,1000,1100,"Sub-basin 4"
346,100,3,700,800,"Sub-basin 4"
347,400,12,3600,4000,"Sub-basin 4"
348,100,2,600,700,"Sub-basin 4"
349,300,36,3200,3500,"Sub-basin 4"
350,9000,3695,12700,21700,"Sub-basin 4"
351,5900,833,17300,23200,"Sub-basin 4"
352,500,47,2800,3300,"Sub-basin 4"
353,600,38,2300,2900,"Sub-basin 4"
354,100,4,1500,1600,"Sub-basin 4"
355,25800,5196,42300,68100,"Sub-basin 4"
356,1400,202,4900,6300,"Sub-basin 4"
357,400,113,1400,1800,"Sub-basin 4"
358,100,5,500,600,"Sub-basin 4"
359,300,22,700,1000,"Sub-basin 4"
360,700,46,3600,4300,"Sub-basin 4"
361,600,33,1200,1800,"Sub-basin 4"
362,500,81,2200,2700,"Sub-basin 4"
363,100,7,900,1000,"Sub-basin 4"
364,4200,1490,6000,10200,"Sub-basin 4"
365,1000,137,6300,7300,"Sub-basin 4"
366,400,24,2000,2400,"Sub-basin 4"
367,100,6,700,800,"Sub-basin 4"
368,200,18,600,800,"Sub-basin 4"
369,600,72,2400,3000,"Sub-basin 4"
370,6200,1634,9600,15800,"Sub-basin 4"
371,100,4,300,400,"Sub-basin 4"
372,1000,197,2900,3900,"Sub-basin 4"
373,600,229,1700,2300,"Sub-basin 4"
374,7000,2667,12900,19900,"Sub-basin 4"
375,900,116,2900,3800,"Sub-basin 4"
376,1300,499,2500,3800,"Sub-basin 4"
377,300,23,300,600,"Sub-basin 4"
378,1200,293,1200,2400,"Sub-basin 4"
379,400,66,1100,1500,"Sub-basin 4"
380,800,211,3200,4000,"Sub-basin 4"
381,400,75,1300,1700,"Sub-basin 4"
382,200,18,1500,1700,"Sub-basin 4"
383,100,0.84,400,500,"Sub-basin 4"
384,4400,1530,13300,17700,"Sub-basin 4"
385,600,97,1600,2200,"Sub-basin 4"
386,2500,1665,6700,9200,"Sub-basin 4"
387,100,1,1100,1200,"Sub-basin 4"
388,100,4,200,300,"Sub-basin 4"
389,42800,16942,56500,99300,"Sub-basin 4"
390,400,39,1600,2000,"Sub-basin 4"
391,5100,1665,13900,19000,"Sub-basin 4"
392,2000,593,5400,7400,"Sub-basin 4"
393,4500,1656,6700,11200,"Sub-basin 4"
394,400,54,1800,2200,"Sub-basin 4"
395,200,8,2200,2400,"Sub-basin 4"
396,400,28,1300,1700,"Sub-basin 4"
397,2000,750,5700,7700,"Sub-basin 4"
398,1000,303,3400,4400,"Sub-basin 4"
399,1300,326,4500,5800,"Sub-basin 4"
400,4200,1662,10800,15000,"Sub-basin 4"
401,7300,2677,9700,17000,"Sub-basin 4"
402,100,7,1000,1100,"Sub-basin 4"
403,1000,374,3400,4400,"Sub-basin 4"
404,1800,301,4400,6200,"Sub-basin 4"
405,2600,697,4200,6800,"Sub-basin 4"
406,1500,214,3000,4500,"Sub-basin 4"
407,700,110,2200,2900,"Sub-basin 4"
408,200,8,1000,1200,"Sub-basin 4"
409,300,63,900,1200,"Sub-basin 4"
410,800,161,2300,3100,"Sub-basin 4"
411,1500,402,4800,6300,"Sub-basin 4"
412,1700,499,5200,6900,"Sub-basin 4"
413,100,13,0,100,"Sub-basin 4"
414,1100,143,2300,3400,"Sub-basin 4"
415,12900,3542,20600,33500,"Sub-basin 4"
416,7100,1793,13100,20200,"Sub-basin 4"
417,200,4,300,500,"Sub-basin 4"
418,163400,79871.68,147100,310500,"Sub-basin 4"
419,1700,189,4400,6100,"Sub-basin 4"
420,600,164,2300,2900,"Sub-basin 4"
421,200,44,200,400,"Sub-basin 4"
422,100,7,0,100,"Sub-basin 4"
423,1100,503,1100,2200,"Sub-basin 4"
424,500,109,600,1100,"Sub-basin 4"
425,13400,3812,18400,31800,"Sub-basin 4"
426,11200,3329,14400,25600,"Sub-basin 4"
427,400,37,2300,2700,"Sub-basin 4"
428,400,49,1100,1500,"Sub-basin 4"
429,100,2,1000,1100,"Sub-basin 4"
430,5400,1985,10600,16000,"Sub-basin 4"
431,400,83,1400,1800,"Sub-basin 4"
432,1200,175,1200,2400,"Sub-basin 4"
433,600,60,3100,3700,"Sub-basin 4"
434,400,41,1600,2000,"Sub-basin 4"
435,5800,995,12000,17800,"Sub-basin 4"
436,1600,668,4700,6300,"Sub-basin 4"
437,4600,738,13100,17700,"Sub-basin 4"
438,8400,1326,11700,20100,"Sub-basin 4"
439,1400,331,1700,3100,"Sub-basin 4"
440,400,55,900,1300,"Sub-basin 4"
441,1500,180,5100,6600,"Sub-basin 4"
442,1600,442,4200,5800,"Sub-basin 4"
443,200,7,2300,2500,"Sub-basin 4"
444,300,41,2100,2400,"Sub-basin 4"
445,200,2,400,600,"Sub-basin 4"
446,3700,1344,9900,13600,"Sub-basin 4"
447,1300,353,1700,3000,"Sub-basin 4"
448,100,6,500,600,"Sub-basin 4"
449,200,16,1700,1900,"Sub-basin 4"
450,900,120,2800,3700,"Sub-basin 4"
451,1200,274,4100,5300,"Sub-basin 4"
452,100,10,300,400,"Sub-basin 4"
453,600,33,5300,5900,"Sub-basin 4"
454,200,27,1300,1500,"Sub-basin 4"
455,400,16,3400,3800,"Sub-basin 4"
456,200,16,1000,1200,"Sub-basin 4"
457,400,32,2100,2500,"Sub-basin 4"
458,900,84,4300,5200,"Sub-basin 4"
459,200,4,2400,2600,"Sub-basin 4"
460,600,77,800,1400,"Sub-basin 4"
461,100,2,800,900,"Sub-basin 4"
462,1500,169,5900,7400,"Sub-basin 4"
463,300,13,3000,3300,"Sub-basin 4"
464,5500,2037,7500,13000,"Sub-basin 4"
465,9000,2545,12600,21600,"Sub-basin 4"
466,1400,219,5100,6500,"Sub-basin 4"
467,2700,617,9000,11700,"Sub-basin 4"
468,100,2,600,700,"Sub-basin 4"
469,400,26,1200,1600,"Sub-basin 4"
470,100,1,800,900,"Sub-basin 4"
471,300,11,1200,1500,"Sub-basin 4"
472,800,125,2000,2800,"Sub-basin 4"
473,1500,293,7200,8700,"Sub-basin 4"
474,900,44,3500,4400,"Sub-basin 4"
475,2600,514,6200,8800,"Sub-basin 4"
476,200,9,600,800,"Sub-basin 4"
477,200,9,500,700,"Sub-basin 4"
478,700,193,1700,2400,"Sub-basin 4"
479,1200,242,3500,4700,"Sub-basin 4"
480,1100,201,5000,6100,"Sub-basin 4"
481,400,57,1900,2300,"Sub-basin 4"
482,1600,183,7900,9500,"Sub-basin 4"
483,200,13,2600,2800,"Sub-basin 4"
484,1600,539,1900,3500,"Sub-basin 4"
485,1500,196,4500,6000,"Sub-basin 4"
486,100,6,900,1000,"Sub-basin 4"
487,600,112,5300,5900,"Sub-basin 4"
488,800,143,1000,1800,"Sub-basin 4"
489,3800,1560,6200,10000,"Sub-basin 4"
490,4000,548,14600,18600,"Sub-basin 4"
491,700,83,2800,3500,"Sub-basin 4"
492,400,29,2800,3200,"Sub-basin 4"
493,200,3,2200,2400,"Sub-basin 4"
494,400,66,3300,3700,"Sub-basin 4"
495,11100,2496,22300,33400,"Sub-basin 4"
496,5600,1680,12300,17900,"Sub-basin 4"
497,800,71,4300,5100,"Sub-basin 4"
498,100,5,500,600,"Sub-basin 4"
499,1000,222,1700,2700,"Sub-basin 4"
500,600,48,3300,3900,"Sub-basin 4"
501,600,68,3100,3700,"Sub-basin 4"
502,1500,210,6500,8000,"Sub-basin 4"
503,700,39,4200,4900,"Sub-basin 4"
504,1400,177,2100,3500,"Sub-basin 4"
505,500,20,1500,2000,"Sub-basin 4"
506,800,117,2100,2900,"Sub-basin 4"
507,200,2,1400,1600,"Sub-basin 4"
508,1200,216,4800,6000,"Sub-basin 4"
509,400,40,1400,1800,"Sub-basin 4"
510,2600,1040,10800,13400,"Sub-basin 4"
511,100,2,900,1000,"Sub-basin 4"
512,200,3,1000,1200,"Sub-basin 4"
513,300,29,1700,2000,"Sub-basin 4"
514,500,96,2500,3000,"Sub-basin 4"
515,2700,565,5700,8400,"Sub-basin 4"
516,1100,129,4800,5900,"Sub-basin 4"
517,400,25,3100,3500,"Sub-basin 4"
518,200,2,1400,1600,"Sub-basin 4"
519,800,116,1200,2000,"Sub-basin 4"
520,900,186,2700,3600,"Sub-basin 4"
521,200,6,2500,2700,"Sub-basin 4"
522,1100,357,3900,5000,"Sub-basin 4"
523,2200,359,8900,11100,"Sub-basin 4"
524,600,48,1800,2400,"Sub-basin 4"
525,800,148,2900,3700,"Sub-basin 4"
526,900,192,5900,6800,"Sub-basin 4"
527,1000,106,3800,4800,"Sub-basin 4"
528,200,4,2400,2600,"Sub-basin 4"
529,21100,7412,34400,55500,"Sub-basin 4"
530,400,26,1900,2300,"Sub-basin 4"
531,600,197,4400,5000,"Sub-basin 4"
532,44300,15463,70000,114300,"Sub-basin 4"
533,4300,1020.34,7100,11400,"Sub-basin 4"
534,100,6,900,1000,"Sub-basin 4"
535,300,17,1600,1900,"Sub-basin 4"
536,4000,865,10400,14400,"Sub-basin 4"
537,3300,1004,5300,8600,"Sub-basin 4"
538,600,28,3400,4000,"Sub-basin 4"
539,200,7,1100,1300,"Sub-basin 4"
540,100,1,800,900,"Sub-basin 4"
541,2600,871,5500,8100,"Sub-basin 4"
542,300,5.99,2500,2800,"Sub-basin 4"
543,200,4,1500,1700,"Sub-basin 4"
544,4800,1237,14400,19200,"Sub-basin 4"
545,500,50,4400,4900,"Sub-basin 4"
546,2900,272,6800,9700,"Sub-basin 4"
547,700,102,4400,5100,"Sub-basin 4"
548,100,1,1700,1800,"Sub-basin 4"
549,3300,309,12500,15800,"Sub-basin 4"
550,200,9,2000,2200,"Sub-basin 4"
551,200,4,1700,1900,"Sub-basin 4"
552,800,76,2600,3400,"Sub-basin 4"
553,500,59,1900,2400,"Sub-basin 4"
554,100,1,1000,1100,"Sub-basin 4"
555,100,2,800,900,"Sub-basin 4"
556,100,1,700,800,"Sub-basin 4"
557,400,14,4800,5200,"Sub-basin 4"
558,1000,269,2700,3700,"Sub-basin 4"
559,600,168.5,3800,4400,"Sub-basin 4"
560,1300,403,3800,5100,"Sub-basin 4"
561,700,115,2100,2800,"Sub-basin 4"
562,900,75,4200,5100,"Sub-basin 4"
563,3400,1568,5000,8400,"Sub-basin 4"
564,700,118,2900,3600,"Sub-basin 4"
565,800,84,3400,4200,"Sub-basin 4"
566,200,7,800,1000,"Sub-basin 4"
567,800,50,3800,4600,"Sub-basin 4"
568,600,20,4400,5000,"Sub-basin 4"
569,300,14,2300,2600,"Sub-basin 4"
570,100,1,700,800,"Sub-basin 4"
571,700,71,4200,4900,"Sub-basin 4"
572,500,27,4900,5400,"Sub-basin 4"
573,200,8,2400,2600,"Sub-basin 4"
574,200,3,2500,2700,"Sub-basin 4"
575,800,204,2400,3200,"Sub-basin 4"
576,100,1,1000,1100,"Sub-basin 4"
577,1200,360,2000,3200,"Sub-basin 4"
578,200,20,1700,1900,"Sub-basin 4"
579,1600,149,9500,11100,"Sub-basin 4"
580,5200,714,21300,26500,"Sub-basin 4"
581,17500,5297,20600,38100,"Sub-basin 4"
582,300,18,700,1000,"Sub-basin 4"
583,1400,213.17,6800,8200,"Sub-basin 4"
584,400,22,2800,3200,"Sub-basin 4"
585,300,16,2200,2500,"Sub-basin 4"
586,500,85,3500,4000,"Sub-basin 4"
587,9400,5228,12700,22100,"Sub-basin 4"
588,13700,1195,28700,42400,"Sub-basin 4"
589,4300,636,14600,18900,"Sub-basin 4"
590,700,102,3200,3900,"Sub-basin 4"
591,100,1,1100,1200,"Sub-basin 4"
592,500,32,2300,2800,"Sub-basin 4"
593,2100,656,6100,8200,"Sub-basin 4"
594,12000,5025,19500,31500,"Sub-basin 4"
595,700,84,8600,9300,"Sub-basin 4"
596,600,108,900,1500,"Sub-basin 4"
597,100,3,1000,1100,"Sub-basin 4"
598,900,151.17,3800,4700,"Sub-basin 4"
599,200,5,1300,1500,"Sub-basin 4"
600,800,61,3700,4500,"Sub-basin 4"
601,12300,4002,30000,42300,"Sub-basin 4"
602,400,108,1200,1600,"Sub-basin 4"
603,700,42,3500,4200,"Sub-basin 4"
604,100,3,1500,1600,"Sub-basin 4"
605,200,18,1200,1400,"Sub-basin 4"
606,400,13,2900,3300,"Sub-basin 4"
607,400,36,2800,3200,"Sub-basin 4"
608,2900,547,12000,14900,"Sub-basin 4"
609,300,29,2100,2400,"Sub-basin 4"
610,100,7,1100,1200,"Sub-basin 4"
611,100,3,1000,1100,"Sub-basin 4"
612,200,25,2600,2800,"Sub-basin 4"
613,1500,527,1800,3300,"Sub-basin 4"
614,200,6,3100,3300,"Sub-basin 4"
615,200,4,2700,2900,"Sub-basin 4"
616,1000,167,3000,4000,"Sub-basin 4"
617,200,15,700,900,"Sub-basin 4"
618,100,4,1100,1200,"Sub-basin 4"
619,3900,451,20000,23900,"Sub-basin 4"
620,100,1,1800,1900,"Sub-basin 4"
621,3100,1296,6400,9500,"Sub-basin 4"
622,100,1,700,800,"Sub-basin 4"
623,8100,580,26400,34500,"Sub-basin 4"
624,11900,4470,18000,29900,"Sub-basin 4"
625,500,23,1700,2200,"Sub-basin 4"
626,600,55,5700,6300,"Sub-basin 4"
627,400,5,3600,4000,"Sub-basin 4"
628,400,11,2500,2900,"Sub-basin 4"
629,1100,261,4600,5700,"Sub-basin 4"
630,700,69,3000,3700,"Sub-basin 4"
631,14400,2576,29200,43600,"Sub-basin 4"
632,100,2,2300,2400,"Sub-basin 4"
633,200,3,2200,2400,"Sub-basin 4"
634,100,5,400,500,"Sub-basin 4"
635,400,47,4900,5300,"Sub-basin 4"
636,9900,2867,12900,22800,"Sub-basin 4"
637,100,2,800,900,"Sub-basin 4"
638,800,74,8100,8900,"Sub-basin 4"
639,3300,1098,6000,9300,"Sub-basin 4"
640,1200,114,8900,10100,"Sub-basin 4"
641,800,56,5400,6200,"Sub-basin 4"
642,8200,1093,19500,27700,"Sub-basin 4"
643,100,1,1300,1400,"Sub-basin 4"
644,7700,2893,14000,21700,"Sub-basin 4"
645,100,4,900,1000,"Sub-basin 4"
646,400,24,3300,3700,"Sub-basin 4"
647,4700,904,19000,23700,"Sub-basin 4"
648,300,6,2800,3100,"Sub-basin 4"
649,600,53,2600,3200,"Sub-basin 4"
650,1100,235,3200,4300,"Sub-basin 4"
651,6300,1876,15000,21300,"Sub-basin 4"
652,100,2,1000,1100,"Sub-basin 4"
653,200,2,2400,2600,"Sub-basin 4"
654,400,41,4100,4500,"Sub-basin 4"
655,100,1,1700,1800,"Sub-basin 4"
656,100,1,200,300,"Sub-basin 4"
657,500,22,4300,4800,"Sub-basin 4"
658,500,34,6900,7400,"Sub-basin 4"
659,100,3,600,700,"Sub-basin 4"
660,400,16,3000,3400,"Sub-basin 4"
661,100,1,1900,2000,"Sub-basin 4"
662,600,20,6300,6900,"Sub-basin 4"
663,2700,1076,8100,10800,"Sub-basin 4"
664,600,76,2800,3400,"Sub-basin 4"
665,4200,573,18400,22600,"Sub-basin 4"
666,200,5,1800,2000,"Sub-basin 4"
667,300,9,1600,1900,"Sub-basin 4"
668,1700,320,6400,8100,"Sub-basin 4"
669,6200,1682,17500,23700,"Sub-basin 4"
670,100,1,1300,1400,"Sub-basin 4"
671,1100,96,7600,8700,"Sub-basin 4"
672,2600,160,18500,21100,"Sub-basin 4"
673,200,6,1300,1500,"Sub-basin 4"
674,400,52,3800,4200,"Sub-basin 4"
675,300,39,1800,2100,"Sub-basin 4"
676,400,80,1800,2200,"Sub-basin 4"
677,400,56,2600,3000,"Sub-basin 4"
678,400,36,3100,3500,"Sub-basin 4"
679,4200,690,12100,16300,"Sub-basin 4"
680,4300,1330,7500,11800,"Sub-basin 4"
681,400,112,1400,1800,"Sub-basin 4"
682,3900,169,10500,14400,"Sub-basin 4"
683,1100,61,6700,7800,"Sub-basin 4"
684,1300,510,2400,3700,"Sub-basin 4"
685,500,64,2200,2700,"Sub-basin 4"
686,2300,474.33,6200,8500,"Sub-basin 4"
687,1600,330,9700,11300,"Sub-basin 4"
688,100,2,700,800,"Sub-basin 4"
689,1000,127,2700,3700,"Sub-basin 4"
690,24600,8850,44300,68900,"Sub-basin 4"
691,300,15,2100,2400,"Sub-basin 4"
692,100,2,400,500,"Sub-basin 4"
693,300,17,700,1000,"Sub-basin 4"
694,1200,290,4600,5800,"Sub-basin 4"
695,5800,2248.5,6100,11900,"Sub-basin 4"
696,2000,112,10300,12300,"Sub-basin 4"
697,100,1,1800,1900,"Sub-basin 4"
698,1800,218,8200,10000,"Sub-basin 4"
699,800,191,3400,4200,"Sub-basin 4"
700,6000,3814,11200,17200,"Sub-basin 4"
701,200,4,900,1100,"Sub-basin 4"
702,2300,554,4200,6500,"Sub-basin 4"
703,29100,14529,27900,57000,"Sub-basin 4"
704,400,35,2500,2900,"Sub-basin 4"
705,100,2,200,300,"Sub-basin 4"
706,1400,343,4100,5500,"Sub-basin 4"
707,2700,444,8800,11500,"Sub-basin 4"
708,100,1,100,200,"Sub-basin 4"
709,400,20,2300,2700,"Sub-basin 4"
710,600,48,3300,3900,"Sub-basin 4"
711,100,1,1000,1100,"Sub-basin 4"
712,100,3,600,700,"Sub-basin 4"
713,154300,101230.5,112500,266800,"Sub-basin 4"
714,12400,2111,21300,33700,"Sub-basin 4"
715,1100,157,2800,3900,"Sub-basin 4"
716,400,31,1000,1400,"Sub-basin 4"
717,100,2,1100,1200,"Sub-basin 4"
718,1000,304,2700,3700,"Sub-basin 4"
719,1600,116,15100,16700,"Sub-basin 4"
720,100,8,1600,1700,"Sub-basin 4"
721,100,1,2000,2100,"Sub-basin 4"
722,1300,416,3600,4900,"Sub-basin 4"
723,700,89,2600,3300,"Sub-basin 4"
724,200,16,1700,1900,"Sub-basin 4"
725,3300,653,9800,13100,"Sub-basin 4"
726,1100,253,4300,5400,"Sub-basin 4"
727,1700,211,6800,8500,"Sub-basin 4"
728,100,1,1900,2000,"Sub-basin 4"
729,600,14,7500,8100,"Sub-basin 4"
730,6300,1357,10700,17000,"Sub-basin 4"
731,400,35,1100,1500,"Sub-basin 4"
732,300,25,1700,2000,"Sub-basin 4"
733,400,36,1800,2200,"Sub-basin 4"
734,800,82,3200,4000,"Sub-basin 4"
735,400,46,2900,3300,"Sub-basin 4"
736,400,10,2300,2700,"Sub-basin 4"
737,300,22,900,1200,"Sub-basin 4"
738,10600,1524,30900,41500,"Sub-basin 4"
739,200,2,400,600,"Sub-basin 4"
740,1100,224,3100,4200,"Sub-basin 4"
741,9800,2925,15700,25500,"Sub-basin 4"
742,700,93,5300,6000,"Sub-basin 4"
743,500,33,2200,2700,"Sub-basin 4"
744,500,18,3600,4100,"Sub-basin 4"
745,1600,527,4500,6100,"Sub-basin 4"
746,100,2,1200,1300,"Sub-basin 4"
747,1100,181,6000,7100,"Sub-basin 4"
748,200,5,600,800,"Sub-basin 4"
749,100,1,1700,1800,"Sub-basin 4"
750,1400,387,2700,4100,"Sub-basin 4"
751,700,148,3000,3700,"Sub-basin 4"
752,300,24,3800,4100,"Sub-basin 4"
753,200,4,3200,3400,"Sub-basin 4"
754,700,67,2600,3300,"Sub-basin 4"
755,1100,266,2900,4000,"Sub-basin 4"
756,1200,126,3600,4800,"Sub-basin 4"
757,300,10,2800,3100,"Sub-basin 4"
758,300,7,1100,1400,"Sub-basin 4"
759,600,28,1800,2400,"Sub-basin 4"
760,800,71,2000,2800,"Sub-basin 4"
761,400,56,1000,1400,"Sub-basin 4"
762,2100,552,8500,10600,"Sub-basin 4"
763,200,5,4000,4200,"Sub-basin 4"
764,300,17,3800,4100,"Sub-basin 4"
765,200,3,1900,2100,"Sub-basin 4"
766,700,193,2700,3400,"Sub-basin 4"
767,600,176,2500,3100,"Sub-basin 4"
768,600,50,2700,3300,"Sub-basin 4"
769,700,68,3100,3800,"Sub-basin 4"
770,100,1,1900,2000,"Sub-basin 4"
771,500,23,2700,3200,"Sub-basin 4"
772,200,7,1700,1900,"Sub-basin 4"
773,300,24,1500,1800,"Sub-basin 4"
774,500,63,1700,2200,"Sub-basin 4"
775,22500,7127,38800,61300,"Sub-basin 4"
776,1000,133,4700,5700,"Sub-basin 4"
777,200,10,3000,3200,"Sub-basin 4"
778,6300,1584,17500,23800,"Sub-basin 4"
779,6500,1144,17500,24000,"Sub-basin 4"
780,900,155,3100,4000,"Sub-basin 4"
781,100,5,800,900,"Sub-basin 4"
782,16100,3841.5,37500,53600,"Sub-basin 4"
783,11300,2483,26900,38200,"Sub-basin 4"
784,400,20,5400,5800,"Sub-basin 4"
785,700,64,2300,3000,"Sub-basin 4"
786,600,111,2700,3300,"Sub-basin 4"
787,800,147,3200,4000,"Sub-basin 4"
788,400,36,1000,1400,"Sub-basin 4"
789,15800,2585,51000,66800,"Sub-basin 4"
790,200,2,2000,2200,"Sub-basin 4"
791,700,94,1600,2300,"Sub-basin 4"
792,800,120,1900,2700,"Sub-basin 4"
793,2400,439,5400,7800,"Sub-basin 4"
794,600,33,3300,3900,"Sub-basin 4"
795,100,2,1100,1200,"Sub-basin 4"
796,1400,287,4100,5500,"Sub-basin 4"
797,100,2,900,1000,"Sub-basin 4"
798,200,8,3500,3700,"Sub-basin 4"
799,2000,511,5400,7400,"Sub-basin 4"
800,49400,11160,81700,131100,"Sub-basin 4"
801,1400,165,4500,5900,"Sub-basin 4"
802,1100,282,5500,6600,"Sub-basin 4"
803,100,5,1000,1100,"Sub-basin 4"
804,100,2,1000,1100,"Sub-basin 4"
805,400,13,1300,1700,"Sub-basin 4"
806,100,9,800,900,"Sub-basin 4"
807,100,5,500,600,"Sub-basin 4"
808,100,3,2200,2300,"Sub-basin 4"
809,200,5,1700,1900,"Sub-basin 4"
810,1000,60,9500,10500,"Sub-basin 4"
811,800,155,4400,5200,"Sub-basin 4"
812,1400,379,4000,5400,"Sub-basin 4"
813,900,234,3400,4300,"Sub-basin 4"
814,100,3,600,700,"Sub-basin 4"
815,400,46,4000,4400,"Sub-basin 4"
816,1000,170,3200,4200,"Sub-basin 4"
817,500,105,2700,3200,"Sub-basin 4"
818,1400,192,3300,4700,"Sub-basin 4"
819,700,148,2100,2800,"Sub-basin 4"
820,400,28,1000,1400,"Sub-basin 4"
821,400,18,1500,1900,"Sub-basin 4"
822,800,266,2900,3700,"Sub-basin 4"
823,400,13,5700,6100,"Sub-basin 4"
824,200,3,3500,3700,"Sub-basin 4"
825,1100,136,3100,4200,"Sub-basin 4"
826,300,10,1200,1500,"Sub-basin 4"
827,400,27,2800,3200,"Sub-basin 4"
828,100,3,1100,1200,"Sub-basin 4"
829,200,8,1400,1600,"Sub-basin 4"
830,1300,139,5400,6700,"Sub-basin 4"
831,2000,814,9300,11300,"Sub-basin 4"
832,300,16,1200,1500,"Sub-basin 4"
833,200,7,3500,3700,"Sub-basin 4"
834,400,21,2600,3000,"Sub-basin 4"
835,1100,245,5300,6400,"Sub-basin 4"
836,1800,260.16,4500,6300,"Sub-basin 4"
837,100,1,2300,2400,"Sub-basin 4"
838,500,12,5100,5600,"Sub-basin 4"
839,400,37,1500,1900,"Sub-basin 4"
840,500,32,3800,4300,"Sub-basin 4"
841,300,12,2200,2500,"Sub-basin 4"
842,1800,652,3600,5400,"Sub-basin 4"
843,100,1,0,100,"Sub-basin 4"
844,800,97,6200,7000,"Sub-basin 4"
845,4300,1664,9000,13300,"Sub-basin 4"
846,100,2,600,700,"Sub-basin 4"
847,900,282.58,2400,3300,"Sub-basin 4"
848,600,65.34,1400,2000,"Sub-basin 4"
849,4400,2009,7700,12100,"Sub-basin 4"
850,100,1,1700,1800,"Sub-basin 4"
851,600,65,3100,3700,"Sub-basin 4"
852,300,18,1300,1600,"Sub-basin 4"
853,400,69,3300,3700,"Sub-basin 4"
854,100,0.33,1100,1200,"Sub-basin 4"
855,500,33,4400,4900,"Sub-basin 4"
856,1500,507,5000,6500,"Sub-basin 4"
857,1000,375,900,1900,"Sub-basin 4"
858,2600,550,6900,9500,"Sub-basin 4"
859,100,11,800,900,"Sub-basin 4"
860,1400,90,4900,6300,"Sub-basin 4"
861,900,53,4200,5100,"Sub-basin 4"
862,900,118,1800,2700,"Sub-basin 4"
863,3000,690,8300,11300,"Sub-basin 4"
864,200,6,2100,2300,"Sub-basin 4"
865,600,34,3300,3900,"Sub-basin 4"
866,20700,5372,34300,55000,"Sub-basin 4"
867,9800,4296,8600,18400,"Sub-basin 4"
868,1200,175,5500,6700,"Sub-basin 4"
869,800,108,3600,4400,"Sub-basin 4"
870,2200,163,7200,9400,"Sub-basin 4"
871,400,30,1400,1800,"Sub-basin 4"
872,700,56.66,8100,8800,"Sub-basin 4"
873,3200,253,17400,20600,"Sub-basin 4"
874,100,2,800,900,"Sub-basin 4"
875,3400,391,17200,20600,"Sub-basin 4"
876,400,39,1800,2200,"Sub-basin 4"
877,100,9,300,400,"Sub-basin 4"
878,1000,105,5500,6500,"Sub-basin 4"
879,1100,153,2400,3500,"Sub-basin 4"
880,400,31,1400,1800,"Sub-basin 4"
881,6300,1299,24400,30700,"Sub-basin 4"
882,2600,438,6900,9500,"Sub-basin 4"
883,600,82.67,2900,3500,"Sub-basin 4"
884,1600,316,8300,9900,"Sub-basin 4"
885,100,2,2000,2100,"Sub-basin 4"
886,3700,593,24400,28100,"Sub-basin 4"
887,600,230,2200,2800,"Sub-basin 4"
888,100,2,900,1000,"Sub-basin 4"
889,6500,1752,17100,23600,"Sub-basin 4"
890,10200,5040,12000,22200,"Sub-basin 4"
891,6600,605,24000,30600,"Sub-basin 4"
892,800,233,1800,2600,"Sub-basin 4"
893,600,187,1900,2500,"Sub-basin 4"
894,600,44,2100,2700,"Sub-basin 4"
895,1200,138,3800,5000,"Sub-basin 4"
896,1900,603,7400,9300,"Sub-basin 4"
897,3100,614,8200,11300,"Sub-basin 4"
898,200,8,1900,2100,"Sub-basin 4"
899,900,349,2000,2900,"Sub-basin 4"
900,2200,337,6500,8700,"Sub-basin 4"
901,100,1,1300,1400,"Sub-basin 4"
902,100,1,1300,1400,"Sub-basin 4"
903,2800,584,12200,15000,"Sub-basin 4"
904,1800,415,4800,6600,"Sub-basin 4"
905,300,29,1600,1900,"Sub-basin 4"
906,1800,592,9100,10900,"Sub-basin 4"
907,1100,184,3100,4200,"Sub-basin 4"
908,1200,147,5400,6600,"Sub-basin 4"
909,300,34,2700,3000,"Sub-basin 4"
910,3400,857,10200,13600,"Sub-basin 4"
911,600,34,5100,5700,"Sub-basin 4"
912,400,43,2300,2700,"Sub-basin 4"
913,100,1,1600,1700,"Sub-basin 4"
914,700,34,5500,6200,"Sub-basin 4"
915,1600,250,5200,6800,"Sub-basin 4"
916,1300,409,3800,5100,"Sub-basin 4"
917,800,71,4100,4900,"Sub-basin 4"
918,500,62,1700,2200,"Sub-basin 4"
919,500,104,3700,4200,"Sub-basin 4"
920,200,7,4100,4300,"Sub-basin 4"
921,700,39,11300,12000,"Sub-basin 4"
922,100,2,500,600,"Sub-basin 4"
923,7000,2492.5,12200,19200,"Sub-basin 4"
924,3000,698,6800,9800,"Sub-basin 4"
925,1000,116,3000,4000,"Sub-basin 4"
926,2800,735,4200,7000,"Sub-basin 4"
927,900,118,3400,4300,"Sub-basin 4"
928,4200,834,15000,19200,"Sub-basin 4"
929,400,56,3200,3600,"Sub-basin 4"
930,200,6,2300,2500,"Sub-basin 4"
931,100,1,2400,2500,"Sub-basin 4"
932,100,2,900,1000,"Sub-basin 4"
933,400,31,2400,2800,"Sub-basin 4"
934,200,9,1400,1600,"Sub-basin 4"
935,2100,541,6800,8900,"Sub-basin 4"
936,4600,1186,15200,19800,"Sub-basin 4"
937,2500,805,7700,10200,"Sub-basin 4"
938,400,23,3500,3900,"Sub-basin 4"
939,800,37,4200,5000,"Sub-basin 4"
940,100,7,1400,1500,"Sub-basin 4"
941,1000,140,4200,5200,"Sub-basin 4"
942,4700,1591,7200,11900,"Sub-basin 4"
943,600,107,2200,2800,"Sub-basin 4"
944,100,1,700,800,"Sub-basin 4"
945,400,64,4400,4800,"Sub-basin 4"
946,700,86,2400,3100,"Sub-basin 4"
947,700,28,2800,3500,"Sub-basin 4"
948,11600,2514.99,67300,78900,"Sub-basin 4"
949,600,91,2900,3500,"Sub-basin 4"
950,3000,491,9900,12900,"Sub-basin 4"
951,1200,336,3200,4400,"Sub-basin 4"
952,1500,156,5500,7000,"Sub-basin 4"
953,200,8,2100,2300,"Sub-basin 4"
954,400,28,1100,1500,"Sub-basin 4"
955,400,23,3100,3500,"Sub-basin 4"
956,200,2,3600,3800,"Sub-basin 4"
957,12200,2701,21900,34100,"Sub-basin 4"
958,2300,226,9100,11400,"Sub-basin 4"
959,400,78,600,1000,"Sub-basin 4"
960,1500,233,4600,6100,"Sub-basin 4"
961,500,35,1000,1500,"Sub-basin 4"
962,7400,2897,10400,17800,"Sub-basin 4"
963,700,143,3100,3800,"Sub-basin 4"
964,100,2,1600,1700,"Sub-basin 4"
965,1800,529,4100,5900,"Sub-basin 4"
966,400,40,2000,2400,"Sub-basin 4"
967,900,90,8600,9500,"Sub-basin 4"
968,100,3,900,1000,"Sub-basin 4"
969,200,11,3700,3900,"Sub-basin 4"
970,100,7,1300,1400,"Sub-basin 4"
971,1400,372,2300,3700,"Sub-basin 4"
972,1700,134,7200,8900,"Sub-basin 4"
973,3100,637,12300,15400,"Sub-basin 4"
974,100,1,1200,1300,"Sub-basin 4"
975,500,35,3100,3600,"Sub-basin 4"
976,200,6,1800,2000,"Sub-basin 4"
977,1200,68,6000,7200,"Sub-basin 4"
978,1500,101,11800,13300,"Sub-basin 4"
979,500,64,5500,6000,"Sub-basin 4"
980,4600,609,38600,43200,"Sub-basin 4"
981,8700,2191,19100,27800,"Sub-basin 4"
982,100,4,500,600,"Sub-basin 4"
983,600,89,3000,3600,"Sub-basin 4"
984,500,78,2800,3300,"Sub-basin 4"
985,14500,3714,32400,46900,"Sub-basin 4"
986,26200,11567,25200,51400,"Sub-basin 4"
987,400,9,900,1300,"Sub-basin 4"
988,100,1,1100,1200,"Sub-basin 4"
989,2500,419,6600,9100,"Sub-basin 4"
990,1800,919,4800,6600,"Sub-basin 4"
991,800,122,5300,6100,"Sub-basin 4"
992,400,71,2200,2600,"Sub-basin 4"
993,1000,144,2400,3400,"Sub-basin 4"
994,400,20,1200,1600,"Sub-basin 4"
995,2600,590,7700,10300,"Sub-basin 4"
996,400,35,700,1100,"Sub-basin 4"
997,1800,221,4700,6500,"Sub-basin 4"
998,800,153,4400,5200,"Sub-basin 4"
999,100,1,3300,3400,"Sub-basin 4"
1000,3100,1197,4300,7400,"Sub-basin 4"
1001,200,8,1700,1900,"Sub-basin 4"
1002,30500,8930,53300,83800,"Sub-basin 4"
1003,100,2,1300,1400,"Sub-basin 4"
1004,100,4,800,900,"Sub-basin 4"
1005,500,24,2400,2900,"Sub-basin 4"
1006,1700,605,2400,4100,"Sub-basin 4"
1007,500,90,1900,2400,"Sub-basin 4"
1008,800,94,3300,4100,"Sub-basin 4"
1009,300,20,600,900,"Sub-basin 4"
1010,700,119,2100,2800,"Sub-basin 4"
1011,900,139,1800,2700,"Sub-basin 4"
1012,200,6,2000,2200,"Sub-basin 4"
1013,2300,487,6400,8700,"Sub-basin 4"
1014,2100,232,9900,12000,"Sub-basin 4"
1015,800,56,9200,10000,"Sub-basin 4"
1016,100,1,1100,1200,"Sub-basin 4"
1017,1300,309,6000,7300,"Sub-basin 4"
1018,700,43,2300,3000,"Sub-basin 4"
1019,100,8,900,1000,"Sub-basin 4"
1020,400,56,3100,3500,"Sub-basin 4"
1021,200,4,1600,1800,"Sub-basin 4"
1022,700,65,9800,10500,"Sub-basin 4"
1023,100,5,1500,1600,"Sub-basin 4"
1024,100,1,1900,2000,"Sub-basin 4"
1025,600,82,2400,3000,"Sub-basin 4"
1026,1800,430,5200,7000,"Sub-basin 4"
1027,200,11,900,1100,"Sub-basin 4"
1028,3400,1057,5800,9200,"Sub-basin 4"
1029,700,83,4800,5500,"Sub-basin 4"
1030,1000,205,4000,5000,"Sub-basin 4"
1031,900,60,9300,10200,"Sub-basin 4"
1032,200,9,1200,1400,"Sub-basin 4"
1033,700,54,4400,5100,"Sub-basin 4"
1034,100,9,1100,1200,"Sub-basin 4"
1035,17000,3304,49500,66500,"Sub-basin 4"
1036,100,2,1400,1500,"Sub-basin 4"
1037,300,32,2800,3100,"Sub-basin 4"
1038,600,53,3200,3800,"Sub-basin 4"
1039,2900,401.66,18100,21000,"Sub-basin 4"
1040,800,243,2900,3700,"Sub-basin 4"
1041,3000,1140,5400,8400,"Sub-basin 4"
1042,3900,716,9500,13400,"Sub-basin 4"
1043,300,4,4600,4900,"Sub-basin 4"
1044,300,13,1700,2000,"Sub-basin 4"
1045,600,132,3400,4000,"Sub-basin 4"
1046,100,4,700,800,"Sub-basin 4"
1047,22300,9685,35600,57900,"Sub-basin 4"
1048,1000,191,3900,4900,"Sub-basin 4"
1049,600,85,5300,5900,"Sub-basin 4"
1050,400,38,1700,2100,"Sub-basin 4"
1051,10600,2319,21400,32000,"Sub-basin 4"
1052,400,18,3600,4000,"Sub-basin 4"
1053,100,1,600,700,"Sub-basin 4"
1054,200,5,1900,2100,"Sub-basin 4"
1055,400,74,1800,2200,"Sub-basin 4"
1056,2900,632,10500,13400,"Sub-basin 4"
1057,1000,117,3900,4900,"Sub-basin 4"
1058,400,30,700,1100,"Sub-basin 4"
1059,300,14,3100,3400,"Sub-basin 4"
1060,200,14,2200,2400,"Sub-basin 4"
1061,200,12,1500,1700,"Sub-basin 4"
1062,8100,2315,9100,17200,"Sub-basin 4"
1063,600,50,3000,3600,"Sub-basin 4"
1064,2700,290,13500,16200,"Sub-basin 4"
1065,100,3,1000,1100,"Sub-basin 4"
1066,1000,311,5100,6100,"Sub-basin 4"
1067,100,2,1800,1900,"Sub-basin 4"
1068,100,1,2500,2600,"Sub-basin 4"
1069,1100,175,5100,6200,"Sub-basin 4"
1070,200,25,1900,2100,"Sub-basin 4"
1071,2900,1058,7000,9900,"Sub-basin 4"
1072,1400,602,4100,5500,"Sub-basin 4"
1073,200,8,1400,1600,"Sub-basin 4"
1074,800,226,5200,6000,"Sub-basin 4"
1075,300,29,2300,2600,"Sub-basin 4"
1076,8800,1415.67,41700,50500,"Sub-basin 4"
1077,100,7,300,400,"Sub-basin 4"
1078,400,30,1700,2100,"Sub-basin 4"
1079,200,6,3200,3400,"Sub-basin 4"
1080,200,3,2000,2200,"Sub-basin 4"
1081,400,22,2600,3000,"Sub-basin 4"
1082,7300,1181,65900,73200,"Sub-basin 4"
1083,4200,1069,10000,14200,"Sub-basin 4"
1084,5200,825,9700,14900,"Sub-basin 4"
1085,200,8,600,800,"Sub-basin 4"
1086,23700,7665,47500,71200,"Sub-basin 4"
1087,800,46,6600,7400,"Sub-basin 4"
1088,500,10,5800,6300,"Sub-basin 4"
1089,200,3,1400,1600,"Sub-basin 4"
1090,1500,314,4000,5500,"Sub-basin 4"
1091,700,113,4600,5300,"Sub-basin 4"
1092,400,23,3700,4100,"Sub-basin 4"
1093,400,42,2700,3100,"Sub-basin 4"
1094,5500,887,15600,21100,"Sub-basin 4"
1095,1000,63,7800,8800,"Sub-basin 4"
1096,600,72,1500,2100,"Sub-basin 4"
1097,900,143,2300,3200,"Sub-basin 4"
1098,200,14,800,1000,"Sub-basin 4"
1099,100,1,100,200,"Sub-basin 4"
1100,100,1,1400,1500,"Sub-basin 4"
1101,200,2,3000,3200,"Sub-basin 4"
1102,400,43,1400,1800,"Sub-basin 4"
1103,200,16,800,1000,"Sub-basin 4"
1104,200,50,1900,2100,"Sub-basin 4"
1105,200,4,2000,2200,"Sub-basin 4"
1106,400,86,1500,1900,"Sub-basin 4"
1107,100,1,100,200,"Sub-basin 4"
1108,300,10,1100,1400,"Sub-basin 4"
1109,200,7,2600,2800,"Sub-basin 4"
1110,200,9,2900,3100,"Sub-basin 4"
1111,500,45,2500,3000,"Sub-basin 4"
1112,100,2,1300,1400,"Sub-basin 4"
1113,1700,281,9000,10700,"Sub-basin 4"
1114,2900,1200,6800,9700,"Sub-basin 4"
1115,1000,426,2200,3200,"Sub-basin 4"
1116,400,51,900,1300,"Sub-basin 4"
1117,300,65,3800,4100,"Sub-basin 4"
1118,5100,1542,8000,13100,"Sub-basin 4"
1119,100,4,1200,1300,"Sub-basin 4"
1120,200,8,400,600,"Sub-basin 4"
1121,300,19,2500,2800,"Sub-basin 4"
1122,800,80,2400,3200,"Sub-basin 4"
1123,500,34,2800,3300,"Sub-basin 4"
1124,900,145,8100,9000,"Sub-basin 4"
1125,400,17,6500,6900,"Sub-basin 4"
1126,600,62,5100,5700,"Sub-basin 4"
1127,2900,443,9800,12700,"Sub-basin 4"
1128,100,2,1400,1500,"Sub-basin 4"
1129,100,4,800,900,"Sub-basin 4"
1130,500,28,2900,3400,"Sub-basin 4"
1131,4800,1805,10100,14900,"Sub-basin 4"
1132,1700,190,6300,8000,"Sub-basin 4"
1133,100,5,1000,1100,"Sub-basin 4"
1134,400,21,4300,4700,"Sub-basin 4"
1135,300,10,4900,5200,"Sub-basin 4"
1136,100,5,1400,1500,"Sub-basin 4"
1137,200,3,1400,1600,"Sub-basin 4"
1138,2000,546,3000,5000,"Sub-basin 4"
1139,800,74,2300,3100,"Sub-basin 4"
1140,100,11,900,1000,"Sub-basin 4"
1141,900,57,6600,7500,"Sub-basin 4"
1142,400,22,2800,3200,"Sub-basin 4"
1143,1200,90,16900,18100,"Sub-basin 4"
1144,900,77,3200,4100,"Sub-basin 4"
1145,300,6,1900,2200,"Sub-basin 4"
1146,100,1,1800,1900,"Sub-basin 4"
1147,800,83,3200,4000,"Sub-basin 4"
1148,100,6,1100,1200,"Sub-basin 4"
1149,200,2,2700,2900,"Sub-basin 4"
1150,100,1,800,900,"Sub-basin 4"
1151,5800,934,23900,29700,"Sub-basin 4"
1152,400,63,4000,4400,"Sub-basin 4"
1153,200,2,600,800,"Sub-basin 4"
1154,600,57,4000,4600,"Sub-basin 4"
1155,1100,87,6200,7300,"Sub-basin 4"
1156,100,5,500,600,"Sub-basin 4"
1157,400,12,4000,4400,"Sub-basin 4"
1158,100,1,1500,1600,"Sub-basin 4"
1159,900,370,6500,7400,"Sub-basin 4"
1160,2000,1084,9700,11700,"Sub-basin 4"
1161,100,2,1700,1800,"Sub-basin 4"
1162,500,38,2900,3400,"Sub-basin 4"
1163,200,2,2100,2300,"Sub-basin 4"
1164,3900,644,15400,19300,"Sub-basin 4"
1165,1300,198.21,6100,7400,"Sub-basin 4"
1166,700,64,2900,3600,"Sub-basin 4"
1167,1100,91,5000,6100,"Sub-basin 4"
1168,2700,785,6600,9300,"Sub-basin 4"
1169,700,193,2900,3600,"Sub-basin 4"
1170,200,3,4400,4600,"Sub-basin 4"
1171,200,4,2400,2600,"Sub-basin 4"
1172,800,130,4400,5200,"Sub-basin 4"
1173,2000,260,10100,12100,"Sub-basin 4"
1174,300,14,4100,4400,"Sub-basin 4"
1175,100,3,600,700,"Sub-basin 4"
1176,300,5,3000,3300,"Sub-basin 4"
1177,200,4,3700,3900,"Sub-basin 4"
1178,100,2,1400,1500,"Sub-basin 4"
1179,100,2,1500,1600,"Sub-basin 4"
1180,5500,1564,9800,15300,"Sub-basin 4"
1181,500,21,3300,3800,"Sub-basin 4"
1182,300,18,4700,5000,"Sub-basin 4"
1183,100,1,1200,1300,"Sub-basin 4"
1184,2000,628,3700,5700,"Sub-basin 4"
1185,100,1,1700,1800,"Sub-basin 4"
1186,400,9,4000,4400,"Sub-basin 4"
1187,3100,1038,17400,20500,"Sub-basin 4"
1188,32700,9601,38500,71200,"Sub-basin 4"
1189,6900,1593,17200,24100,"Sub-basin 4"
1190,400,18,1000,1400,"Sub-basin 4"
1191,200,3,1300,1500,"Sub-basin 4"
1192,300,26,3600,3900,"Sub-basin 4"
1193,100,2,1500,1600,"Sub-basin 4"
1194,300,10,3700,4000,"Sub-basin 4"
1195,1000,208,5400,6400,"Sub-basin 4"
1196,1000,31,6000,7000,"Sub-basin 4"
1197,2400,170,19900,22300,"Sub-basin 4"
1198,100,3,2500,2600,"Sub-basin 4"
1199,400,28,2200,2600,"Sub-basin 4"
1200,1600,164,6800,8400,"Sub-basin 4"
1201,12600,3504,15100,27700,"Sub-basin 4"
1202,300,19,3400,3700,"Sub-basin 4"
1203,200,4,1900,2100,"Sub-basin 4"
1204,1800,202,19200,21000,"Sub-basin 4"
1205,100,1,1300,1400,"Sub-basin 4"
1206,1800,183,8000,9800,"Sub-basin 4"
1207,400,43,2500,2900,"Sub-basin 4"
1208,300,8,2200,2500,"Sub-basin 4"
1209,900,158,3800,4700,"Sub-basin 4"
1210,2000,517.33,6100,8100,"Sub-basin 4"
1211,800,180,2900,3700,"Sub-basin 4"
1212,2400,862,8100,10500,"Sub-basin 4"
1213,100,2,1600,1700,"Sub-basin 4"
1214,300,9,2100,2400,"Sub-basin 4"
1215,400,15,4700,5100,"Sub-basin 4"
1216,1300,71,8600,9900,"Sub-basin 4"
1217,900,249,2100,3000,"Sub-basin 4"
1218,200,10,1700,1900,"Sub-basin 4"
1219,800,136,4000,4800,"Sub-basin 4"
1220,700,217,4000,4700,"Sub-basin 4"
1221,200,3,3600,3800,"Sub-basin 4"
1222,600,22,4200,4800,"Sub-basin 4"
1223,100,1,1700,1800,"Sub-basin 4"
1224,2500,194,10500,13000,"Sub-basin 4"
1225,200,4,1400,1600,"Sub-basin 4"
1226,2200,502,8400,10600,"Sub-basin 4"
1227,500,40,3700,4200,"Sub-basin 4"
1228,200,10,1200,1400,"Sub-basin 4"
1229,800,37.68,6200,7000,"Sub-basin 4"
1230,1200,527,4500,5700,"Sub-basin 4"
1231,4700,1404,13500,18200,"Sub-basin 4"
1232,1000,306,3100,4100,"Sub-basin 4"
1233,300,14,3400,3700,"Sub-basin 4"
1234,400,36,4400,4800,"Sub-basin 4"
1235,200,8,1500,1700,"Sub-basin 4"
1236,100,4,1300,1400,"Sub-basin 4"
1237,900,59,5700,6600,"Sub-basin 4"
1238,200,6,1800,2000,"Sub-basin 4"
1239,2200,280,10700,12900,"Sub-basin 4"
1240,500,48,4400,4900,"Sub-basin 4"
1241,1200,308,6700,7900,"Sub-basin 4"
1242,700,138,4400,5100,"Sub-basin 4"
1243,2000,728,11200,13200,"Sub-basin 4"
1244,100,3,2200,2300,"Sub-basin 4"
1245,600,26.02,2100,2700,"Sub-basin 4"
1246,7000,1065,31400,38400,"Sub-basin 4"
1247,700,40,13100,13800,"Sub-basin 4"
1248,200,20,2000,2200,"Sub-basin 4"
1249,500,67,3400,3900,"Sub-basin 4"
1250,100,1,1900,2000,"Sub-basin 4"
1251,1200,290,4300,5500,"Sub-basin 4"
1252,100,1,1800,1900,"Sub-basin 4"
1253,700,57,4700,5400,"Sub-basin 4"
1254,9600,2705,19200,28800,"Sub-basin 4"
1255,4700,854,14200,18900,"Sub-basin 4"
1256,100,3,1500,1600,"Sub-basin 4"
1257,1500,434,7900,9400,"Sub-basin 4"
1258,300,18,3800,4100,"Sub-basin 4"
1259,2400,686,12400,14800,"Sub-basin 4"
1260,400,14,3100,3500,"Sub-basin 4"
1261,200,3,2000,2200,"Sub-basin 4"
1262,3400,1263,10600,14000,"Sub-basin 4"
1263,200,3,2200,2400,"Sub-basin 4"
1264,200,13,3800,4000,"Sub-basin 4"
1265,200,4,2200,2400,"Sub-basin 4"
1266,400,12,6000,6400,"Sub-basin 4"
1267,400,62,3000,3400,"Sub-basin 4"
1268,400,47,2800,3200,"Sub-basin 4"
1269,600,125,8100,8700,"Sub-basin 4"
1270,2600,476,10800,13400,"Sub-basin 4"
1271,200,8,2100,2300,"Sub-basin 4"
1272,100,1,900,1000,"Sub-basin 4"
1273,2300,740,10300,12600,"Sub-basin 4"
1274,200,13,1500,1700,"Sub-basin 4"
1275,400,18,3000,3400,"Sub-basin 4"
1276,1200,174,3600,4800,"Sub-basin 4"
1277,2600,673,9600,12200,"Sub-basin 4"
1278,100,1,1500,1600,"Sub-basin 4"
1279,1000,156,7700,8700,"Sub-basin 4"
1280,1500,247,9300,10800,"Sub-basin 4"
1281,100,3,1100,1200,"Sub-basin 4"
1282,300,7,2400,2700,"Sub-basin 4"
1283,1200,92,3800,5000,"Sub-basin 4"
1284,200,2,4000,4200,"Sub-basin 4"
1285,54200,16143,68700,122900,"Sub-basin 4"
1286,100,7,1000,1100,"Sub-basin 4"
1287,2600,223,28900,31500,"Sub-basin 4"
1288,600,49,4800,5400,"Sub-basin 4"
1289,1300,285,10000,11300,"Sub-basin 4"
1290,800,107,7800,8600,"Sub-basin 4"
1291,100,2,1200,1300,"Sub-basin 4"
1292,300,11,2900,3200,"Sub-basin 4"
1293,100,3,1300,1400,"Sub-basin 4"
1294,300,10,2600,2900,"Sub-basin 4"
1295,100,1,1800,1900,"Sub-basin 4"
1296,3200,419,12700,15900,"Sub-basin 4"
1297,200,3,600,800,"Sub-basin 4"
1298,12000,1708,37200,49200,"Sub-basin 4"
1299,100,1,1200,1300,"Sub-basin 4"
1300,1100,163,7000,8100,"Sub-basin 4"
1301,2400,465,8400,10800,"Sub-basin 4"
1302,100,1,2300,2400,"Sub-basin 4"
1303,5000,1112,11400,16400,"Sub-basin 4"
1304,300,10,3700,4000,"Sub-basin 4"
1305,900,39,9800,10700,"Sub-basin 4"
1306,100,1,900,1000,"Sub-basin 4"
1307,45500,16717,88900,134400,"Sub-basin 4"
1308,200,2,2500,2700,"Sub-basin 4"
1309,300,4,2600,2900,"Sub-basin 4"
1310,600,141,4000,4600,"Sub-basin 4"
1311,200,9,1600,1800,"Sub-basin 4"
1312,11300,4746,19900,31200,"Sub-basin 4"
1313,400,51.68,5900,6300,"Sub-basin 4"
1314,800,79,3000,3800,"Sub-basin 4"
1315,16900,4124.83,48500,65400,"Sub-basin 4"
1316,500,115,2100,2600,"Sub-basin 4"
1317,1400,283,2500,3900,"Sub-basin 4"
1318,100,1,2200,2300,"Sub-basin 4"
1319,500,95,4100,4600,"Sub-basin 4"
1320,500,37,1900,2400,"Sub-basin 4"
1321,100,1,2200,2300,"Sub-basin 4"
1322,5900,1139,24400,30300,"Sub-basin 4"
1323,5000,663,17200,22200,"Sub-basin 4"
1324,100,2,1500,1600,"Sub-basin 4"
1325,400,10,5500,5900,"Sub-basin 4"
1326,700,15,8200,8900,"Sub-basin 4"
1327,100,2,1600,1700,"Sub-basin 4"
1328,2800,425,19100,21900,"Sub-basin 4"
1329,2500,452,13500,16000,"Sub-basin 4"
1330,900,179,2300,3200,"Sub-basin 4"
1331,200,2,3900,4100,"Sub-basin 4"
1332,100,1,2900,3000,"Sub-basin 4"
1333,600,46,1900,2500,"Sub-basin 4"
1334,200,3,900,1100,"Sub-basin 4"
1335,1400,209,11100,12500,"Sub-basin 4"
1336,100,3,2000,2100,"Sub-basin 4"
1337,100,2,1700,1800,"Sub-basin 4"
1338,200,5,4100,4300,"Sub-basin 4"
1339,800,39,16100,16900,"Sub-basin 4"
1340,600,54,3500,4100,"Sub-basin 4"
1341,1400,55,12100,13500,"Sub-basin 4"
1342,1500,502,3200,4700,"Sub-basin 4"
1343,100,5,1900,2000,"Sub-basin 4"
1344,2300,156,18100,20400,"Sub-basin 4"
1345,400,16,2900,3300,"Sub-basin 4"
1346,15900,4530,25300,41200,"Sub-basin 4"
1347,200,4,1700,1900,"Sub-basin 4"
1348,400,43,900,1300,"Sub-basin 4"
1349,600,11,7600,8200,"Sub-basin 4"
1350,1500,192,5700,7200,"Sub-basin 4"
1351,100,1,1000,1100,"Sub-basin 4"
1352,100,1,2100,2200,"Sub-basin 4"
1353,200,2,3100,3300,"Sub-basin 4"
1354,100,1,2900,3000,"Sub-basin 4"
1355,23900,6247,54900,78800,"Sub-basin 4"
1356,500,47,2800,3300,"Sub-basin 4"
1357,1500,186,8200,9700,"Sub-basin 4"
1358,700,42,4400,5100,"Sub-basin 4"
1359,400,17,2400,2800,"Sub-basin 4"
1360,2400,705,7400,9800,"Sub-basin 4"
1361,100,4,600,700,"Sub-basin 4"
1362,800,132,5000,5800,"Sub-basin 4"
1363,300,5,3000,3300,"Sub-basin 4"
1364,1600,214,10300,11900,"Sub-basin 4"
1365,100,1,1200,1300,"Sub-basin 4"
1366,300,11,4400,4700,"Sub-basin 4"
1367,400,11,6500,6900,"Sub-basin 4"
1368,100,2,1800,1900,"Sub-basin 4"
1369,500,16,2800,3300,"Sub-basin 4"
1370,1300,294,5000,6300,"Sub-basin 4"
1371,1200,315,4600,5800,"Sub-basin 4"
1372,2300,724,9700,12000,"Sub-basin 4"
1373,6000,1387,11900,17900,"Sub-basin 4"
1374,500,45,2800,3300,"Sub-basin 4"
1375,200,16,1900,2100,"Sub-basin 4"
1376,800,189,2800,3600,"Sub-basin 4"
1377,300,7,2100,2400,"Sub-basin 4"
1378,800,44,3300,4100,"Sub-basin 4"
1379,300,14,1800,2100,"Sub-basin 4"
1380,2700,426,10800,13500,"Sub-basin 4"
1381,1300,171,4400,5700,"Sub-basin 4"
1382,800,65,12500,13300,"Sub-basin 4"
1383,200,3,4100,4300,"Sub-basin 4"
1384,6700,827,36200,42900,"Sub-basin 4"
1385,100,2,1500,1600,"Sub-basin 4"
1386,16700,5221,36100,52800,"Sub-basin 4"
1387,100,2,1200,1300,"Sub-basin 4"
1388,1900,229.34,11300,13200,"Sub-basin 4"
1389,600,42,3400,4000,"Sub-basin 4"
1390,200,6,1100,1300,"Sub-basin 4"
1391,400,23,2200,2600,"Sub-basin 4"
1392,300,8,5400,5700,"Sub-basin 4"
1393,500,29,11400,11900,"Sub-basin 4"
1394,900,61,5000,5900,"Sub-basin 4"
1395,2700,751,9400,12100,"Sub-basin 4"
1396,400,12,4700,5100,"Sub-basin 4"
1397,300,31,2100,2400,"Sub-basin 4"
1398,2200,504,7800,10000,"Sub-basin 4"
1399,2900,1071,7200,10100,"Sub-basin 4"
1400,1000,246,5500,6500,"Sub-basin 4"
1401,100,3,2400,2500,"Sub-basin 4"
1402,1800,97,12800,14600,"Sub-basin 4"
1403,1800,237,4100,5900,"Sub-basin 4"
1404,1500,67,12600,14100,"Sub-basin 4"
1405,800,133,2500,3300,"Sub-basin 4"
1406,1200,541,3600,4800,"Sub-basin 4"
1407,1100,119,4300,5400,"Sub-basin 4"
1408,500,10,5400,5900,"Sub-basin 4"
1409,200,11,2000,2200,"Sub-basin 4"
1410,400,64,2200,2600,"Sub-basin 4"
1411,200,8,1200,1400,"Sub-basin 4"
1412,100,1,100,200,"Sub-basin 4"
1413,1200,346,3800,5000,"Sub-basin 4"
1414,1200,138,12000,13200,"Sub-basin 4"
1415,300,18,1600,1900,"Sub-basin 4"
1416,500,18,3200,3700,"Sub-basin 4"
1417,300,22,2400,2700,"Sub-basin 4"
1418,100,1,1300,1400,"Sub-basin 4"
1419,100,4,1800,1900,"Sub-basin 4"
1420,100,2,2600,2700,"Sub-basin 4"
1421,300,9,1000,1300,"Sub-basin 4"
1422,300,14,2500,2800,"Sub-basin 4"
1423,2600,661,8800,11400,"Sub-basin 4"
1424,1600,329,9400,11000,"Sub-basin 4"
1425,3000,556,17000,20000,"Sub-basin 4"
1426,800,125,4500,5300,"Sub-basin 4"
1427,1900,373,8600,10500,"Sub-basin 4"
1428,1700,726,4500,6200,"Sub-basin 4"
1429,2200,504,4900,7100,"Sub-basin 4"
1430,1700,201,11200,12900,"Sub-basin 4"
1431,100,1,1300,1400,"Sub-basin 4"
1432,800,68,8200,9000,"Sub-basin 4"
1433,500,75,2100,2600,"Sub-basin 4"
1434,1600,519,3900,5500,"Sub-basin 4"
1435,200,8,2900,3100,"Sub-basin 4"
1436,100,1,2500,2600,"Sub-basin 4"
1437,400,9,2700,3100,"Sub-basin 4"
1438,300,18,1900,2200,"Sub-basin 4"
1439,200,4,1500,1700,"Sub-basin 4"
1440,100,2,900,1000,"Sub-basin 4"
1441,400,29,3400,3800,"Sub-basin 4"
1442,6700,799,14500,21200,"Sub-basin 4"
1443,100,5,1600,1700,"Sub-basin 4"
1444,800,68,14000,14800,"Sub-basin 4"
1445,100,1,2500,2600,"Sub-basin 4"
1446,200,5,4800,5000,"Sub-basin 4"
1447,1600,159,7600,9200,"Sub-basin 4"
1448,2900,662,8800,11700,"Sub-basin 4"
1449,800,55,5600,6400,"Sub-basin 4"
1450,1600,230,7000,8600,"Sub-basin 4"
1451,3200,314,33900,37100,"Sub-basin 4"
1452,200,12,300,500,"Sub-basin 4"
1453,100,2,1600,1700,"Sub-basin 4"
1454,5100,2242,9200,14300,"Sub-basin 4"
1455,6000,1450,11100,17100,"Sub-basin 4"
1456,300,34,5100,5400,"Sub-basin 4"
1457,1300,180,6400,7700,"Sub-basin 4"
1458,22400,7252,43400,65800,"Sub-basin 4"
1459,600,74,2300,2900,"Sub-basin 4"
1460,2100,195,21900,24000,"Sub-basin 4"
1461,1400,195,5100,6500,"Sub-basin 4"
1462,3900,1496.33,8600,12500,"Sub-basin 4"
1463,700,81,5900,6600,"Sub-basin 4"
1464,100,1,1300,1400,"Sub-basin 4"
1465,2700,738,7800,10500,"Sub-basin 4"
1466,100,3,3200,3300,"Sub-basin 4"
1467,100,1,800,900,"Sub-basin 4"
1468,1100,76,7200,8300,"Sub-basin 4"
1469,200,2,1500,1700,"Sub-basin 4"
1470,900,98,4900,5800,"Sub-basin 4"
1471,400,51,1800,2200,"Sub-basin 4"
1472,2600,510.84,10000,12600,"Sub-basin 4"
1473,700,52,6600,7300,"Sub-basin 4"
1474,900,102,4300,5200,"Sub-basin 4"
1475,2000,182,10100,12100,"Sub-basin 4"
1476,1000,100,6400,7400,"Sub-basin 4"
1477,2600,1445,7900,10500,"Sub-basin 4"
1478,700,121,3100,3800,"Sub-basin 4"
1479,100,1,1700,1800,"Sub-basin 4"
1480,300,16,6300,6600,"Sub-basin 4"
1481,100,1,1500,1600,"Sub-basin 4"
1482,200,6,2100,2300,"Sub-basin 4"
1483,1000,69,3200,4200,"Sub-basin 4"
1484,900,135,6100,7000,"Sub-basin 4"
1485,1300,253,8100,9400,"Sub-basin 4"
1486,3300,584,11700,15000,"Sub-basin 4"
1487,15000,4901,24600,39600,"Sub-basin 4"
1488,1100,111,6700,7800,"Sub-basin 4"
1489,100,1,600,700,"Sub-basin 4"
1490,300,29,3800,4100,"Sub-basin 4"
1491,2700,542,8600,11300,"Sub-basin 4"
1492,400,65,2200,2600,"Sub-basin 4"
1493,100,1,900,1000,"Sub-basin 4"
1494,500,25,5800,6300,"Sub-basin 4"
1495,200,7,1900,2100,"Sub-basin 4"
1496,300,19,2400,2700,"Sub-basin 4"
1497,11500,2618,69900,81400,"Sub-basin 4"
1498,800,63,6400,7200,"Sub-basin 4"
1499,1900,509,8000,9900,"Sub-basin 4"
1500,100,2.83,2400,2500,"Sub-basin 4"
1501,100,2,500,600,"Sub-basin 4"
1502,400,32.5,1100,1500,"Sub-basin 4"
1503,700,19,8500,9200,"Sub-basin 4"
1504,2100,195,10600,12700,"Sub-basin 4"
1505,100,4.33,1700,1800,"Sub-basin 4"
1506,100,1,1200,1300,"Sub-basin 4"
1507,400,10,2100,2500,"Sub-basin 4"
1508,100,2,1200,1300,"Sub-basin 4"
1509,100,6,3100,3200,"Sub-basin 4"
1510,9200,5017,7100,16300,"Sub-basin 4"
1511,100,4,1300,1400,"Sub-basin 4"
1512,1700,616,6400,8100,"Sub-basin 4"
1513,1900,284,4100,6000,"Sub-basin 4"
1514,3200,325,11500,14700,"Sub-basin 4"
1515,2100,193,24300,26400,"Sub-basin 4"
1516,100,1,1600,1700,"Sub-basin 4"
1517,300,10,900,1200,"Sub-basin 4"
1518,3800,328.34,13700,17500,"Sub-basin 4"
1519,400,21,1600,2000,"Sub-basin 4"
1520,100,1,1600,1700,"Sub-basin 4"
1521,100,3,1200,1300,"Sub-basin 4"
1522,400,43,2400,2800,"Sub-basin 4"
1523,7800,2467,27700,35500,"Sub-basin 4"
1524,600,50,4600,5200,"Sub-basin 4"
1525,1400,283,5800,7200,"Sub-basin 4"
1526,1800,456,8100,9900,"Sub-basin 4"
1527,200,7,5200,5400,"Sub-basin 4"
1528,1400,95,5900,7300,"Sub-basin 4"
1529,3900,344,17500,21400,"Sub-basin 4"
1530,100,1,800,900,"Sub-basin 4"
1531,100,3,700,800,"Sub-basin 4"
1532,1800,463,4200,6000,"Sub-basin 4"
1533,2500,295,11700,14200,"Sub-basin 4"
1534,800,112,3400,4200,"Sub-basin 4"
1535,4400,553,21200,25600,"Sub-basin 4"
1536,700,117,3400,4100,"Sub-basin 4"
1537,3500,399,27300,30800,"Sub-basin 4"
1538,3300,227,38900,42200,"Sub-basin 4"
1539,300,4,2300,2600,"Sub-basin 4"
1540,200,9,800,1000,"Sub-basin 4"
1541,200,15,2800,3000,"Sub-basin 4"
1542,900,86,4100,5000,"Sub-basin 4"
1543,200,5,2300,2500,"Sub-basin 4"
1544,300,9,2300,2600,"Sub-basin 4"
1545,11200,3129,43800,55000,"Sub-basin 4"
1546,100,3,1000,1100,"Sub-basin 4"
1547,8200,3430,12900,21100,"Sub-basin 4"
1548,200,6,2600,2800,"Sub-basin 4"
1549,12600,1457,33900,46500,"Sub-basin 4"
1550,1000,84,13700,14700,"Sub-basin 4"
1551,1000,52,5500,6500,"Sub-basin 4"
1552,100,1,1400,1500,"Sub-basin 4"
1553,400,21,3800,4200,"Sub-basin 4"
1554,2500,833,4700,7200,"Sub-basin 4"
1555,3300,893,13400,16700,"Sub-basin 4"
1556,100,3,700,800,"Sub-basin 4"
1557,100,1,2600,2700,"Sub-basin 4"
1558,100,3,700,800,"Sub-basin 4"
1559,800,97,5000,5800,"Sub-basin 4"
1560,100,1,2100,2200,"Sub-basin 4"
1561,1300,211,3900,5200,"Sub-basin 4"
1562,600,11,6200,6800,"Sub-basin 4"
1563,100,1,1000,1100,"Sub-basin 4"
1564,200,3,1200,1400,"Sub-basin 4"
1565,400,24,6300,6700,"Sub-basin 4"
1566,100,1,3600,3700,"Sub-basin 4"
1567,1100,146,6400,7500,"Sub-basin 4"
1568,100,1,1900,2000,"Sub-basin 4"
1569,100,3,300,400,"Sub-basin 4"
1570,100,4,600,700,"Sub-basin 4"
1571,900,195,1900,2800,"Sub-basin 4"
1572,2000,587,8900,10900,"Sub-basin 4"
1573,3700,713,11100,14800,"Sub-basin 4"
1574,100,2,2500,2600,"Sub-basin 4"
1575,100,1,900,1000,"Sub-basin 4"
1576,900,41,3300,4200,"Sub-basin 4"
1577,300,19,2900,3200,"Sub-basin 4"
1578,2800,620,8300,11100,"Sub-basin 4"
1579,4100,1663,14000,18100,"Sub-basin 4"
1580,200,2,1900,2100,"Sub-basin 4"
1581,1200,112,3800,5000,"Sub-basin 4"
1582,100,3,1400,1500,"Sub-basin 4"
1583,100,2,1700,1800,"Sub-basin 4"
1584,200,4,3600,3800,"Sub-basin 4"
1585,900,69,6300,7200,"Sub-basin 4"
1586,2300,289,6600,8900,"Sub-basin 4"
1587,1000,81,6800,7800,"Sub-basin 4"
1588,800,65,2700,3500,"Sub-basin 4"
1589,800,88,6200,7000,"Sub-basin 4"
1590,200,17,3800,4000,"Sub-basin 4"
1591,3000,258,10400,13400,"Sub-basin 4"
1592,8500,2743,15300,23800,"Sub-basin 4"
1593,100,2,500,600,"Sub-basin 4"
1594,700,51,4200,4900,"Sub-basin 4"
1595,600,16,2700,3300,"Sub-basin 4"
1596,200,6,2500,2700,"Sub-basin 4"
1597,100,2,1200,1300,"Sub-basin 4"
1598,400,51,1900,2300,"Sub-basin 4"
1599,100,1,1300,1400,"Sub-basin 4"
1600,1400,137,7400,8800,"Sub-basin 4"
1601,300,7,1700,2000,"Sub-basin 4"
1602,400,31,1800,2200,"Sub-basin 4"
1603,700,77,3000,3700,"Sub-basin 4"
1604,100,1,1100,1200,"Sub-basin 4"
1605,1000,83,14900,15900,"Sub-basin 4"
1606,200,4,2300,2500,"Sub-basin 4"
1607,1500,604,3400,4900,"Sub-basin 4"
1608,100,5,1500,1600,"Sub-basin 4"
1609,100,4,700,800,"Sub-basin 4"
1610,400,21,1800,2200,"Sub-basin 4"
1611,3600,238,34000,37600,"Sub-basin 4"
1612,200,11,4600,4800,"Sub-basin 4"
1613,1200,295,3700,4900,"Sub-basin 4"
1614,3600,599,13800,17400,"Sub-basin 4"
1615,700,107,2100,2800,"Sub-basin 4"
1616,6300,1105,12000,18300,"Sub-basin 4"
1617,100,2,2000,2100,"Sub-basin 4"
1618,400,45,1700,2100,"Sub-basin 4"
1619,400,87,1800,2200,"Sub-basin 4"
1620,2500,993,8300,10800,"Sub-basin 4"
1621,1700,268,10800,12500,"Sub-basin 4"
1622,4700,1461,13000,17700,"Sub-basin 4"
1623,400,7,4100,4500,"Sub-basin 4"
1624,800,157,1900,2700,"Sub-basin 4"
1625,2000,433,9300,11300,"Sub-basin 4"
1626,100,1,800,900,"Sub-basin 4"
1627,18700,2862,43900,62600,"Sub-basin 4"
1628,2000,320,5800,7800,"Sub-basin 4"
1629,3200,1018,10000,13200,"Sub-basin 4"
1630,2500,687,6100,8600,"Sub-basin 4"
1631,100,1,200,300,"Sub-basin 4"
1632,100,4,1600,1700,"Sub-basin 4"
1633,100,1,1300,1400,"Sub-basin 4"
1634,1600,94,9100,10700,"Sub-basin 4"
1635,300,15,2000,2300,"Sub-basin 4"
1636,800,51,5300,6100,"Sub-basin 4"
1637,3900,308,14600,18500,"Sub-basin 4"
1638,100,2,800,900,"Sub-basin 4"
1639,800,374,2300,3100,"Sub-basin 4"
1640,900,127,9000,9900,"Sub-basin 4"
1641,4200,632,20400,24600,"Sub-basin 4"
1642,400,11,4900,5300,"Sub-basin 4"
1643,100,1,900,1000,"Sub-basin 4"
1644,700,36,2900,3600,"Sub-basin 4"
1645,700,85,4300,5000,"Sub-basin 4"
1646,100,3,900,1000,"Sub-basin 4"
1647,2600,824,6000,8600,"Sub-basin 4"
1648,400,60,1700,2100,"Sub-basin 4"
1649,400,30,3300,3700,"Sub-basin 4"
1650,1200,171,2000,3200,"Sub-basin 4"
1651,5300,1317,8400,13700,"Sub-basin 4"
1652,1800,631,2600,4400,"Sub-basin 4"
1653,12000,3804,28400,40400,"Sub-basin 4"
1654,100,1,1000,1100,"Sub-basin 4"
1655,1700,295.33,3700,5400,"Sub-basin 4"
1656,900,105,6600,7500,"Sub-basin 4"
1657,1700,197,10400,12100,"Sub-basin 4"
1658,1200,198,11400,12600,"Sub-basin 4"
1659,100,1,1700,1800,"Sub-basin 4"
1660,1000,238,4000,5000,"Sub-basin 4"
1661,400,26,2700,3100,"Sub-basin 4"
1662,200,16,600,800,"Sub-basin 4"
1663,200,3,2200,2400,"Sub-basin 4"
1664,101300,24568.84,146200,247500,"Sub-basin 4"
1665,300,12,1500,1800,"Sub-basin 4"
1666,2000,294,9600,11600,"Sub-basin 4"
1667,4600,790,18700,23300,"Sub-basin 4"
1668,1700,223,4000,5700,"Sub-basin 4"
1669,200,5,5200,5400,"Sub-basin 4"
1670,300,6,2100,2400,"Sub-basin 4"
1671,500,42,4000,4500,"Sub-basin 4"
1672,2700,559,9900,12600,"Sub-basin 4"
1673,600,125,3800,4400,"Sub-basin 4"
1674,2200,813,6500,8700,"Sub-basin 4"
1675,300,9,5600,5900,"Sub-basin 4"
1676,100,1,1300,1400,"Sub-basin 4"
1677,17500,7249,13900,31400,"Sub-basin 4"
1678,400,91,700,1100,"Sub-basin 4"
1679,4100,858,7300,11400,"Sub-basin 4"
1680,1500,177,4200,5700,"Sub-basin 4"
1681,600,74,3300,3900,"Sub-basin 4"
1682,8200,3036,20200,28400,"Sub-basin 4"
1683,100,1,1600,1700,"Sub-basin 4"
1684,200,13,2000,2200,"Sub-basin 4"
1685,100,1,1500,1600,"Sub-basin 4"
1686,700,142,1800,2500,"Sub-basin 4"
1687,1100,88,3000,4100,"Sub-basin 4"
1688,100,1,900,1000,"Sub-basin 4"
1689,100,2,1300,1400,"Sub-basin 4"
1690,700,38,4600,5300,"Sub-basin 4"
1691,9300,2733,20500,29800,"Sub-basin 4"
1692,400,106,2800,3200,"Sub-basin 4"
1693,500,47,4600,5100,"Sub-basin 4"
1694,1000,111,4400,5400,"Sub-basin 4"
1695,300,6,2300,2600,"Sub-basin 4"
1696,2100,207,8500,10600,"Sub-basin 4"
1697,300,17,1600,1900,"Sub-basin 4"
1698,500,43,4100,4600,"Sub-basin 4"
1699,100,1,1400,1500,"Sub-basin 4"
1700,500,32,4100,4600,"Sub-basin 4"
1701,9600,1897,23400,33000,"Sub-basin 4"
1702,300,19,2300,2600,"Sub-basin 4"
1703,100,8,200,300,"Sub-basin 4"
1704,1000,151,1100,2100,"Sub-basin 4"
1705,100,4,600,700,"Sub-basin 4"
1706,500,23,1900,2400,"Sub-basin 4"
1707,200,6,2300,2500,"Sub-basin 4"
1708,400,39,2100,2500,"Sub-basin 4"
1709,600,57,4900,5500,"Sub-basin 4"
1710,800,70,4200,5000,"Sub-basin 4"
1711,100,2,2000,2100,"Sub-basin 4"
1712,100,1,2300,2400,"Sub-basin 4"
1713,1400,436,3500,4900,"Sub-basin 4"
1714,100,4,2200,2300,"Sub-basin 4"
1715,100,1,400,500,"Sub-basin 4"
1716,1700,409,3800,5500,"Sub-basin 4"
1717,2400,686,6900,9300,"Sub-basin 4"
1718,800,228,2600,3400,"Sub-basin 4"
1719,200,8,1000,1200,"Sub-basin 4"
1720,1200,210,15300,16500,"Sub-basin 4"
1721,800,111,900,1700,"Sub-basin 4"
1722,100,3,1000,1100,"Sub-basin 4"
1723,3700,440,11600,15300,"Sub-basin 4"
1724,2900,690,9800,12700,"Sub-basin 4"
1725,200,26,1200,1400,"Sub-basin 4"
1726,100,2,1200,1300,"Sub-basin 4"
1727,1600,189,9000,10600,"Sub-basin 4"
1728,100,2,1100,1200,"Sub-basin 4"
1729,1300,114,7600,8900,"Sub-basin 4"
1730,1700,219,9100,10800,"Sub-basin 4"
1731,16400,7858.33,16700,33100,"Sub-basin 4"
1732,200,4,4800,5000,"Sub-basin 4"
1733,1000,140,7400,8400,"Sub-basin 4"
1734,500,48,2800,3300,"Sub-basin 4"
1735,900,123,2800,3700,"Sub-basin 4"
1736,27700,5239.01,32300,60000,"Sub-basin 4"
1737,300,11,2500,2800,"Sub-basin 4"
1738,400,25,2000,2400,"Sub-basin 4"
1739,1200,74,8600,9800,"Sub-basin 4"
1740,2300,1119,6000,8300,"Sub-basin 4"
1741,2200,210,18200,20400,"Sub-basin 4"
1742,100,2,1200,1300,"Sub-basin 4"
1743,1500,465,700,2200,"Sub-basin 4"
1744,700,127,3700,4400,"Sub-basin 4"
1745,3800,627,32200,36000,"Sub-basin 4"
1746,4600,663.51,15000,19600,"Sub-basin 4"
1747,1700,418,4200,5900,"Sub-basin 4"
1748,700,199,3100,3800,"Sub-basin 4"
1749,100,6,800,900,"Sub-basin 4"
1750,10800,4078,13100,23900,"Sub-basin 4"
1751,6800,2519,13500,20300,"Sub-basin 4"
1752,1100,66,6900,8000,"Sub-basin 4"
1753,200,3,1800,2000,"Sub-basin 4"
1754,2500,466,10200,12700,"Sub-basin 4"
1755,7900,1499.17,59300,67200,"Sub-basin 4"
1756,400,20,2100,2500,"Sub-basin 4"
1757,1100,130,5000,6100,"Sub-basin 4"
1758,1500,504,3100,4600,"Sub-basin 4"
1759,2400,326,18800,21200,"Sub-basin 4"
1760,200,7,2900,3100,"Sub-basin 4"
1761,700,173,2600,3300,"Sub-basin 4"
1762,5100,869,17800,22900,"Sub-basin 4"
1763,100,2,1800,1900,"Sub-basin 4"
1764,100,4,1700,1800,"Sub-basin 4"
1765,11200,4599,17700,28900,"Sub-basin 4"
1766,1200,310,5600,6800,"Sub-basin 4"
1767,400,14,4600,5000,"Sub-basin 4"
1768,400,17,3500,3900,"Sub-basin 4"
1769,100,2,700,800,"Sub-basin 4"
1770,300,11,4500,4800,"Sub-basin 4"
1771,100,1,400,500,"Sub-basin 4"
1772,100,2,900,1000,"Sub-basin 4"
1773,100,1,2000,2100,"Sub-basin 4"
1774,200,10,400,600,"Sub-basin 4"
1775,100,1,300,400,"Sub-basin 4"
1776,100,2,600,700,"Sub-basin 4"
1777,600,39,4600,5200,"Sub-basin 4"
1778,9500,2982,17500,27000,"Sub-basin 4"
1779,100,12,900,1000,"Sub-basin 4"
1780,100,7,1200,1300,"Sub-basin 4"
1781,700,95,5800,6500,"Sub-basin 4"
1782,600,34,6000,6600,"Sub-basin 4"
1783,4400,1016,13500,17900,"Sub-basin 4"
1784,200,9,1600,1800,"Sub-basin 4"
1785,1000,115,5300,6300,"Sub-basin 4"
1786,2300,444,6500,8800,"Sub-basin 4"
1787,400,38,3200,3600,"Sub-basin 4"
1788,200,10,2300,2500,"Sub-basin 4"
1789,800,154,3800,4600,"Sub-basin 4"
1790,200,8,1400,1600,"Sub-basin 4"
1791,8300,2397,20800,29100,"Sub-basin 4"
1792,100,4,1800,1900,"Sub-basin 4"
1793,600,54,2500,3100,"Sub-basin 4"
1794,1100,134,6100,7200,"Sub-basin 4"
1795,7700,1282,9600,17300,"Sub-basin 4"
1796,100,3,1100,1200,"Sub-basin 4"
1797,900,198,3000,3900,"Sub-basin 4"
1798,6300,1876.5,14700,21000,"Sub-basin 4"
1799,200,4,2500,2700,"Sub-basin 4"
1800,13000,2868,42100,55100,"Sub-basin 4"
1801,5400,910,33600,39000,"Sub-basin 4"
1802,500,40,1600,2100,"Sub-basin 4"
1803,200,9,1400,1600,"Sub-basin 4"
1804,100,1,800,900,"Sub-basin 4"
1805,1200,398,4800,6000,"Sub-basin 4"
1806,800,312,3100,3900,"Sub-basin 4"
1807,200,3,1400,1600,"Sub-basin 4"
1808,100,13,700,800,"Sub-basin 4"
1809,1200,221,3500,4700,"Sub-basin 4"
1810,100,1,1600,1700,"Sub-basin 4"
1811,100,2,1700,1800,"Sub-basin 4"
1812,3300,1036,10000,13300,"Sub-basin 4"
1813,100,1,500,600,"Sub-basin 4"
1814,100,1,600,700,"Sub-basin 4"
1815,400,52,2500,2900,"Sub-basin 4"
1816,2400,383,7700,10100,"Sub-basin 4"
1817,1700,535,5600,7300,"Sub-basin 4"
1818,400,39,4300,4700,"Sub-basin 4"
1819,300,11,4700,5000,"Sub-basin 4"
1820,4200,1086,10200,14400,"Sub-basin 4"
1821,600,98,4500,5100,"Sub-basin 4"
1822,1800,370,8300,10100,"Sub-basin 4"
1823,100,14,1300,1400,"Sub-basin 4"
1824,300,7,4800,5100,"Sub-basin 4"
1825,100,2,1000,1100,"Sub-basin 4"
1826,5300,596,38100,43400,"Sub-basin 4"
1827,100,1,900,1000,"Sub-basin 4"
1828,400,20,2900,3300,"Sub-basin 4"
1829,600,152,3000,3600,"Sub-basin 4"
1830,1000,96,2400,3400,"Sub-basin 4"
1831,1200,127,5800,7000,"Sub-basin 4"
1832,1000,148,3600,4600,"Sub-basin 4"
1833,7900,2255,27000,34900,"Sub-basin 4"
1834,200,27,600,800,"Sub-basin 4"
1835,600,30,4300,4900,"Sub-basin 4"
1836,300,8,2300,2600,"Sub-basin 4"
1837,1800,153,6900,8700,"Sub-basin 4"
1838,400,17,1700,2100,"Sub-basin 4"
1839,5300,1643,10500,15800,"Sub-basin 4"
1840,800,90,3500,4300,"Sub-basin 4"
1841,1400,499,7400,8800,"Sub-basin 4"
1842,200,23,1300,1500,"Sub-basin 4"
1843,100,4,1300,1400,"Sub-basin 4"
1844,1500,209,4800,6300,"Sub-basin 4"
1845,400,31,2500,2900,"Sub-basin 4"
1846,300,8,2200,2500,"Sub-basin 4"
1847,1700,293,8600,10300,"Sub-basin 4"
1848,100,1,1500,1600,"Sub-basin 4"
1849,500,33,4000,4500,"Sub-basin 4"
1850,8500,3568,16600,25100,"Sub-basin 4"
1851,200,4,700,900,"Sub-basin 4"
1852,1000,203,5800,6800,"Sub-basin 4"
1853,800,84,3900,4700,"Sub-basin 4"
1854,1000,182,3900,4900,"Sub-basin 4"
1855,200,11,1700,1900,"Sub-basin 4"
1856,1200,137,2700,3900,"Sub-basin 4"
1857,700,62,2300,3000,"Sub-basin 4"
1858,500,33,4000,4500,"Sub-basin 4"
1859,200,14,300,500,"Sub-basin 4"
1860,500,21,6900,7400,"Sub-basin 4"
1861,200,6,200,400,"Sub-basin 4"
1862,1200,116,4900,6100,"Sub-basin 4"
1863,1500,348,6300,7800,"Sub-basin 4"
1864,100,2,1500,1600,"Sub-basin 4"
1865,2400,537,9300,11700,"Sub-basin 4"
1866,5000,1649,8800,13800,"Sub-basin 4"
1867,100,1,1100,1200,"Sub-basin 4"
1868,300,17,2500,2800,"Sub-basin 4"
1869,300,10,3600,3900,"Sub-basin 4"
1870,1900,184,10200,12100,"Sub-basin 4"
1871,2500,487,6200,8700,"Sub-basin 4"
1872,700,93,1400,2100,"Sub-basin 4"
1873,4200,1478,9300,13500,"Sub-basin 4"
1874,7200,1737,15500,22700,"Sub-basin 4"
1875,1700,75,15800,17500,"Sub-basin 4"
1876,1900,419,5400,7300,"Sub-basin 4"
1877,20300,5293,27100,47400,"Sub-basin 4"
1878,15400,3010,34600,50000,"Sub-basin 4"
1879,600,93,1500,2100,"Sub-basin 4"
1880,300,17,900,1200,"Sub-basin 4"
1881,3000,1228,4600,7600,"Sub-basin 4"
1882,1000,299,2000,3000,"Sub-basin 4"
1883,500,43,2200,2700,"Sub-basin 4"
1884,3900,1420,12000,15900,"Sub-basin 4"
1885,600,28,7400,8000,"Sub-basin 4"
1886,700,111,1600,2300,"Sub-basin 4"
1887,600,59,2600,3200,"Sub-basin 4"
1888,9800,4044,17400,27200,"Sub-basin 4"
1889,1500,255,6500,8000,"Sub-basin 4"
1890,200,12,2100,2300,"Sub-basin 4"
1891,800,314,2900,3700,"Sub-basin 4"
1892,2000,459,3000,5000,"Sub-basin 4"
1893,500,15,11900,12400,"Sub-basin 4"
1894,300,4,3300,3600,"Sub-basin 4"
1895,2900,542,7600,10500,"Sub-basin 4"
1896,3600,919,11700,15300,"Sub-basin 4"
1897,200,6,1200,1400,"Sub-basin 4"
1898,2200,327,4100,6300,"Sub-basin 4"
1899,3100,636,8400,11500,"Sub-basin 4"
1900,200,3,1600,1800,"Sub-basin 4"
1901,200,16,2000,2200,"Sub-basin 4"
1902,3600,457,11200,14800,"Sub-basin 4"
1903,600,104,1800,2400,"Sub-basin 4"
1904,300,5,5700,6000,"Sub-basin 4"
1905,600,27,6900,7500,"Sub-basin 4"
1906,400,40,1400,1800,"Sub-basin 4"
1907,200,4,1500,1700,"Sub-basin 4"
1908,100,5,1000,1100,"Sub-basin 4"
1909,500,84,3100,3600,"Sub-basin 4"
1910,600,26,2500,3100,"Sub-basin 4"
1911,400,18,3000,3400,"Sub-basin 4"
1912,2600,381,15000,17600,"Sub-basin 4"
1913,11200,3409.17,27800,39000,"Sub-basin 4"
1914,200,2,1200,1400,"Sub-basin 4"
1915,700,113,3800,4500,"Sub-basin 4"
1916,300,39,2700,3000,"Sub-basin 4"
1917,5000,1250.33,14400,19400,"Sub-basin 4"
1918,500,60,3100,3600,"Sub-basin 4"
1919,100,2,700,800,"Sub-basin 4"
1920,200,9,2000,2200,"Sub-basin 4"
1921,11500,2016,28700,40200,"Sub-basin 4"
1922,2000,307,6200,8200,"Sub-basin 4"
1923,300,33,2200,2500,"Sub-basin 4"
1924,1100,179,6100,7200,"Sub-basin 4"
1925,100,1,600,700,"Sub-basin 4"
1926,100,8,2000,2100,"Sub-basin 4"
1927,200,3,2400,2600,"Sub-basin 4"
1928,11100,2649,21400,32500,"Sub-basin 4"
1929,2100,697,5000,7100,"Sub-basin 4"
1930,200,10,1200,1400,"Sub-basin 4"
1931,1200,138,4000,5200,"Sub-basin 4"
1932,700,34,2900,3600,"Sub-basin 4"
1933,100,1,1100,1200,"Sub-basin 4"
1934,3200,276,16800,20000,"Sub-basin 4"
1935,300,32,2200,2500,"Sub-basin 4"
1936,500,52,4600,5100,"Sub-basin 4"
1937,500,162,4000,4500,"Sub-basin 4"
1938,200,30,3000,3200,"Sub-basin 4"
1939,800,108,5000,5800,"Sub-basin 4"
1940,100,2,300,400,"Sub-basin 4"
1941,6400,2810,9500,15900,"Sub-basin 4"
1942,3700,911,5800,9500,"Sub-basin 4"
1943,300,17,1600,1900,"Sub-basin 4"
1944,2100,145,10700,12800,"Sub-basin 4"
1945,1200,130,5900,7100,"Sub-basin 4"
1946,200,9,1100,1300,"Sub-basin 4"
1947,800,81,3000,3800,"Sub-basin 4"
1948,800,87,5100,5900,"Sub-basin 4"
1949,2900,970,7800,10700,"Sub-basin 4"
1950,3500,729,11400,14900,"Sub-basin 4"
1951,1500,222,5800,7300,"Sub-basin 4"
1952,4000,1032,10700,14700,"Sub-basin 4"
1953,2100,510,6500,8600,"Sub-basin 4"
1954,2200,334,3400,5600,"Sub-basin 4"
1955,100,1,800,900,"Sub-basin 4"
1956,700,64,4000,4700,"Sub-basin 4"
1957,200,7,2800,3000,"Sub-basin 4"
1958,1100,182,6700,7800,"Sub-basin 4"
1959,700,49,2800,3500,"Sub-basin 4"
1960,900,106,5900,6800,"Sub-basin 4"
1961,18900,6119,28000,46900,"Sub-basin 4"
1962,13800,4365,28700,42500,"Sub-basin 4"
1963,4400,514,9800,14200,"Sub-basin 4"
1964,100,2,2400,2500,"Sub-basin 4"
1965,100,1,3000,3100,"Sub-basin 4"
1966,200,8,1800,2000,"Sub-basin 4"
1967,3100,221,19100,22200,"Sub-basin 4"
1968,3900,344,26000,29900,"Sub-basin 4"
1969,100,1,100,200,"Sub-basin 4"
1970,12100,2916,23600,35700,"Sub-basin 4"
1971,400,29,1700,2100,"Sub-basin 4"
1972,1900,380,13100,15000,"Sub-basin 4"
1973,500,35,3400,3900,"Sub-basin 4"
1974,900,263,3700,4600,"Sub-basin 4"
1975,200,7,4700,4900,"Sub-basin 4"
1976,700,61,3000,3700,"Sub-basin 4"
1977,300,10,2300,2600,"Sub-basin 4"
1978,200,8,1900,2100,"Sub-basin 4"
1979,100,4,1400,1500,"Sub-basin 4"
1980,5400,1547,9900,15300,"Sub-basin 4"
1981,200,2,1600,1800,"Sub-basin 4"
1982,200,10,1200,1400,"Sub-basin 4"
1983,300,14,7900,8200,"Sub-basin 4"
1984,100,2,1600,1700,"Sub-basin 4"
1985,100,1,2000,2100,"Sub-basin 4"
1986,3800,613,9800,13600,"Sub-basin 4"
1987,100,5,300,400,"Sub-basin 4"
1988,1300,189,5500,6800,"Sub-basin 4"
1989,500,28,1700,2200,"Sub-basin 4"
1990,500,71,2300,2800,"Sub-basin 4"
1991,2000,382,6100,8100,"Sub-basin 4"
1992,2500,250,28100,30600,"Sub-basin 4"
1993,900,192,4000,4900,"Sub-basin 4"
1994,100,2,1000,1100,"Sub-basin 4"
1995,100,2,1300,1400,"Sub-basin 4"
1996,5200,1126,16600,21800,"Sub-basin 4"
1997,100,3,900,1000,"Sub-basin 4"
1998,400,12,3100,3500,"Sub-basin 4"
1999,2000,718,4700,6700,"Sub-basin 4"
2000,100,1,200,300,"Sub-basin 4"
2001,900,40,4800,5700,"Sub-basin 4"
2002,300,11,1600,1900,"Sub-basin 4"
2003,600,117,5600,6200,"Sub-basin 4"
2004,500,63,3800,4300,"Sub-basin 4"
2005,300,12,1400,1700,"Sub-basin 4"
2006,100,3,1700,1800,"Sub-basin 4"
2007,500,15,4300,4800,"Sub-basin 4"
2008,100,1,800,900,"Sub-basin 4"
2009,400,28,2200,2600,"Sub-basin 4"
2010,600,80,3100,3700,"Sub-basin 4"
2011,8800,3084,10100,18900,"Sub-basin 4"
2012,900,159,1600,2500,"Sub-basin 4"
2013,800,100,3800,4600,"Sub-basin 4"
2014,700,53,10800,11500,"Sub-basin 4"
2015,300,12,1700,2000,"Sub-basin 4"
2016,600,46,3000,3600,"Sub-basin 4"
2017,100,1,1000,1100,"Sub-basin 4"
2018,2400,295,7900,10300,"Sub-basin 4"
2019,1400,384,3300,4700,"Sub-basin 4"
2020,3800,853,16700,20500,"Sub-basin 4"
2021,600,115,3700,4300,"Sub-basin 4"
2022,400,10,5700,6100,"Sub-basin 4"
2023,100,1,2400,2500,"Sub-basin 4"
2024,400,22,1200,1600,"Sub-basin 4"
2025,600,107,2300,2900,"Sub-basin 4"
2026,200,2,400,600,"Sub-basin 4"
2027,1700,149,4300,6000,"Sub-basin 4"
2028,800,115,3100,3900,"Sub-basin 4"
2029,900,76,12900,13800,"Sub-basin 4"
2030,400,22,2600,3000,"Sub-basin 4"
2031,100,1,1100,1200,"Sub-basin 4"
2032,200,6,2100,2300,"Sub-basin 4"
2033,100,1,700,800,"Sub-basin 4"
2034,100,2,1300,1400,"Sub-basin 4"
2035,400,25,3800,4200,"Sub-basin 4"
2036,2600,306,12900,15500,"Sub-basin 4"
2037,800,103,5300,6100,"Sub-basin 4"
2038,400,33,2900,3300,"Sub-basin 4"
2039,4400,744,7900,12300,"Sub-basin 4"
2040,5800,1746,9300,15100,"Sub-basin 4"
2041,300,12,3600,3900,"Sub-basin 4"
2042,200,9,3800,4000,"Sub-basin 4"
2043,800,80,1700,2500,"Sub-basin 4"
2044,5800,1616,15300,21100,"Sub-basin 4"
2045,5600,1547,9300,14900,"Sub-basin 4"
2046,400,25,900,1300,"Sub-basin 4"
2047,200,4,2200,2400,"Sub-basin 4"
2048,900,87,8000,8900,"Sub-basin 4"
2049,6200,2356,24400,30600,"Sub-basin 4"
2050,400,32,1400,1800,"Sub-basin 4"
2051,200,4,4200,4400,"Sub-basin 4"
2052,15300,3145,36800,52100,"Sub-basin 4"
2053,6800,1325,17300,24100,"Sub-basin 4"
2054,100,2,400,500,"Sub-basin 4"
2055,400,24,3000,3400,"Sub-basin 4"
2056,200,3,2300,2500,"Sub-basin 4"
2057,17600,6163.67,17500,35100,"Sub-basin 4"
2058,80300,12953,1e+05,180300,"Sub-basin 4"
2059,100,3,2900,3000,"Sub-basin 4"
2060,100,6,1000,1100,"Sub-basin 4"
2061,600,85,5500,6100,"Sub-basin 4"
2062,1800,463,4100,5900,"Sub-basin 4"
2063,600,32,4800,5400,"Sub-basin 4"
2064,100,1,1000,1100,"Sub-basin 4"
2065,8400,1797,18000,26400,"Sub-basin 4"
2066,700,54,5500,6200,"Sub-basin 4"
2067,300,11,2400,2700,"Sub-basin 4"
2068,100,1,900,1000,"Sub-basin 4"
2069,700,67,2600,3300,"Sub-basin 4"
2070,8500,3257,9600,18100,"Sub-basin 4"
2071,200,7,2300,2500,"Sub-basin 4"
2072,100,1,1200,1300,"Sub-basin 4"
2073,300,16,5500,5800,"Sub-basin 4"
2074,1100,137,4200,5300,"Sub-basin 4"
2075,4300,418,15700,20000,"Sub-basin 4"
2076,100,2,700,800,"Sub-basin 4"
2077,1000,243,2800,3800,"Sub-basin 4"
2078,1400,167,14500,15900,"Sub-basin 4"
2079,600,61,1100,1700,"Sub-basin 4"
2080,3400,600,4400,7800,"Sub-basin 4"
2081,2100,212,4800,6900,"Sub-basin 4"
2082,1500,135,7700,9200,"Sub-basin 4"
2083,8100,550,38800,46900,"Sub-basin 4"
2084,900,105,4800,5700,"Sub-basin 4"
2085,700,69,3200,3900,"Sub-basin 4"
2086,100,1,200,300,"Sub-basin 4"
2087,2600,460,11100,13700,"Sub-basin 4"
2088,100,4,400,500,"Sub-basin 4"
2089,1000,247,3800,4800,"Sub-basin 4"
2090,800,111,1500,2300,"Sub-basin 4"
2091,21600,4488,42300,63900,"Sub-basin 4"
2092,300,21,4500,4800,"Sub-basin 4"
2093,800,43,4300,5100,"Sub-basin 4"
2094,100,3,1000,1100,"Sub-basin 4"
2095,600,57,3900,4500,"Sub-basin 4"
2096,3800,1227,4700,8500,"Sub-basin 4"
2097,300,12,4500,4800,"Sub-basin 4"
2098,200,9,3700,3900,"Sub-basin 4"
2099,900,103,4100,5000,"Sub-basin 4"
2100,500,84,5100,5600,"Sub-basin 4"
2101,100,5,300,400,"Sub-basin 4"
2102,500,104,1900,2400,"Sub-basin 4"
2103,100,6,800,900,"Sub-basin 4"
2104,500,28,7900,8400,"Sub-basin 4"
2105,400,20,1300,1700,"Sub-basin 4"
2106,2400,343,7600,10000,"Sub-basin 4"
2107,200,2.66,2000,2200,"Sub-basin 4"
2108,600,37,2400,3000,"Sub-basin 4"
2109,100,1,800,900,"Sub-basin 4"
2110,100,4,1300,1400,"Sub-basin 4"
2111,300,17,2000,2300,"Sub-basin 4"
2112,1000,126,2500,3500,"Sub-basin 4"
2113,400,78,2500,2900,"Sub-basin 4"
2114,2300,253,13300,15600,"Sub-basin 4"
2115,100,2,600,700,"Sub-basin 4"
2116,1400,162,5900,7300,"Sub-basin 4"
2117,1500,287,3500,5000,"Sub-basin 4"
2118,1100,86,6700,7800,"Sub-basin 4"
2119,100,2,1700,1800,"Sub-basin 4"
2120,2500,532,8900,11400,"Sub-basin 4"
2121,55700,9873,79300,135000,"Sub-basin 4"
2122,200,10,1600,1800,"Sub-basin 4"
2123,500,28,2500,3000,"Sub-basin 4"
2124,800,225,4000,4800,"Sub-basin 4"
2125,2300,124,40100,42400,"Sub-basin 4"
2126,300,14,1900,2200,"Sub-basin 4"
2127,26500,4170.67,59200,85700,"Sub-basin 4"
2128,300,49,1800,2100,"Sub-basin 4"
2129,600,62,2000,2600,"Sub-basin 4"
2130,2100,371,6200,8300,"Sub-basin 4"
2131,1200,242,2400,3600,"Sub-basin 4"
2132,200,4,4100,4300,"Sub-basin 4"
2133,800,85,2500,3300,"Sub-basin 4"
2134,100,5,900,1000,"Sub-basin 4"
2135,1200,79,3800,5000,"Sub-basin 4"
2136,800,154,2600,3400,"Sub-basin 4"
2137,100,1,2400,2500,"Sub-basin 4"
2138,2000,75,9500,11500,"Sub-basin 4"
2139,400,24,4000,4400,"Sub-basin 4"
2140,6200,1488,9800,16000,"Sub-basin 4"
2141,1300,160,3100,4400,"Sub-basin 4"
2142,600,22,6200,6800,"Sub-basin 4"
2143,1100,78,6300,7400,"Sub-basin 4"
2144,100,3,1900,2000,"Sub-basin 4"
2145,68500,14874.5,76700,145200,"Sub-basin 4"
2146,800,155,5400,6200,"Sub-basin 4"
2147,3400,571,9400,12800,"Sub-basin 4"
2148,5500,545.5,21800,27300,"Sub-basin 4"
2149,100,1,100,200,"Sub-basin 4"
2150,100,3,600,700,"Sub-basin 4"
2151,1200,58,6500,7700,"Sub-basin 4"
2152,400,10,3100,3500,"Sub-basin 4"
2153,400,13,4600,5000,"Sub-basin 4"
2154,14300,2472,23100,37400,"Sub-basin 4"
2155,2700,950,4000,6700,"Sub-basin 4"
2156,1000,207,2600,3600,"Sub-basin 4"
2157,100,1,700,800,"Sub-basin 4"
2158,200,5,4300,4500,"Sub-basin 4"
2159,200,4,3300,3500,"Sub-basin 4"
2160,5400,791,14500,19900,"Sub-basin 4"
2161,900,114,4200,5100,"Sub-basin 4"
2162,4100,1363,8900,13000,"Sub-basin 4"
2163,600,38,3900,4500,"Sub-basin 4"
2164,1100,262,4000,5100,"Sub-basin 4"
2165,400,10,5400,5800,"Sub-basin 4"
2166,200,16,2900,3100,"Sub-basin 4"
2167,600,40,3400,4000,"Sub-basin 4"
2168,1800,533,2500,4300,"Sub-basin 4"
2169,300,19,5800,6100,"Sub-basin 4"
2170,200,12,4600,4800,"Sub-basin 4"
2171,2600,174,17100,19700,"Sub-basin 4"
2172,100,4,1400,1500,"Sub-basin 4"
2173,200,12,2000,2200,"Sub-basin 4"
2174,100,2,1000,1100,"Sub-basin 4"
2175,200,2,3500,3700,"Sub-basin 4"
2176,300,5,5200,5500,"Sub-basin 4"
2177,1000,73,4700,5700,"Sub-basin 4"
2178,4300,653.05,9900,14200,"Sub-basin 4"
2179,1700,363,6700,8400,"Sub-basin 4"
2180,800,134,3100,3900,"Sub-basin 4"
2181,100,1,2400,2500,"Sub-basin 4"
2182,1700,187,3200,4900,"Sub-basin 4"
2183,8100,1776,23800,31900,"Sub-basin 4"
2184,1900,408,5700,7600,"Sub-basin 4"
2185,800,148,3200,4000,"Sub-basin 4"
2186,100,1,1000,1100,"Sub-basin 4"
2187,400,19,4200,4600,"Sub-basin 4"
2188,8000,2145,10700,18700,"Sub-basin 4"
2189,200,4,2800,3000,"Sub-basin 4"
2190,600,21,7200,7800,"Sub-basin 4"
2191,100,2,2400,2500,"Sub-basin 4"
2192,500,36,2200,2700,"Sub-basin 4"
2193,100,3,1100,1200,"Sub-basin 4"
2194,300,7,3000,3300,"Sub-basin 4"
2195,1100,141,6400,7500,"Sub-basin 4"
2196,1300,255,3100,4400,"Sub-basin 4"
2197,500,106,1700,2200,"Sub-basin 4"
2198,1900,742,2800,4700,"Sub-basin 4"
2199,5900,797,14800,20700,"Sub-basin 4"
2200,1700,439,3600,5300,"Sub-basin 4"
2201,100,2,1000,1100,"Sub-basin 4"
2202,200,10,2000,2200,"Sub-basin 4"
2203,100,7,200,300,"Sub-basin 4"
2204,21200,7850.92,14200,35400,"Sub-basin 4"
2205,100,1,3400,3500,"Sub-basin 4"
2206,900,219,3100,4000,"Sub-basin 4"
2207,100,3,1100,1200,"Sub-basin 4"
2208,1000,380,1900,2900,"Sub-basin 4"
2209,42000,9353,85700,127700,"Sub-basin 4"
2210,100,1,2300,2400,"Sub-basin 4"
2211,100,1,2700,2800,"Sub-basin 4"
2212,500,24,4000,4500,"Sub-basin 4"
2213,900,82,6300,7200,"Sub-basin 4"
2214,4700,298,16400,21100,"Sub-basin 4"
2215,400,25,1600,2000,"Sub-basin 4"
2216,5300,2291,9000,14300,"Sub-basin 4"
2217,200,50,2100,2300,"Sub-basin 4"
2218,1000,270,2200,3200,"Sub-basin 4"
2219,2500,712,6200,8700,"Sub-basin 4"
2220,100,1,2400,2500,"Sub-basin 4"
2221,600,22.33,9800,10400,"Sub-basin 4"
2222,300,4,3900,4200,"Sub-basin 4"
2223,6800,324,18300,25100,"Sub-basin 4"
2224,1800,312.33,5200,7000,"Sub-basin 4"
2225,100,1,1400,1500,"Sub-basin 4"
2226,2100,157,9400,11500,"Sub-basin 4"
2227,1000,115.7,8100,9100,"Sub-basin 4"
2228,300,4,2000,2300,"Sub-basin 4"
2229,2100,318,6400,8500,"Sub-basin 4"
2230,1500,75,10700,12200,"Sub-basin 4"
2231,100,1,1900,2000,"Sub-basin 4"
2232,500,15,9400,9900,"Sub-basin 4"
2233,100,3,800,900,"Sub-basin 4"
2234,100,2,1200,1300,"Sub-basin 4"
2235,200,6,2200,2400,"Sub-basin 4"
2236,100,1,2900,3000,"Sub-basin 4"
2237,200,21,1900,2100,"Sub-basin 4"
2238,3600,984,8700,12300,"Sub-basin 4"
2239,500,33.5,4000,4500,"Sub-basin 4"
2240,600,111,4500,5100,"Sub-basin 4"
2241,800,66,3200,4000,"Sub-basin 4"
2242,200,10,1700,1900,"Sub-basin 4"
2243,700,36,6800,7500,"Sub-basin 4"
2244,300,10,1900,2200,"Sub-basin 4"
2245,1000,60,3800,4800,"Sub-basin 4"
2246,2800,558,11100,13900,"Sub-basin 4"
2247,100,2.67,1900,2000,"Sub-basin 4"
2248,100,2,1000,1100,"Sub-basin 4"
2249,400,23,1600,2000,"Sub-basin 4"
2250,200,4,2900,3100,"Sub-basin 4"
2251,100,5,1700,1800,"Sub-basin 4"
2252,400,12,4500,4900,"Sub-basin 4"
2253,200,3,5500,5700,"Sub-basin 4"
2254,100,4,4200,4300,"Sub-basin 4"
2255,300,21,6300,6600,"Sub-basin 4"
2256,200,4,1900,2100,"Sub-basin 4"
2257,600,133,1400,2000,"Sub-basin 4"
2258,100,10,1300,1400,"Sub-basin 4"
2259,100,1,1300,1400,"Sub-basin 4"
2260,500,50,3300,3800,"Sub-basin 4"
2261,700,76,1900,2600,"Sub-basin 4"
2262,6600,2890,9900,16500,"Sub-basin 4"
2263,1700,149,7200,8900,"Sub-basin 4"
2264,400,11,7100,7500,"Sub-basin 4"
2265,2700,300,5600,8300,"Sub-basin 4"
2266,100,4,200,300,"Sub-basin 4"
2267,900,65,3600,4500,"Sub-basin 4"
2268,200,12,1500,1700,"Sub-basin 4"
2269,4400,1126,8900,13300,"Sub-basin 4"
2270,1100,167,5500,6600,"Sub-basin 4"
2271,100,1,1500,1600,"Sub-basin 4"
2272,100,1,600,700,"Sub-basin 4"
2273,3400,1366,3700,7100,"Sub-basin 4"
2274,400,27,2400,2800,"Sub-basin 4"
2275,100,1,600,700,"Sub-basin 4"
2276,1300,213,7100,8400,"Sub-basin 4"
2277,100,4,700,800,"Sub-basin 4"
2278,300,6,1200,1500,"Sub-basin 4"
2279,200,5,2000,2200,"Sub-basin 4"
2280,200,8,2500,2700,"Sub-basin 4"
2281,100,1,800,900,"Sub-basin 4"
2282,500,87,5600,6100,"Sub-basin 4"
2283,500,87,4300,4800,"Sub-basin 4"
2284,3200,764,12400,15600,"Sub-basin 4"
2285,600,99,2700,3300,"Sub-basin 4"
2286,300,20,2000,2300,"Sub-basin 4"
2287,400,13,700,1100,"Sub-basin 4"
2288,300,13,7200,7500,"Sub-basin 4"
2289,1800,231,6900,8700,"Sub-basin 4"
2290,200,4,700,900,"Sub-basin 4"
2291,100,2,500,600,"Sub-basin 4"
2292,2400,306,7400,9800,"Sub-basin 4"
2293,600,31,3200,3800,"Sub-basin 4"
2294,200,3,2100,2300,"Sub-basin 4"
2295,100,2,600,700,"Sub-basin 4"
2296,300,11,2000,2300,"Sub-basin 4"
2297,2100,313,19500,21600,"Sub-basin 4"
2298,20600,5126,47500,68100,"Sub-basin 4"
2299,1100,113,6000,7100,"Sub-basin 4"
2300,200,5,2400,2600,"Sub-basin 4"
2301,1200,105,4300,5500,"Sub-basin 4"
2302,200,5,3200,3400,"Sub-basin 4"
2303,100,1,1500,1600,"Sub-basin 4"
2304,100,5,500,600,"Sub-basin 4"
2305,600,84,3900,4500,"Sub-basin 4"
2306,2900,300,12300,15200,"Sub-basin 4"
2307,200,3,1600,1800,"Sub-basin 4"
2308,200,4,2300,2500,"Sub-basin 4"
2309,100,2,1200,1300,"Sub-basin 4"
2310,9300,1267,16400,25700,"Sub-basin 4"
2311,100,1,400,500,"Sub-basin 4"
2312,600,79,2600,3200,"Sub-basin 4"
2313,100,2,1100,1200,"Sub-basin 4"
2314,1700,216,5000,6700,"Sub-basin 4"
2315,1300,237,3900,5200,"Sub-basin 4"
2316,200,5,1600,1800,"Sub-basin 4"
2317,12400,996,20200,32600,"Sub-basin 4"
2318,1300,222,1800,3100,"Sub-basin 4"
2319,100,1,800,900,"Sub-basin 4"
2320,28500,9154.83,38000,66500,"Sub-basin 4"
2321,100,5,700,800,"Sub-basin 4"
2322,400,15,2100,2500,"Sub-basin 4"
2323,100,1,1000,1100,"Sub-basin 4"
2324,1400,315,4300,5700,"Sub-basin 4"
2325,100,1,500,600,"Sub-basin 4"
2326,1800,606,3900,5700,"Sub-basin 4"
2327,200,9,2300,2500,"Sub-basin 4"
2328,300,5,700,1000,"Sub-basin 4"
2329,900,211,3800,4700,"Sub-basin 4"
2330,200,11,1700,1900,"Sub-basin 4"
2331,800,39,5300,6100,"Sub-basin 4"
2332,300,9,2400,2700,"Sub-basin 4"
2333,2300,258,11300,13600,"Sub-basin 4"
2334,900,128,8200,9100,"Sub-basin 4"
2335,400,17,4400,4800,"Sub-basin 4"
2336,100,3,300,400,"Sub-basin 4"
2337,200,5,2100,2300,"Sub-basin 4"
2338,1000,46,2000,3000,"Sub-basin 4"
2339,300,19,1500,1800,"Sub-basin 4"
2340,3500,361,8500,12000,"Sub-basin 4"
2341,2800,375,9600,12400,"Sub-basin 4"
2342,1200,105,4400,5600,"Sub-basin 4"
2343,15000,3526,15400,30400,"Sub-basin 4"
2344,200,6,700,900,"Sub-basin 4"
2345,200,3,1000,1200,"Sub-basin 4"
2346,200,7,1900,2100,"Sub-basin 4"
2347,100,2,1100,1200,"Sub-basin 4"
2348,1300,95,8400,9700,"Sub-basin 4"
2349,800,43,7400,8200,"Sub-basin 4"
2350,800,100,3100,3900,"Sub-basin 4"
2351,1500,353,4600,6100,"Sub-basin 4"
2352,600,62,3200,3800,"Sub-basin 4"
2353,700,58,5500,6200,"Sub-basin 4"
2354,400,74,3600,4000,"Sub-basin 4"
2355,3300,300,8100,11400,"Sub-basin 4"
2356,7400,625,12900,20300,"Sub-basin 4"
2357,300,5,5100,5400,"Sub-basin 4"
2358,500,31,6300,6800,"Sub-basin 4"
2359,200,5,2100,2300,"Sub-basin 4"
2360,900,333,2000,2900,"Sub-basin 4"
2361,500,27,5900,6400,"Sub-basin 4"
2362,100,1,1500,1600,"Sub-basin 4"
2363,800,95,3100,3900,"Sub-basin 4"
2364,12100,2135,24100,36200,"Sub-basin 4"
2365,200,12,2500,2700,"Sub-basin 4"
2366,200,4,700,900,"Sub-basin 4"
2367,400,16,4200,4600,"Sub-basin 4"
2368,200,14,1600,1800,"Sub-basin 4"
2369,300,13,1700,2000,"Sub-basin 4"
2370,400,54,1100,1500,"Sub-basin 4"
2371,400,28,1800,2200,"Sub-basin 4"
2372,400,45,1600,2000,"Sub-basin 4"
2373,100,3,300,400,"Sub-basin 4"
2374,70400,10852,109000,179400,"Sub-basin 4"
2375,200,11,800,1000,"Sub-basin 4"
2376,1600,303,9500,11100,"Sub-basin 4"
2377,200,13,1200,1400,"Sub-basin 4"
2378,200,7,1900,2100,"Sub-basin 4"
2379,200,8,1600,1800,"Sub-basin 4"
2380,200,7,1300,1500,"Sub-basin 4"
2381,100,1,1300,1400,"Sub-basin 4"
2382,1000,86,6100,7100,"Sub-basin 4"
2383,100,4,600,700,"Sub-basin 4"
2384,100,5,400,500,"Sub-basin 4"
2385,100,5,2600,2700,"Sub-basin 4"
2386,200,8,2500,2700,"Sub-basin 4"
2387,400,64,4200,4600,"Sub-basin 4"
2388,1000,108,3400,4400,"Sub-basin 4"
2389,6300,763,16100,22400,"Sub-basin 4"
2390,1500,234,6300,7800,"Sub-basin 4"
2391,3500,781,7300,10800,"Sub-basin 4"
2392,100,4,2600,2700,"Sub-basin 4"
2393,100,7,1700,1800,"Sub-basin 4"
2394,1300,81,9600,10900,"Sub-basin 4"
2395,100,3,1800,1900,"Sub-basin 4"
2396,100,1,1400,1500,"Sub-basin 4"
2397,100,1,1400,1500,"Sub-basin 4"
2398,100,2,500,600,"Sub-basin 4"
2399,200,10,1200,1400,"Sub-basin 4"
2400,100,2,2500,2600,"Sub-basin 4"
2401,100,1,2000,2100,"Sub-basin 4"
2402,100,1,1000,1100,"Sub-basin 4"
2403,400,93,1700,2100,"Sub-basin 4"
2404,1300,261,2900,4200,"Sub-basin 4"
2405,5000,1446,7400,12400,"Sub-basin 4"
2406,100,9,2200,2300,"Sub-basin 4"
2407,300,28,1600,1900,"Sub-basin 4"
2408,7200,2442.82,21100,28300,"Sub-basin 4"
2409,200,2,1700,1900,"Sub-basin 4"
2410,100,1,900,1000,"Sub-basin 4"
2411,100,3,800,900,"Sub-basin 4"
2412,1500,106,3500,5000,"Sub-basin 4"
2413,1500,102,12800,14300,"Sub-basin 4"
2414,200,2,700,900,"Sub-basin 4"
2415,200,8,1300,1500,"Sub-basin 4"
2416,1000,222,2400,3400,"Sub-basin 4"
2417,100,1,600,700,"Sub-basin 4"
2418,100,1,1200,1300,"Sub-basin 4"
2419,400,11,3100,3500,"Sub-basin 4"
2420,100,1,1200,1300,"Sub-basin 4"
2421,200,20,3500,3700,"Sub-basin 4"
2422,100,1,600,700,"Sub-basin 4"
2423,100,4,500,600,"Sub-basin 4"
2424,300,13,1800,2100,"Sub-basin 4"
2425,200,13,2100,2300,"Sub-basin 4"
2426,1300,80,17800,19100,"Sub-basin 4"
2427,2200,305,10100,12300,"Sub-basin 4"
2428,400,28,2000,2400,"Sub-basin 4"
2429,3800,1318,8200,12000,"Sub-basin 4"
2430,100,1,2000,2100,"Sub-basin 4"
2431,100,1,800,900,"Sub-basin 4"
2432,200,3,900,1100,"Sub-basin 4"
2433,300,12,2100,2400,"Sub-basin 4"
2434,200,6,1300,1500,"Sub-basin 4"
2435,100,1,400,500,"Sub-basin 4"
2436,7300,2218,11600,18900,"Sub-basin 4"
2437,19400,7336,24600,44000,"Sub-basin 4"
2438,300,11,2800,3100,"Sub-basin 4"
2439,200,16,2200,2400,"Sub-basin 4"
2440,500,17,4300,4800,"Sub-basin 4"
2441,100,4,1200,1300,"Sub-basin 4"
2442,700,37,5600,6300,"Sub-basin 4"
2443,400,17,1100,1500,"Sub-basin 4"
2444,100,1,2400,2500,"Sub-basin 4"
2445,14200,1171,28700,42900,"Sub-basin 4"
2446,1700,90,4000,5700,"Sub-basin 4"
2447,800,38,1900,2700,"Sub-basin 4"
2448,200,20,1000,1200,"Sub-basin 4"
2449,100,5,700,800,"Sub-basin 4"
2450,100,1,1700,1800,"Sub-basin 4"
2451,400,12,2000,2400,"Sub-basin 4"
2452,1300,169,1000,2300,"Sub-basin 4"
2453,100,1,200,300,"Sub-basin 4"
2454,1400,168,6800,8200,"Sub-basin 4"
2455,100,5,600,700,"Sub-basin 4"
2456,1400,95,8200,9600,"Sub-basin 4"
2457,400,50,5700,6100,"Sub-basin 4"
2458,100,3,2000,2100,"Sub-basin 4"
2459,400,18,500,900,"Sub-basin 4"
2460,600,73,6000,6600,"Sub-basin 4"
2461,60300,28861,53800,114100,"Sub-basin 4"
2462,300,12,4300,4600,"Sub-basin 4"
2463,200,6,1900,2100,"Sub-basin 4"
2464,100,2,700,800,"Sub-basin 4"
2465,4500,481,6700,11200,"Sub-basin 4"
2466,300,6,1200,1500,"Sub-basin 4"
2467,1100,70,3700,4800,"Sub-basin 4"
2468,100,1,500,600,"Sub-basin 4"
2469,100,2,900,1000,"Sub-basin 4"
2470,200,22,1500,1700,"Sub-basin 4"
2471,300,10,5000,5300,"Sub-basin 4"
2472,3200,273,28900,32100,"Sub-basin 4"
2473,100,1,1000,1100,"Sub-basin 4"
2474,100,1,1000,1100,"Sub-basin 4"
2475,600,44,2800,3400,"Sub-basin 4"
2476,1100,191,4100,5200,"Sub-basin 4"
2477,600,86,4100,4700,"Sub-basin 4"
2478,100,2,1000,1100,"Sub-basin 4"
2479,1100,228,7400,8500,"Sub-basin 4"
2480,100,3,1900,2000,"Sub-basin 4"
2481,3000,498,10300,13300,"Sub-basin 4"
2482,100,2,600,700,"Sub-basin 4"
2483,100,1,300,400,"Sub-basin 4"
2484,100,1,600,700,"Sub-basin 4"
2485,1000,23,4600,5600,"Sub-basin 4"
2486,100,1,700,800,"Sub-basin 4"
2487,100,2,300,400,"Sub-basin 4"
2488,100,5,2600,2700,"Sub-basin 4"
2489,200,4,1300,1500,"Sub-basin 4"
2490,500,40,4400,4900,"Sub-basin 4"
2491,600,32,2900,3500,"Sub-basin 4"
2492,1000,74,4100,5100,"Sub-basin 4"
2493,100,1,1100,1200,"Sub-basin 4"
2494,500,108,2300,2800,"Sub-basin 4"
2495,200,19,1900,2100,"Sub-basin 4"
2496,1000,109,5400,6400,"Sub-basin 4"
2497,1500,111,11300,12800,"Sub-basin 4"
2498,600,84,3700,4300,"Sub-basin 4"
2499,700,129,4200,4900,"Sub-basin 4"
2500,9200,419,34600,43800,"Sub-basin 4"
2501,800,46,4700,5500,"Sub-basin 4"
2502,100,7,800,900,"Sub-basin 4"
2503,100,2,1300,1400,"Sub-basin 4"
2504,100,4,300,400,"Sub-basin 4"
2505,100,2,1900,2000,"Sub-basin 4"
2506,200,16,2300,2500,"Sub-basin 4"
2507,400,15,3400,3800,"Sub-basin 4"
2508,200,7,2500,2700,"Sub-basin 4"
2509,3200,141,8600,11800,"Sub-basin 4"
2510,100,4,900,1000,"Sub-basin 4"
2511,1900,225,8800,10700,"Sub-basin 4"
2512,500,27,2700,3200,"Sub-basin 4"
2513,600,48,6100,6700,"Sub-basin 4"
2514,1400,412,3500,4900,"Sub-basin 4"
2515,1200,173,6400,7600,"Sub-basin 4"
2516,1900,144,13200,15100,"Sub-basin 4"
2517,800,34,10100,10900,"Sub-basin 4"
2518,4000,220,20200,24200,"Sub-basin 4"
2519,100,1,800,900,"Sub-basin 4"
2520,1000,178,3200,4200,"Sub-basin 4"
2521,37500,14375,25500,63000,"Sub-basin 4"
2522,1000,353,3900,4900,"Sub-basin 4"
2523,200,5,800,1000,"Sub-basin 4"
2524,800,49,3200,4000,"Sub-basin 4"
2525,200,15.34,1900,2100,"Sub-basin 4"
2526,400,16,2400,2800,"Sub-basin 4"
2527,300,3,2900,3200,"Sub-basin 4"
2528,100,1,400,500,"Sub-basin 4"
2529,200,12,1700,1900,"Sub-basin 4"
2530,300,4,1700,2000,"Sub-basin 4"
2531,300,8,1200,1500,"Sub-basin 4"
2532,400,14,1200,1600,"Sub-basin 4"
2533,100,9,1300,1400,"Sub-basin 4"
2534,400,28,3100,3500,"Sub-basin 4"
2535,600,31,5400,6000,"Sub-basin 4"
2536,900,195,3400,4300,"Sub-basin 4"
2537,1600,198,6900,8500,"Sub-basin 4"
2538,400,48,1700,2100,"Sub-basin 4"
2539,3100,155,10100,13200,"Sub-basin 4"
2540,11200,1063,24000,35200,"Sub-basin 4"
2541,100,1,1300,1400,"Sub-basin 4"
2542,200,3,3000,3200,"Sub-basin 4"
2543,900,57,4300,5200,"Sub-basin 4"
2544,176400,15991,199400,375800,"Sub-basin 4"
2545,200,154.1278,1200,1400,"Sub-basin 4"
2546,3200,849,6900,10100,"Sub-basin 4"
2547,300,4,1700,2000,"Sub-basin 4"
2548,200,3,1100,1300,"Sub-basin 4"
2549,1600,234,7200,8800,"Sub-basin 4"
2550,200,8,1600,1800,"Sub-basin 4"
2551,800,34,2800,3600,"Sub-basin 4"
2552,100,16,1500,1600,"Sub-basin 4"
2553,200,9,2000,2200,"Sub-basin 4"
2554,4300,1348,6200,10500,"Sub-basin 4"
2555,36000,15860,56400,92400,"Sub-basin 4"
2556,200,3,2000,2200,"Sub-basin 4"
2557,700,28,4600,5300,"Sub-basin 4"
2558,1300,232,8000,9300,"Sub-basin 4"
2559,600,74,1800,2400,"Sub-basin 4"
2560,800,56,3400,4200,"Sub-basin 4"
2561,100,2,1000,1100,"Sub-basin 4"
2562,100,2,1100,1200,"Sub-basin 4"
2563,2600,346,7700,10300,"Sub-basin 4"
2564,100,1,600,700,"Sub-basin 4"
2565,200,7,2100,2300,"Sub-basin 4"
2566,7300,2190,24400,31700,"Sub-basin 4"
2567,1800,216,5000,6800,"Sub-basin 4"
2568,2100,581,6400,8500,"Sub-basin 4"
2569,2600,492,9800,12400,"Sub-basin 4"
2570,1400,310,9800,11200,"Sub-basin 4"
2571,100,6,1000,1100,"Sub-basin 4"
2572,600,42,5500,6100,"Sub-basin 4"
2573,1000,68,10100,11100,"Sub-basin 4"
2574,200,9,1600,1800,"Sub-basin 4"
2575,100,5,1800,1900,"Sub-basin 4"
2576,200,7,2000,2200,"Sub-basin 4"
2577,600,102,4400,5000,"Sub-basin 4"
2578,1100,191,3100,4200,"Sub-basin 4"
2579,300,35,3000,3300,"Sub-basin 4"
2580,1700,249,9900,11600,"Sub-basin 4"
2581,200,3,2600,2800,"Sub-basin 4"
2582,100,3,1500,1600,"Sub-basin 4"
2583,600,58,3600,4200,"Sub-basin 4"
2584,400,24,3400,3800,"Sub-basin 4"
2585,400,12,5700,6100,"Sub-basin 4"
2586,2200,519,4600,6800,"Sub-basin 4"
2587,3600,607,13300,16900,"Sub-basin 4"
2588,500,70,2900,3400,"Sub-basin 4"
2589,300,19,1300,1600,"Sub-basin 4"
2590,3400,279,14900,18300,"Sub-basin 4"
2591,400,8,4200,4600,"Sub-basin 4"
2592,600,51,5300,5900,"Sub-basin 4"
2593,700,55,2700,3400,"Sub-basin 4"
2594,200,10,2000,2200,"Sub-basin 4"
2595,300,21,2500,2800,"Sub-basin 4"
2596,4300,1555,11600,15900,"Sub-basin 4"
2597,200,28,1000,1200,"Sub-basin 4"
2598,1500,100,4400,5900,"Sub-basin 4"
2599,600,30,2100,2700,"Sub-basin 4"
2600,700,96,3100,3800,"Sub-basin 4"
2601,600,99,3000,3600,"Sub-basin 4"
2602,500,22,3000,3500,"Sub-basin 4"
2603,12400,2916,29000,41400,"Sub-basin 4"
2604,600,31,6600,7200,"Sub-basin 4"
2605,16300,1667,29600,45900,"Sub-basin 4"
2606,200,11,2100,2300,"Sub-basin 4"
2607,100,2,1200,1300,"Sub-basin 4"
2608,200,7,1800,2000,"Sub-basin 4"
2609,1200,175,3000,4200,"Sub-basin 4"
2610,100,2,1500,1600,"Sub-basin 4"
2611,15100,1116,35400,50500,"Sub-basin 4"
2612,100,3,1300,1400,"Sub-basin 4"
2613,300,10,1200,1500,"Sub-basin 4"
2614,100,8,2700,2800,"Sub-basin 4"
2615,2100,718,7200,9300,"Sub-basin 4"
2616,1000,232,2100,3100,"Sub-basin 4"
2617,800,106,3100,3900,"Sub-basin 4"
2618,100,1,1100,1200,"Sub-basin 4"
2619,5500,604,10600,16100,"Sub-basin 4"
2620,300,13,1700,2000,"Sub-basin 4"
2621,800,154,3600,4400,"Sub-basin 4"
2622,400,21,2600,3000,"Sub-basin 4"
2623,400,33,4000,4400,"Sub-basin 4"
2624,600,67,4700,5300,"Sub-basin 4"
2625,100,3,1200,1300,"Sub-basin 4"
2626,100,1,1700,1800,"Sub-basin 4"
2627,200,4,3300,3500,"Sub-basin 4"
2628,300,17,1600,1900,"Sub-basin 4"
2629,100,2,0,100,"Sub-basin 4"
2630,100,1,1300,1400,"Sub-basin 4"
2631,3900,672,10200,14100,"Sub-basin 4"
2632,5600,1600,16100,21700,"Sub-basin 4"
2633,100,3,1800,1900,"Sub-basin 4"
2634,2600,533,7300,9900,"Sub-basin 4"
2635,4000,640,11300,15300,"Sub-basin 4"
2636,20500,5209,31200,51700,"Sub-basin 4"
2637,200,7,1000,1200,"Sub-basin 4"
2638,100,3,1600,1700,"Sub-basin 4"
2639,100,1,700,800,"Sub-basin 4"
2640,6700,223,12700,19400,"Sub-basin 4"
2641,200,25,500,700,"Sub-basin 4"
2642,800,146,2300,3100,"Sub-basin 4"
2643,700,27,1600,2300,"Sub-basin 4"
2644,1600,313,5800,7400,"Sub-basin 4"
2645,400,47,2500,2900,"Sub-basin 4"
2646,1700,237,17500,19200,"Sub-basin 4"
2647,100,2,700,800,"Sub-basin 4"
2648,3300,963,9400,12700,"Sub-basin 4"
2649,100,2,2700,2800,"Sub-basin 4"
2650,500,46,1800,2300,"Sub-basin 4"
2651,1100,184,4900,6000,"Sub-basin 4"
2652,100,3,1100,1200,"Sub-basin 4"
2653,200,7,900,1100,"Sub-basin 4"
2654,100,2,300,400,"Sub-basin 4"
2655,400,6,1000,1400,"Sub-basin 4"
2656,100,8,300,400,"Sub-basin 4"
2657,600,91,3400,4000,"Sub-basin 4"
2658,1400,195,7600,9000,"Sub-basin 4"
2659,100,4,1200,1300,"Sub-basin 4"
2660,300,24,1300,1600,"Sub-basin 4"
2661,300,7,1600,1900,"Sub-basin 4"
2662,1200,286,4100,5300,"Sub-basin 4"
2663,200,8,900,1100,"Sub-basin 4"
2664,24300,2720,16900,41200,"Sub-basin 4"
2665,400,31,1000,1400,"Sub-basin 4"
2666,4400,841,12200,16600,"Sub-basin 4"
2667,700,68,5000,5700,"Sub-basin 4"
2668,1000,221,3300,4300,"Sub-basin 4"
2669,200,9,3800,4000,"Sub-basin 4"
2670,500,29,2600,3100,"Sub-basin 4"
2671,1300,136,10000,11300,"Sub-basin 4"
2672,400,15,2000,2400,"Sub-basin 4"
2673,600,103,2900,3500,"Sub-basin 4"
2674,100,1,1800,1900,"Sub-basin 4"
2675,2600,1078,10800,13400,"Sub-basin 4"
2676,2200,506,4700,6900,"Sub-basin 4"
2677,300,13,2400,2700,"Sub-basin 4"
2678,800,135,2500,3300,"Sub-basin 4"
2679,4500,183,12900,17400,"Sub-basin 4"
2680,15200,6180,28100,43300,"Sub-basin 4"
2681,3300,569,13200,16500,"Sub-basin 4"
2682,1000,60,6800,7800,"Sub-basin 4"
2683,100,2,1900,2000,"Sub-basin 4"
2684,1100,153,5500,6600,"Sub-basin 4"
2685,1200,65,6800,8000,"Sub-basin 4"
2686,3300,1353,6800,10100,"Sub-basin 4"
2687,200,23,1100,1300,"Sub-basin 4"
2688,400,21,3600,4000,"Sub-basin 4"
2689,500,74,1900,2400,"Sub-basin 4"
2690,5400,1143,10100,15500,"Sub-basin 4"
2691,100,9,1700,1800,"Sub-basin 4"
2692,1400,188,4800,6200,"Sub-basin 4"
2693,300,15,3500,3800,"Sub-basin 4"
2694,100,2,500,600,"Sub-basin 4"
2695,600,77,3700,4300,"Sub-basin 4"
2696,100,4,700,800,"Sub-basin 4"
2697,1100,215,1700,2800,"Sub-basin 4"
2698,1000,119,4100,5100,"Sub-basin 4"
2699,1900,190,9500,11400,"Sub-basin 4"
2700,100,1,1100,1200,"Sub-basin 4"
2701,1600,169,13500,15100,"Sub-basin 4"
2702,7200,1131,16100,23300,"Sub-basin 4"
2703,300,27,1100,1400,"Sub-basin 4"
2704,500,98,1500,2000,"Sub-basin 4"
2705,600,15,5500,6100,"Sub-basin 4"
2706,200,7,2500,2700,"Sub-basin 4"
2707,1200,67,6700,7900,"Sub-basin 4"
2708,3100,853,10600,13700,"Sub-basin 4"
2709,2200,474,8800,11000,"Sub-basin 4"
2710,600,46,4700,5300,"Sub-basin 4"
2711,200,8,2700,2900,"Sub-basin 4"
2712,1700,184,7600,9300,"Sub-basin 4"
2713,100,1,600,700,"Sub-basin 4"
2714,400,15,2800,3200,"Sub-basin 4"
2715,200,13,1400,1600,"Sub-basin 4"
2716,100,3,600,700,"Sub-basin 4"
2717,12000,3566,19300,31300,"Sub-basin 4"
2718,2800,266,15100,17900,"Sub-basin 4"
2719,500,71,5200,5700,"Sub-basin 4"
2720,200,3,2800,3000,"Sub-basin 4"
2721,1200,138,7100,8300,"Sub-basin 4"
2722,100,1,1300,1400,"Sub-basin 4"
2723,300,16,2400,2700,"Sub-basin 4"
2724,2200,328,10200,12400,"Sub-basin 4"
2725,100,4,1100,1200,"Sub-basin 4"
2726,6400,3143,12300,18700,"Sub-basin 4"
2727,200,18,1900,2100,"Sub-basin 4"
2728,300,10,3200,3500,"Sub-basin 4"
2729,200,4,2400,2600,"Sub-basin 4"
2730,200,5,2400,2600,"Sub-basin 4"
2731,3200,120,9600,12800,"Sub-basin 4"
2732,3200,535,10800,14000,"Sub-basin 4"
2733,200,2,2300,2500,"Sub-basin 4"
2734,300,18,2200,2500,"Sub-basin 4"
2735,1000,313,5100,6100,"Sub-basin 4"
2736,200,9,3100,3300,"Sub-basin 4"
2737,100,1,900,1000,"Sub-basin 4"
2738,200,16,3100,3300,"Sub-basin 4"
2739,200,3,3400,3600,"Sub-basin 4"
2740,2800,487,7700,10500,"Sub-basin 4"
2741,200,18,1500,1700,"Sub-basin 4"
2742,6600,1232,9200,15800,"Sub-basin 4"
2743,300,25,1800,2100,"Sub-basin 4"
2744,500,31,2300,2800,"Sub-basin 4"
2745,100,1,1200,1300,"Sub-basin 4"
2746,1100,127,3900,5000,"Sub-basin 4"
2747,600,52,3100,3700,"Sub-basin 4"
2748,100,5,1300,1400,"Sub-basin 4"
2749,200,18,2600,2800,"Sub-basin 4"
2750,600,26,3700,4300,"Sub-basin 4"
2751,500,56,3700,4200,"Sub-basin 4"
2752,20800,3171,32400,53200,"Sub-basin 4"
2753,4300,553,11000,15300,"Sub-basin 4"
2754,1600,279,5800,7400,"Sub-basin 4"
2755,100,2,1400,1500,"Sub-basin 4"
2756,400,27,1600,2000,"Sub-basin 4"
2757,100,1,600,700,"Sub-basin 4"
2758,1400,152,11000,12400,"Sub-basin 4"
2759,600,30,3800,4400,"Sub-basin 4"
2760,100,1,2200,2300,"Sub-basin 4"
2761,88900,38864,59400,148300,"Sub-basin 4"
2762,200,8,500,700,"Sub-basin 4"
2763,200,2,2500,2700,"Sub-basin 4"
2764,100,1,1200,1300,"Sub-basin 4"
2765,3400,321,18400,21800,"Sub-basin 4"
2766,700,22,4000,4700,"Sub-basin 4"
2767,1200,32,5800,7000,"Sub-basin 4"
2768,600,23,6100,6700,"Sub-basin 4"
2769,1600,541,7900,9500,"Sub-basin 4"
2770,700,88,4100,4800,"Sub-basin 4"
2771,100,2,1000,1100,"Sub-basin 4"
2772,3100,985,8500,11600,"Sub-basin 4"
2773,100,1,200,300,"Sub-basin 4"
2774,14800,3593,23600,38400,"Sub-basin 4"
2775,1300,350,4000,5300,"Sub-basin 4"
2776,600,83,1600,2200,"Sub-basin 4"
2777,2100,488,2800,4900,"Sub-basin 4"
2778,400,20,1200,1600,"Sub-basin 4"
2779,100,1,1500,1600,"Sub-basin 4"
2780,2900,344,6700,9600,"Sub-basin 4"
2781,100,2,1000,1100,"Sub-basin 4"
2782,300,16,3400,3700,"Sub-basin 4"
2783,700,436,2800,3500,"Sub-basin 4"
2784,2500,80,10100,12600,"Sub-basin 4"
2785,700,47,12000,12700,"Sub-basin 4"
2786,10200,2159,23900,34100,"Sub-basin 4"
2787,100,2,900,1000,"Sub-basin 4"
2788,900,88,6200,7100,"Sub-basin 4"
2789,2800,202,17800,20600,"Sub-basin 4"
2790,200,9,2400,2600,"Sub-basin 4"
2791,100,1,600,700,"Sub-basin 4"
2792,100,1,600,700,"Sub-basin 4"
2793,3100,563.44,15400,18500,"Sub-basin 4"
2794,100,2,1400,1500,"Sub-basin 4"
2795,4500,964,12600,17100,"Sub-basin 4"
2796,200,14,1500,1700,"Sub-basin 4"
2797,800,95,4900,5700,"Sub-basin 4"
2798,100,1,500,600,"Sub-basin 4"
2799,3300,730,14400,17700,"Sub-basin 4"
2800,500,33,6500,7000,"Sub-basin 4"
2801,2600,143,6600,9200,"Sub-basin 4"
2802,200,26,1200,1400,"Sub-basin 4"
2803,3300,775,12700,16000,"Sub-basin 4"
2804,300,12.5,900,1200,"Sub-basin 4"
2805,3500,510,13400,16900,"Sub-basin 4"
2806,600,100,3200,3800,"Sub-basin 4"
2807,900,185,5200,6100,"Sub-basin 4"
2808,400,23,3200,3600,"Sub-basin 4"
2809,800,196,2500,3300,"Sub-basin 4"
2810,100,2,700,800,"Sub-basin 4"
2811,100,2,1400,1500,"Sub-basin 4"
2812,3600,565.66,9800,13400,"Sub-basin 4"
2813,3600,138,11700,15300,"Sub-basin 4"
2814,100,2,1100,1200,"Sub-basin 4"
2815,100,5,400,500,"Sub-basin 4"
2816,100,1,1300,1400,"Sub-basin 4"
2817,600,71,5800,6400,"Sub-basin 4"
2818,200,8,1500,1700,"Sub-basin 4"
2819,500,71,1100,1600,"Sub-basin 4"
2820,4200,247,11200,15400,"Sub-basin 4"
2821,900,166,6600,7500,"Sub-basin 4"
2822,200,14,5400,5600,"Sub-basin 4"
2823,9600,3067,10500,20100,"Sub-basin 4"
2824,1600,314,5500,7100,"Sub-basin 4"
2825,1000,172,2900,3900,"Sub-basin 4"
2826,2100,579,8200,10300,"Sub-basin 4"
2827,400,13,2400,2800,"Sub-basin 4"
2828,400,25,2400,2800,"Sub-basin 4"
2829,100,3,1300,1400,"Sub-basin 4"
2830,100,2,400,500,"Sub-basin 4"
2831,1000,224,6000,7000,"Sub-basin 4"
2832,500,82,4000,4500,"Sub-basin 4"
2833,100,1,1300,1400,"Sub-basin 4"
2834,100,1,1300,1400,"Sub-basin 4"
2835,600,43,4700,5300,"Sub-basin 4"
2836,200,4,1500,1700,"Sub-basin 4"
2837,700,59,4400,5100,"Sub-basin 4"
2838,500,15,4400,4900,"Sub-basin 4"
2839,400,14,2700,3100,"Sub-basin 4"
2840,20300,5909,39400,59700,"Sub-basin 4"
2841,8900,1574,19000,27900,"Sub-basin 4"
2842,400,13,2200,2600,"Sub-basin 4"
2843,400,46,2400,2800,"Sub-basin 4"
2844,100,3,2000,2100,"Sub-basin 4"
2845,300,21,700,1000,"Sub-basin 4"
2846,100,1,100,200,"Sub-basin 4"
2847,100,2,1400,1500,"Sub-basin 4"
2848,2600,593,14100,16700,"Sub-basin 4"
2849,100,1,700,800,"Sub-basin 4"
2850,100,1,600,700,"Sub-basin 4"
2851,300,18,2300,2600,"Sub-basin 4"
2852,200,10,1300,1500,"Sub-basin 4"
2853,200,8,1700,1900,"Sub-basin 4"
2854,200,4,1000,1200,"Sub-basin 4"
2855,100,1,1200,1300,"Sub-basin 4"
2856,600,31,7000,7600,"Sub-basin 4"
2857,400,39,5900,6300,"Sub-basin 4"
2858,300,26,4100,4400,"Sub-basin 4"
2859,100,2,800,900,"Sub-basin 4"
2860,100,4,1800,1900,"Sub-basin 4"
2861,300,13,3200,3500,"Sub-basin 4"
2862,300,16,3600,3900,"Sub-basin 4"
2863,700,54,4100,4800,"Sub-basin 4"
2864,300,8,1100,1400,"Sub-basin 4"
2865,200,84,3800,4000,"Sub-basin 4"
2866,300,10,3300,3600,"Sub-basin 4"
2867,100,2,800,900,"Sub-basin 4"
2868,800,64,3900,4700,"Sub-basin 4"
2869,1000,171,1600,2600,"Sub-basin 4"
2870,1900,518,7900,9800,"Sub-basin 4"
2871,200,9,1900,2100,"Sub-basin 4"
2872,200,14,1200,1400,"Sub-basin 4"
2873,200,7,1400,1600,"Sub-basin 4"
2874,2400,502,11900,14300,"Sub-basin 4"
2875,200,14,1300,1500,"Sub-basin 4"
2876,500,45,3400,3900,"Sub-basin 4"
2877,2700,193,16700,19400,"Sub-basin 4"
2878,700,87,4200,4900,"Sub-basin 4"
2879,300,20,1800,2100,"Sub-basin 4"
2880,3300,459,26700,30000,"Sub-basin 4"
2881,1200,110,5000,6200,"Sub-basin 4"
2882,100,1,900,1000,"Sub-basin 4"
2883,100,1,1400,1500,"Sub-basin 4"
2884,300,9,1900,2200,"Sub-basin 4"
2885,1300,90,8400,9700,"Sub-basin 4"
2886,400,64,1800,2200,"Sub-basin 4"
2887,400,56,3000,3400,"Sub-basin 4"
2888,7700,1022,37000,44700,"Sub-basin 4"
2889,400,8,4400,4800,"Sub-basin 4"
2890,100,1,2000,2100,"Sub-basin 4"
2891,400,37,3100,3500,"Sub-basin 4"
2892,3700,1158,8800,12500,"Sub-basin 4"
2893,500,81,2400,2900,"Sub-basin 4"
2894,200,5,1400,1600,"Sub-basin 4"
2895,800,100,4300,5100,"Sub-basin 4"
2896,1600,204,11600,13200,"Sub-basin 4"
2897,800,97,6300,7100,"Sub-basin 4"
2898,100,1,1000,1100,"Sub-basin 4"
2899,200,5,2400,2600,"Sub-basin 4"
2900,200,6,2200,2400,"Sub-basin 4"
2901,700,71,5100,5800,"Sub-basin 4"
2902,900,64,4700,5600,"Sub-basin 4"
2903,100,1,1800,1900,"Sub-basin 4"
2904,200,7,2400,2600,"Sub-basin 4"
2905,300,8,2100,2400,"Sub-basin 4"
2906,1400,176,11200,12600,"Sub-basin 4"
2907,1600,160,7400,9000,"Sub-basin 4"
2908,1300,85,11600,12900,"Sub-basin 4"
2909,200,2,2400,2600,"Sub-basin 4"
2910,600,39,6500,7100,"Sub-basin 4"
2911,1200,250,3400,4600,"Sub-basin 4"
2912,300,16,2300,2600,"Sub-basin 4"
2913,1300,263,5000,6300,"Sub-basin 4"
2914,4700,726,11800,16500,"Sub-basin 4"
2915,1400,217,6000,7400,"Sub-basin 4"
2916,1100,381.17,4600,5700,"Sub-basin 4"
2917,7700,1507,21200,28900,"Sub-basin 4"
2918,100,1,900,1000,"Sub-basin 4"
2919,1100,78,4500,5600,"Sub-basin 4"
2920,100,1,1200,1300,"Sub-basin 4"
2921,100,5,2000,2100,"Sub-basin 4"
2922,400,54,4500,4900,"Sub-basin 4"
2923,300,13,1800,2100,"Sub-basin 4"
2924,600,20,7200,7800,"Sub-basin 4"
2925,1300,103,5600,6900,"Sub-basin 4"
2926,94800,28051,87000,181800,"Sub-basin 4"
2927,1200,41,4200,5400,"Sub-basin 4"
2928,500,40,2400,2900,"Sub-basin 4"
2929,21700,1389,59600,81300,"Sub-basin 4"
2930,2500,110,10600,13100,"Sub-basin 4"
2931,600,24,4900,5500,"Sub-basin 4"
2932,500,52,4500,5000,"Sub-basin 4"
2933,700,44,2900,3600,"Sub-basin 4"
2934,400,14,4200,4600,"Sub-basin 4"
2935,100,1,1800,1900,"Sub-basin 4"
2936,1800,283,19200,21000,"Sub-basin 4"
2937,300,29,1400,1700,"Sub-basin 4"
2938,400,103,2500,2900,"Sub-basin 4"
2939,1400,111,11000,12400,"Sub-basin 4"
2940,200,12,2200,2400,"Sub-basin 4"
2941,100,3,1500,1600,"Sub-basin 4"
2942,300,3,3400,3700,"Sub-basin 4"
2943,36900,8642.34,64500,101400,"Sub-basin 4"
2944,100,2,1200,1300,"Sub-basin 4"
2945,100,1,300,400,"Sub-basin 4"
2946,4600,573,9600,14200,"Sub-basin 4"
2947,600,132,2400,3000,"Sub-basin 4"
2948,800,82,3500,4300,"Sub-basin 4"
2949,500,29,3100,3600,"Sub-basin 4"
2950,5400,1547,10200,15600,"Sub-basin 4"
2951,500,61,2700,3200,"Sub-basin 4"
2952,200,3,1800,2000,"Sub-basin 4"
2953,300,13,6000,6300,"Sub-basin 4"
2954,800,68,8100,8900,"Sub-basin 4"
2955,100,3,900,1000,"Sub-basin 4"
2956,700,131,2500,3200,"Sub-basin 4"
2957,1300,339,6600,7900,"Sub-basin 4"
2958,1700,282,5400,7100,"Sub-basin 4"
2959,100,1,1700,1800,"Sub-basin 4"
2960,400,29,1700,2100,"Sub-basin 4"
2961,2100,379,8900,11000,"Sub-basin 4"
2962,900,37,3900,4800,"Sub-basin 4"
2963,2600,504,14400,17000,"Sub-basin 4"
2964,200,4,1700,1900,"Sub-basin 4"
2965,100,3,1100,1200,"Sub-basin 4"
2966,100,2,1400,1500,"Sub-basin 4"
2967,100,1,1400,1500,"Sub-basin 4"
2968,900,146,3900,4800,"Sub-basin 4"
2969,600,32,3000,3600,"Sub-basin 4"
2970,11200,2540,26000,37200,"Sub-basin 4"
2971,600,39,6500,7100,"Sub-basin 4"
2972,1400,118,5000,6400,"Sub-basin 4"
2973,200,7,1900,2100,"Sub-basin 4"
2974,500,32,3000,3500,"Sub-basin 4"
2975,200,5,2700,2900,"Sub-basin 4"
2976,1400,145,5900,7300,"Sub-basin 4"
2977,100,1,1100,1200,"Sub-basin 4"
2978,4100,964,19700,23800,"Sub-basin 4"
2979,100,4,1400,1500,"Sub-basin 4"
2980,100,3,1500,1600,"Sub-basin 4"
2981,1800,154,15100,16900,"Sub-basin 4"
2982,11800,3255,23100,34900,"Sub-basin 4"
2983,2100,140,6800,8900,"Sub-basin 4"
2984,500,120,2000,2500,"Sub-basin 4"
2985,1500,365,3500,5000,"Sub-basin 4"
2986,800,185,2300,3100,"Sub-basin 4"
2987,800,90,1700,2500,"Sub-basin 4"
2988,900,88,3400,4300,"Sub-basin 4"
2989,2100,399,10400,12500,"Sub-basin 4"
2990,100,3,1200,1300,"Sub-basin 4"
2991,100,1,900,1000,"Sub-basin 4"
2992,900,139,5400,6300,"Sub-basin 4"
2993,7200,2133,16500,23700,"Sub-basin 4"
2994,2600,633,12000,14600,"Sub-basin 4"
2995,400,26,4600,5000,"Sub-basin 4"
2996,1000,34,4800,5800,"Sub-basin 4"
2997,14100,599,25400,39500,"Sub-basin 4"
2998,200,3,1800,2000,"Sub-basin 4"
2999,200,6,2600,2800,"Sub-basin 4"
3000,1800,157,11800,13600,"Sub-basin 4"
3001,2000,206,15900,17900,"Sub-basin 4"
3002,500,33,1900,2400,"Sub-basin 4"
3003,2400,678,5300,7700,"Sub-basin 4"
3004,900,147,2200,3100,"Sub-basin 4"
3005,1800,407,8300,10100,"Sub-basin 4"
3006,100,1,700,800,"Sub-basin 4"
3007,800,117,5500,6300,"Sub-basin 4"
3008,200,5,1900,2100,"Sub-basin 4"
3009,1200,233,4300,5500,"Sub-basin 4"
3010,1400,325,6700,8100,"Sub-basin 4"
3011,700,30,7100,7800,"Sub-basin 4"
3012,100,2,1700,1800,"Sub-basin 4"
3013,100,3,1000,1100,"Sub-basin 4"
3014,3500,1111,3100,6600,"Sub-basin 4"
3015,400,53,2400,2800,"Sub-basin 4"
3016,400,26,1800,2200,"Sub-basin 4"
3017,300,26,1800,2100,"Sub-basin 4"
3018,100,1,300,400,"Sub-basin 4"
3019,5600,2105,14600,20200,"Sub-basin 4"
3020,600,69,2700,3300,"Sub-basin 4"
3021,1500,128,10300,11800,"Sub-basin 4"
3022,500,46,3100,3600,"Sub-basin 4"
3023,100,6,1000,1100,"Sub-basin 4"
3024,100,3,1100,1200,"Sub-basin 4"
3025,200,5,2000,2200,"Sub-basin 4"
3026,3300,807,7100,10400,"Sub-basin 4"
3027,500,52,2300,2800,"Sub-basin 4"
3028,200,10,1300,1500,"Sub-basin 4"
3029,100,1,2500,2600,"Sub-basin 4"
3030,4200,441,15700,19900,"Sub-basin 4"
3031,100,1,100,200,"Sub-basin 4"
3032,1600,346,7200,8800,"Sub-basin 4"
3033,400,17,5800,6200,"Sub-basin 4"
3034,2400,486,9500,11900,"Sub-basin 4"
3035,800,128,4200,5000,"Sub-basin 4"
3036,400,18,2800,3200,"Sub-basin 4"
3037,100,3,800,900,"Sub-basin 4"
3038,600,36,5200,5800,"Sub-basin 4"
3039,100,1,1300,1400,"Sub-basin 4"
3040,100,1,2300,2400,"Sub-basin 4"
3041,6300,1206.17,20200,26500,"Sub-basin 4"
3042,100,6,1600,1700,"Sub-basin 4"
3043,300,19,2100,2400,"Sub-basin 4"
3044,2300,262,7800,10100,"Sub-basin 4"
3045,11800,7148,15500,27300,"Sub-basin 4"
3046,1200,103,6500,7700,"Sub-basin 4"
3047,100,5,1800,1900,"Sub-basin 4"
3048,32600,8874,68100,100700,"Sub-basin 4"
3049,1300,117,6400,7700,"Sub-basin 4"
3050,400,27,5400,5800,"Sub-basin 4"
3051,100,4,2200,2300,"Sub-basin 4"
3052,700,90,4900,5600,"Sub-basin 4"
3053,100,6,1800,1900,"Sub-basin 4"
3054,1900,471,8200,10100,"Sub-basin 4"
3055,4300,515,8700,13000,"Sub-basin 4"
3056,1100,195,8900,10000,"Sub-basin 4"
3057,300,26,2400,2700,"Sub-basin 4"
3058,100,2,1500,1600,"Sub-basin 4"
3059,100,2,700,800,"Sub-basin 4"
3060,400,48,7000,7400,"Sub-basin 4"
3061,100,1,1400,1500,"Sub-basin 4"
3062,200,8,900,1100,"Sub-basin 4"
3063,200,2,600,800,"Sub-basin 4"
3064,2900,219,6900,9800,"Sub-basin 4"
3065,300,10,1400,1700,"Sub-basin 4"
3066,1400,185,5800,7200,"Sub-basin 4"
3067,500,72,3100,3600,"Sub-basin 4"
3068,900,190,4200,5100,"Sub-basin 4"
3069,5600,1075,16600,22200,"Sub-basin 4"
3070,200,7,2700,2900,"Sub-basin 4"
3071,100,1,1800,1900,"Sub-basin 4"
3072,2000,262,10100,12100,"Sub-basin 4"
3073,400,20,2500,2900,"Sub-basin 4"
3074,1400,140,14600,16000,"Sub-basin 4"
3075,800,107,5700,6500,"Sub-basin 4"
3076,500,47,2000,2500,"Sub-basin 4"
3077,6400,2182,8200,14600,"Sub-basin 4"
3078,1300,186,9500,10800,"Sub-basin 4"
3079,800,73,13400,14200,"Sub-basin 4"
3080,700,39,8200,8900,"Sub-basin 4"
3081,200,4,5200,5400,"Sub-basin 4"
3082,2300,370.5,15700,18000,"Sub-basin 4"
3083,300,12,5100,5400,"Sub-basin 4"
3084,100,1,1000,1100,"Sub-basin 4"
3085,3200,589,5300,8500,"Sub-basin 4"
3086,400,51,1200,1600,"Sub-basin 4"
3087,800,119,5800,6600,"Sub-basin 4"
3088,100,1,800,900,"Sub-basin 4"
3089,300,9,2900,3200,"Sub-basin 4"
3090,800,256,3900,4700,"Sub-basin 4"
3091,100,1,1100,1200,"Sub-basin 4"
3092,100,1,1300,1400,"Sub-basin 4"
3093,100,1,600,700,"Sub-basin 4"
3094,1000,121,2800,3800,"Sub-basin 4"
3095,700,35,2700,3400,"Sub-basin 4"
3096,100,1,1900,2000,"Sub-basin 4"
3097,600,44,3600,4200,"Sub-basin 4"
3098,100,1,1500,1600,"Sub-basin 4"
3099,100,4,2200,2300,"Sub-basin 4"
3100,400,28,1800,2200,"Sub-basin 4"
3101,400,11,2200,2600,"Sub-basin 4"
3102,200,20,2300,2500,"Sub-basin 4"
3103,100,2,1000,1100,"Sub-basin 4"
3104,200,8,3900,4100,"Sub-basin 4"
3105,17000,549,46000,63000,"Sub-basin 4"
3106,500,20,4000,4500,"Sub-basin 4"
3107,200,13,1400,1600,"Sub-basin 4"
3108,1900,373.84,11700,13600,"Sub-basin 4"
3109,200,3,1600,1800,"Sub-basin 4"
3110,1800,577,7200,9000,"Sub-basin 4"
3111,4700,724,26400,31100,"Sub-basin 4"
3112,600,53,3400,4000,"Sub-basin 4"
3113,1200,159,8600,9800,"Sub-basin 4"
3114,300,11,3600,3900,"Sub-basin 4"
3115,300,22,3400,3700,"Sub-basin 4"
3116,100,1,800,900,"Sub-basin 4"
3117,100,2,2300,2400,"Sub-basin 4"
3118,100,4,700,800,"Sub-basin 4"
3119,400,27,3500,3900,"Sub-basin 4"
3120,100,2,1400,1500,"Sub-basin 4"
3121,400,13,2100,2500,"Sub-basin 4"
3122,600,38,4200,4800,"Sub-basin 4"
3123,100,5,2200,2300,"Sub-basin 4"
3124,4200,1027,15800,20000,"Sub-basin 4"
3125,700,45,4800,5500,"Sub-basin 4"
3126,900,179,7700,8600,"Sub-basin 4"
3127,100,1,1900,2000,"Sub-basin 4"
3128,200,10,1700,1900,"Sub-basin 4"
3129,2100,179,5600,7700,"Sub-basin 4"
3130,2000,389,4600,6600,"Sub-basin 4"
3131,200,8,1000,1200,"Sub-basin 4"
3132,7800,3624,13600,21400,"Sub-basin 4"
3133,100,2,1500,1600,"Sub-basin 4"
3134,400,119,2200,2600,"Sub-basin 4"
3135,900,73,5600,6500,"Sub-basin 4"
3136,1900,469,8500,10400,"Sub-basin 4"
3137,500,40,3600,4100,"Sub-basin 4"
3138,600,85,4800,5400,"Sub-basin 4"
3139,1000,179,6700,7700,"Sub-basin 4"
3140,2800,320.16,12100,14900,"Sub-basin 4"
3141,800,76,5200,6000,"Sub-basin 4"
3142,600,88,4100,4700,"Sub-basin 4"
3143,100,2,1200,1300,"Sub-basin 4"
3144,900,164,6200,7100,"Sub-basin 4"
3145,1900,238,6300,8200,"Sub-basin 4"
3146,200,11,3500,3700,"Sub-basin 4"
3147,1000,100,4600,5600,"Sub-basin 4"
3148,100,3,900,1000,"Sub-basin 4"
3149,10200,371,39000,49200,"Sub-basin 4"
3150,100,3,700,800,"Sub-basin 4"
3151,200,4.34,3900,4100,"Sub-basin 4"
3152,7200,1127,26900,34100,"Sub-basin 4"
3153,400,31,5900,6300,"Sub-basin 4"
3154,400,46,5700,6100,"Sub-basin 4"
3155,100,1,1300,1400,"Sub-basin 4"
3156,59000,4273,89400,148400,"Sub-basin 4"
3157,2000,212,5100,7100,"Sub-basin 4"
3158,500,66,2700,3200,"Sub-basin 4"
3159,200,10,3100,3300,"Sub-basin 4"
3160,200,6,1100,1300,"Sub-basin 4"
3161,7900,3265,8200,16100,"Sub-basin 4"
3162,1200,47,8300,9500,"Sub-basin 4"
3163,100,2,300,400,"Sub-basin 4"
3164,10200,445,28800,39000,"Sub-basin 4"
3165,500,11,2800,3300,"Sub-basin 4"
3166,200,10,1400,1600,"Sub-basin 4"
3167,200,2,3900,4100,"Sub-basin 4"
3168,900,88,5700,6600,"Sub-basin 4"
3169,100,1,700,800,"Sub-basin 4"
3170,3700,445,12500,16200,"Sub-basin 4"
3171,600,98,2800,3400,"Sub-basin 4"
3172,11900,5154,27000,38900,"Sub-basin 4"
3173,100,2,600,700,"Sub-basin 4"
3174,800,173,6200,7000,"Sub-basin 4"
3175,200,6,1700,1900,"Sub-basin 4"
3176,100,1,1500,1600,"Sub-basin 4"
3177,100,1,1600,1700,"Sub-basin 4"
3178,200,2,2100,2300,"Sub-basin 4"
3179,1600,178,10400,12000,"Sub-basin 4"
3180,900,67,5200,6100,"Sub-basin 4"
3181,100,1,2500,2600,"Sub-basin 4"
3182,100,3,2100,2200,"Sub-basin 4"
3183,600,129,4600,5200,"Sub-basin 4"
3184,100,2,1300,1400,"Sub-basin 4"
3185,2300,374,8800,11100,"Sub-basin 4"
3186,83900,26253,112000,195900,"Sub-basin 4"
3187,300,5,4600,4900,"Sub-basin 4"
3188,100,1,3200,3300,"Sub-basin 4"
3189,100,4,3000,3100,"Sub-basin 4"
3190,100,3,2100,2200,"Sub-basin 4"
3191,700,60,4800,5500,"Sub-basin 4"
3192,200,4,200,400,"Sub-basin 4"
3193,400,11,3900,4300,"Sub-basin 4"
3194,500,7,3400,3900,"Sub-basin 4"
3195,6600,2478,11200,17800,"Sub-basin 4"
3196,400,32,4100,4500,"Sub-basin 4"
3197,100,1,2700,2800,"Sub-basin 4"
3198,1300,191,13000,14300,"Sub-basin 4"
3199,500,79,4900,5400,"Sub-basin 4"
3200,200,9,2000,2200,"Sub-basin 4"
3201,6100,1582,13400,19500,"Sub-basin 4"
3202,200,16,900,1100,"Sub-basin 4"
3203,1300,221,3700,5000,"Sub-basin 4"
3204,100,1,1300,1400,"Sub-basin 4"
3205,300,6,3600,3900,"Sub-basin 4"
3206,100,2,700,800,"Sub-basin 4"
3207,200,32,2700,2900,"Sub-basin 4"
3208,200,13,1900,2100,"Sub-basin 4"
3209,100,5,2000,2100,"Sub-basin 4"
3210,100,2,1000,1100,"Sub-basin 4"
3211,5000,177,17700,22700,"Sub-basin 4"
3212,200,2,600,800,"Sub-basin 4"
3213,900,65,6900,7800,"Sub-basin 4"
3214,400,36,4600,5000,"Sub-basin 4"
3215,100,1,2400,2500,"Sub-basin 4"
3216,100,1,2300,2400,"Sub-basin 4"
3217,100,6,1600,1700,"Sub-basin 4"
3218,1000,382,5700,6700,"Sub-basin 4"
3219,300,15,3100,3400,"Sub-basin 4"
3220,2000,324,5700,7700,"Sub-basin 4"
3221,700,75,3800,4500,"Sub-basin 4"
3222,900,176,8100,9000,"Sub-basin 4"
3223,400,61,2500,2900,"Sub-basin 4"
3224,100,1,1000,1100,"Sub-basin 4"
3225,100,3,1400,1500,"Sub-basin 4"
3226,2500,196,10100,12600,"Sub-basin 4"
3227,800,141,4400,5200,"Sub-basin 4"
3228,1000,128,5500,6500,"Sub-basin 4"
3229,1800,109,30300,32100,"Sub-basin 4"
3230,100,1,2300,2400,"Sub-basin 4"
3231,1500,171,13400,14900,"Sub-basin 4"
3232,100,4,1500,1600,"Sub-basin 4"
3233,500,41,2700,3200,"Sub-basin 4"
3234,100,2,400,500,"Sub-basin 4"
3235,2300,357,4600,6900,"Sub-basin 4"
3236,2000,71,6000,8000,"Sub-basin 4"
3237,1000,80,8100,9100,"Sub-basin 4"
3238,12000,2164,34900,46900,"Sub-basin 4"
3239,100,12,2300,2400,"Sub-basin 4"
3240,700,108,7200,7900,"Sub-basin 4"
3241,100,1,1300,1400,"Sub-basin 4"
3242,200,6,3500,3700,"Sub-basin 4"
3243,500,40,3500,4000,"Sub-basin 4"
3244,200,3,3200,3400,"Sub-basin 4"
3245,500,7,4800,5300,"Sub-basin 4"
3246,200,7,3600,3800,"Sub-basin 4"
3247,1000,71,5600,6600,"Sub-basin 4"
3248,800,123,7200,8000,"Sub-basin 4"
3249,200,10,2800,3000,"Sub-basin 4"
3250,100,3,1300,1400,"Sub-basin 4"
3251,1700,236,8400,10100,"Sub-basin 4"
3252,100,5,900,1000,"Sub-basin 4"
3253,100,2,1900,2000,"Sub-basin 4"
3254,800,146,4000,4800,"Sub-basin 4"
3255,100,1,1200,1300,"Sub-basin 4"
3256,1100,24,4200,5300,"Sub-basin 4"
3257,300,11,600,900,"Sub-basin 4"
3258,300,17,3300,3600,"Sub-basin 4"
3259,1000,139,4600,5600,"Sub-basin 4"
3260,100,3,2300,2400,"Sub-basin 4"
3261,600,20,2800,3400,"Sub-basin 4"
3262,1700,149,11200,12900,"Sub-basin 4"
3263,600,37,4800,5400,"Sub-basin 4"
3264,700,105,2600,3300,"Sub-basin 4"
3265,3900,412,16700,20600,"Sub-basin 4"
3266,400,9,5200,5600,"Sub-basin 4"
3267,300,10,3800,4100,"Sub-basin 4"
3268,2600,564,10900,13500,"Sub-basin 4"
3269,100,3,700,800,"Sub-basin 4"
3270,200,9,2300,2500,"Sub-basin 4"
3271,700,117.83,3600,4300,"Sub-basin 4"
3272,1200,83,6300,7500,"Sub-basin 4"
3273,400,28,1300,1700,"Sub-basin 4"
3274,600,124,2400,3000,"Sub-basin 4"
3275,100,1,1000,1100,"Sub-basin 4"
3276,700,30,5600,6300,"Sub-basin 4"
3277,100,4,1100,1200,"Sub-basin 4"
3278,400,30,3900,4300,"Sub-basin 4"
3279,600,65,8300,8900,"Sub-basin 4"
3280,200,13,3500,3700,"Sub-basin 4"
3281,1200,330,6100,7300,"Sub-basin 4"
3282,100,1,500,600,"Sub-basin 4"
3283,100,2,700,800,"Sub-basin 4"
3284,37000,1324,62400,99400,"Sub-basin 4"
3285,5100,1279,15200,20300,"Sub-basin 4"
3286,100,6,1200,1300,"Sub-basin 4"
3287,600,109,2600,3200,"Sub-basin 4"
3288,100,2,2500,2600,"Sub-basin 4"
3289,600,67,4100,4700,"Sub-basin 4"
3290,200,4,2400,2600,"Sub-basin 4"
3291,1100,31,7100,8200,"Sub-basin 4"
3292,100,1,1000,1100,"Sub-basin 4"
3293,400,8,2700,3100,"Sub-basin 4"
3294,200,16,2200,2400,"Sub-basin 4"
3295,31600,10247,49500,81100,"Sub-basin 4"
3296,2900,999,10000,12900,"Sub-basin 4"
3297,11400,1580.84,30900,42300,"Sub-basin 4"
3298,4900,951,8500,13400,"Sub-basin 4"
3299,100,1,100,200,"Sub-basin 4"
3300,300,3,900,1200,"Sub-basin 4"
3301,500,26,1200,1700,"Sub-basin 4"
3302,200,3,2500,2700,"Sub-basin 4"
3303,400,23,3100,3500,"Sub-basin 4"
3304,3000,330,18900,21900,"Sub-basin 4"
3305,800,56,5600,6400,"Sub-basin 4"
3306,200,9,3400,3600,"Sub-basin 4"
3307,3800,274,22100,25900,"Sub-basin 4"
3308,100,2,1800,1900,"Sub-basin 4"
3309,900,45,3900,4800,"Sub-basin 4"
3310,4600,211,12500,17100,"Sub-basin 4"
3311,2400,503,6400,8800,"Sub-basin 4"
3312,100,2,600,700,"Sub-basin 4"
3313,100,2,600,700,"Sub-basin 4"
3314,100,5,1200,1300,"Sub-basin 4"
3315,1700,388,4100,5800,"Sub-basin 4"
3316,600,102,5200,5800,"Sub-basin 4"
3317,100,1,1300,1400,"Sub-basin 4"
3318,100,4,2100,2200,"Sub-basin 4"
3319,600,50,2600,3200,"Sub-basin 4"
3320,100,2,600,700,"Sub-basin 4"
3321,100,2,700,800,"Sub-basin 4"
3322,100,3,1300,1400,"Sub-basin 4"
3323,61600,3142,174800,236400,"Sub-basin 4"
3324,400,53,7100,7500,"Sub-basin 4"
3325,300,3,1300,1600,"Sub-basin 4"
3326,100,13,1400,1500,"Sub-basin 4"
3327,100,1,600,700,"Sub-basin 4"
3328,1000,40,5000,6000,"Sub-basin 4"
3329,100,2,800,900,"Sub-basin 4"
3330,2700,541.17,7600,10300,"Sub-basin 4"
3331,500,117,3100,3600,"Sub-basin 4"
3332,200,36,1600,1800,"Sub-basin 4"
3333,100,1,300,400,"Sub-basin 4"
3334,100,1,1500,1600,"Sub-basin 4"
3335,200,4,1900,2100,"Sub-basin 4"
3336,500,13,2200,2700,"Sub-basin 4"
3337,600,15,5400,6000,"Sub-basin 4"
3338,1200,98,10700,11900,"Sub-basin 4"
3339,4000,355,11200,15200,"Sub-basin 4"
3340,100,3,700,800,"Sub-basin 4"
3341,1300,139,7700,9000,"Sub-basin 4"
3342,100,1,1900,2000,"Sub-basin 4"
3343,400,22,3800,4200,"Sub-basin 4"
3344,700,77,2000,2700,"Sub-basin 4"
3345,400,46,3000,3400,"Sub-basin 4"
3346,200,3,1200,1400,"Sub-basin 4"
3347,8000,752,28100,36100,"Sub-basin 4"
3348,300,5,1500,1800,"Sub-basin 4"
3349,600,12,3700,4300,"Sub-basin 4"
3350,100,2,1500,1600,"Sub-basin 4"
3351,400,5,4600,5000,"Sub-basin 4"
3352,500,33,3500,4000,"Sub-basin 4"
3353,600,30,7600,8200,"Sub-basin 4"
3354,200,4,2300,2500,"Sub-basin 4"
3355,100,1,700,800,"Sub-basin 4"
3356,100,1,1300,1400,"Sub-basin 4"
3357,3300,529,9400,12700,"Sub-basin 4"
3358,400,49,4000,4400,"Sub-basin 4"
3359,600,23,3400,4000,"Sub-basin 4"
3360,200,6,2400,2600,"Sub-basin 4"
3361,100,1,1300,1400,"Sub-basin 4"
3362,2700,182,13600,16300,"Sub-basin 4"
3363,100,2,700,800,"Sub-basin 4"
3364,1700,435,5100,6800,"Sub-basin 4"
3365,300,14,4400,4700,"Sub-basin 4"
3366,800,92,2800,3600,"Sub-basin 4"
3367,100,6,1300,1400,"Sub-basin 4"
3368,200,2,500,700,"Sub-basin 4"
3369,200,7,1600,1800,"Sub-basin 4"
3370,100,1,700,800,"Sub-basin 4"
3371,100,1,1300,1400,"Sub-basin 4"
3372,1100,83,9300,10400,"Sub-basin 4"
3373,400,15,2600,3000,"Sub-basin 4"
3374,400,17,1300,1700,"Sub-basin 4"
3375,300,18,2200,2500,"Sub-basin 4"
3376,100,4,400,500,"Sub-basin 4"
3377,100,1,1200,1300,"Sub-basin 4"
3378,1300,218,6000,7300,"Sub-basin 4"
3379,1200,55,10700,11900,"Sub-basin 4"
3380,400,33,1300,1700,"Sub-basin 4"
3381,100,1,900,1000,"Sub-basin 4"
3382,400,9,1400,1800,"Sub-basin 4"
3383,1900,145,9500,11400,"Sub-basin 4"
3384,100,2,500,600,"Sub-basin 4"
3385,200,17,2500,2700,"Sub-basin 4"
3386,100,2,1700,1800,"Sub-basin 4"
3387,1000,193,6500,7500,"Sub-basin 4"
3388,9600,1840,41200,50800,"Sub-basin 4"
3389,300,11,3600,3900,"Sub-basin 4"
3390,5300,1109,13400,18700,"Sub-basin 4"
3391,500,30,2700,3200,"Sub-basin 4"
3392,100,4,1600,1700,"Sub-basin 4"
3393,400,39,2100,2500,"Sub-basin 4"
3394,1200,161,5100,6300,"Sub-basin 4"
3395,200,5,1000,1200,"Sub-basin 4"
3396,200,11,1300,1500,"Sub-basin 4"
3397,1600,67,5500,7100,"Sub-basin 4"
3398,100,4,500,600,"Sub-basin 4"
3399,300,31,1400,1700,"Sub-basin 4"
3400,100,2,1700,1800,"Sub-basin 4"
3401,1200,151,7800,9000,"Sub-basin 4"
3402,6900,1224,33500,40400,"Sub-basin 4"
3403,1300,334,3700,5000,"Sub-basin 4"
3404,100,5,300,400,"Sub-basin 4"
3405,500,13,2000,2500,"Sub-basin 4"
3406,100,5,500,600,"Sub-basin 4"
3407,100,3,900,1000,"Sub-basin 4"
3408,100,4,1300,1400,"Sub-basin 4"
3409,400,26,3100,3500,"Sub-basin 4"
3410,100,5,2500,2600,"Sub-basin 4"
3411,2300,513,10700,13000,"Sub-basin 4"
3412,1300,220,7900,9200,"Sub-basin 4"
3413,1200,239,2100,3300,"Sub-basin 4"
3414,400,55,4700,5100,"Sub-basin 4"
3415,3000,416.67,11500,14500,"Sub-basin 4"
3416,1500,326,3100,4600,"Sub-basin 4"
3417,700,16,3600,4300,"Sub-basin 4"
3418,100,1,300,400,"Sub-basin 4"
3419,100,1,1100,1200,"Sub-basin 4"
3420,100,1,800,900,"Sub-basin 4"
3421,200,6,800,1000,"Sub-basin 4"
3422,100,3,700,800,"Sub-basin 4"
3423,200,11,2700,2900,"Sub-basin 4"
3424,800,39,5900,6700,"Sub-basin 4"
3425,100,2,3000,3100,"Sub-basin 4"
3426,600,72,2800,3400,"Sub-basin 4"
3427,300,8,2500,2800,"Sub-basin 4"
3428,3500,196,8900,12400,"Sub-basin 4"
3429,700,88,2800,3500,"Sub-basin 4"
3430,200,10,1600,1800,"Sub-basin 4"
3431,600,73,2800,3400,"Sub-basin 4"
3432,200,8,2100,2300,"Sub-basin 4"
3433,400,26,4400,4800,"Sub-basin 4"
3434,1200,176,3300,4500,"Sub-basin 4"
3435,400,22,5000,5400,"Sub-basin 4"
3436,400,65,5500,5900,"Sub-basin 4"
3437,3300,489,8000,11300,"Sub-basin 4"
3438,1300,184,4800,6100,"Sub-basin 4"
3439,800,13,2400,3200,"Sub-basin 4"
3440,200,7,700,900,"Sub-basin 4"
3441,100,2,2200,2300,"Sub-basin 4"
3442,300,13,2000,2300,"Sub-basin 4"
3443,100,1,2900,3000,"Sub-basin 4"
3444,100,2,1800,1900,"Sub-basin 4"
3445,3500,313,17000,20500,"Sub-basin 4"
3446,1700,368,6000,7700,"Sub-basin 4"
3447,6100,2215,17000,23100,"Sub-basin 4"
3448,300,10,3600,3900,"Sub-basin 4"
3449,100,2,800,900,"Sub-basin 4"
3450,800,94,4100,4900,"Sub-basin 4"
3451,500,19,3400,3900,"Sub-basin 4"
3452,900,128,2200,3100,"Sub-basin 4"
3453,100,2,2500,2600,"Sub-basin 4"
3454,200,16,3300,3500,"Sub-basin 4"
3455,100,5,2500,2600,"Sub-basin 4"
3456,100,1,1300,1400,"Sub-basin 4"
3457,2400,183,9300,11700,"Sub-basin 4"
3458,300,10,1800,2100,"Sub-basin 4"
3459,300,13,2600,2900,"Sub-basin 4"
3460,200,2,2800,3000,"Sub-basin 4"
3461,1200,247,7100,8300,"Sub-basin 4"
3462,14000,729,60900,74900,"Sub-basin 4"
3463,200,5,1400,1600,"Sub-basin 4"
3464,1300,381,4900,6200,"Sub-basin 4"
3465,400,54,2500,2900,"Sub-basin 4"
3466,7000,1069,34000,41000,"Sub-basin 4"
3467,1600,203,17800,19400,"Sub-basin 4"
3468,200,8,2000,2200,"Sub-basin 4"
3469,100,1,500,600,"Sub-basin 4"
3470,300,10,1200,1500,"Sub-basin 4"
3471,100,1,1600,1700,"Sub-basin 4"
3472,200,6,1000,1200,"Sub-basin 4"
3473,100,2,1000,1100,"Sub-basin 4"
3474,1900,275,6500,8400,"Sub-basin 4"
3475,1700,693,4200,5900,"Sub-basin 4"
3476,200,13,2300,2500,"Sub-basin 4"
3477,600,87,3700,4300,"Sub-basin 4"
3478,1600,484,3300,4900,"Sub-basin 4"
3479,2000,274,19900,21900,"Sub-basin 4"
3480,3900,383,22200,26100,"Sub-basin 4"
3481,400,52,2600,3000,"Sub-basin 4"
3482,2100,231,4800,6900,"Sub-basin 4"
3483,600,37,5500,6100,"Sub-basin 4"
3484,200,6,1600,1800,"Sub-basin 4"
3485,200,5,2600,2800,"Sub-basin 4"
3486,800,49,2000,2800,"Sub-basin 4"
3487,100,3,1400,1500,"Sub-basin 4"
3488,500,16,1900,2400,"Sub-basin 4"
3489,200,3,1600,1800,"Sub-basin 4"
3490,1300,56,7600,8900,"Sub-basin 4"
3491,10000,1466,33400,43400,"Sub-basin 4"
3492,300,20,400,700,"Sub-basin 4"
3493,100,1,300,400,"Sub-basin 4"
3494,7700,2665.84,20200,27900,"Sub-basin 4"
3495,100,1,600,700,"Sub-basin 4"
3496,400,32,5000,5400,"Sub-basin 4"
3497,100,1,800,900,"Sub-basin 4"
3498,200,7,3200,3400,"Sub-basin 4"
3499,1700,107,8000,9700,"Sub-basin 4"
3500,1100,69,6500,7600,"Sub-basin 4"
3501,100,2,800,900,"Sub-basin 4"
3502,1700,288,2600,4300,"Sub-basin 4"
3503,1900,77,8000,9900,"Sub-basin 4"
3504,100,1,2500,2600,"Sub-basin 4"
3505,200,8,4100,4300,"Sub-basin 4"
3506,18900,2720.51,39300,58200,"Sub-basin 4"
3507,1000,212,7600,8600,"Sub-basin 4"
3508,300,24,2300,2600,"Sub-basin 4"
3509,100,3,1300,1400,"Sub-basin 4"
3510,2500,232,10000,12500,"Sub-basin 4"
3511,400,43,2700,3100,"Sub-basin 4"
3512,2000,94,12600,14600,"Sub-basin 4"
3513,1400,135,14900,16300,"Sub-basin 4"
3514,100,1,1700,1800,"Sub-basin 4"
3515,200,3,1000,1200,"Sub-basin 4"
3516,20800,2790,37700,58500,"Sub-basin 4"
3517,3100,853,7400,10500,"Sub-basin 4"
3518,300,7,3100,3400,"Sub-basin 4"
3519,900,140,1800,2700,"Sub-basin 4"
3520,900,61,5000,5900,"Sub-basin 4"
3521,300,12,3900,4200,"Sub-basin 4"
3522,2600,84,13300,15900,"Sub-basin 4"
3523,100,3,600,700,"Sub-basin 4"
3524,100,5,1400,1500,"Sub-basin 4"
3525,700,142,5700,6400,"Sub-basin 4"
3526,1100,93,6800,7900,"Sub-basin 4"
3527,2000,227,12000,14000,"Sub-basin 4"
3528,300,7,2700,3000,"Sub-basin 4"
3529,100,1,400,500,"Sub-basin 4"
3530,100,1,1800,1900,"Sub-basin 4"
3531,100,1,1400,1500,"Sub-basin 4"
3532,100,1,2200,2300,"Sub-basin 4"
3533,300,16,800,1100,"Sub-basin 4"
3534,200,11,2700,2900,"Sub-basin 4"
3535,400,38,3700,4100,"Sub-basin 4"
3536,100,1,1600,1700,"Sub-basin 4"
3537,400,14,2900,3300,"Sub-basin 4"
3538,800,38,5200,6000,"Sub-basin 4"
3539,100,1,1300,1400,"Sub-basin 4"
3540,100,1,2400,2500,"Sub-basin 4"
3541,2700,204,17100,19800,"Sub-basin 4"
3542,300,5,2700,3000,"Sub-basin 4"
3543,300,16,4300,4600,"Sub-basin 4"
3544,100,2,800,900,"Sub-basin 4"
3545,900,38,4600,5500,"Sub-basin 4"
3546,100,2,2300,2400,"Sub-basin 4"
3547,100,3,1400,1500,"Sub-basin 4"
3548,100,2,1000,1100,"Sub-basin 4"
3549,400,25,1900,2300,"Sub-basin 4"
3550,300,27,2300,2600,"Sub-basin 4"
3551,100,1,700,800,"Sub-basin 4"
3552,6900,1132,48100,55000,"Sub-basin 4"
3553,900,35,11700,12600,"Sub-basin 4"
3554,1700,71,12600,14300,"Sub-basin 4"
3555,300,17,7100,7400,"Sub-basin 4"
3556,1400,204,9700,11100,"Sub-basin 4"
3557,600,43,6800,7400,"Sub-basin 4"
3558,4600,1539,16500,21100,"Sub-basin 4"
3559,100,5,1000,1100,"Sub-basin 4"
3560,1500,231.33,6700,8200,"Sub-basin 4"
3561,600,47,3600,4200,"Sub-basin 4"
3562,1000,35,12700,13700,"Sub-basin 4"
3563,100,1,800,900,"Sub-basin 4"
3564,700,36,3200,3900,"Sub-basin 4"
3565,300,13,2300,2600,"Sub-basin 4"
3566,600,51,900,1500,"Sub-basin 4"
3567,400,20,3200,3600,"Sub-basin 4"
3568,300,11,5900,6200,"Sub-basin 4"
3569,200,15,2400,2600,"Sub-basin 4"
3570,100,3,500,600,"Sub-basin 4"
3571,1000,133,4200,5200,"Sub-basin 4"
3572,4000,1640,13400,17400,"Sub-basin 4"
3573,400,51,4500,4900,"Sub-basin 4"
3574,500,31,2600,3100,"Sub-basin 4"
3575,7900,453,17500,25400,"Sub-basin 4"
3576,100,2,1100,1200,"Sub-basin 4"
3577,200,9,2000,2200,"Sub-basin 4"
3578,100,1,1200,1300,"Sub-basin 4"
3579,200,19,1800,2000,"Sub-basin 4"
3580,11600,977,25200,36800,"Sub-basin 4"
3581,200,2,1100,1300,"Sub-basin 4"
3582,200,2,1100,1300,"Sub-basin 4"
3583,1000,93,6300,7300,"Sub-basin 4"
3584,900,230,4600,5500,"Sub-basin 4"
3585,400,13,10200,10600,"Sub-basin 4"
3586,16000,2051,75500,91500,"Sub-basin 4"
3587,200,10,1900,2100,"Sub-basin 4"
3588,1800,348,5400,7200,"Sub-basin 4"
3589,100,1,1300,1400,"Sub-basin 4"
3590,100,2,800,900,"Sub-basin 4"
3591,100,1,1300,1400,"Sub-basin 4"
3592,200,8,2300,2500,"Sub-basin 4"
3593,500,20,2000,2500,"Sub-basin 4"
3594,1200,179,8200,9400,"Sub-basin 4"
3595,500,35,6700,7200,"Sub-basin 4"
3596,400,57,1500,1900,"Sub-basin 4"
3597,1200,163,4300,5500,"Sub-basin 4"
3598,5900,198,21100,27000,"Sub-basin 4"
3599,200,18,1500,1700,"Sub-basin 4"
3600,300,97,2200,2500,"Sub-basin 4"
3601,400,37,2500,2900,"Sub-basin 4"
3602,900,114,2500,3400,"Sub-basin 4"
3603,400,77,3000,3400,"Sub-basin 4"
3604,1600,129,5400,7000,"Sub-basin 4"
3605,100,12,900,1000,"Sub-basin 4"
3606,200,3,3500,3700,"Sub-basin 4"
3607,2600,238,9700,12300,"Sub-basin 4"
3608,100,8,700,800,"Sub-basin 4"
3609,400,20,2900,3300,"Sub-basin 4"
3610,1200,95,8500,9700,"Sub-basin 4"
3611,500,36,2900,3400,"Sub-basin 4"
3612,100,1,1100,1200,"Sub-basin 4"
3613,900,115,5500,6400,"Sub-basin 4"
3614,200,4,2400,2600,"Sub-basin 4"
3615,900,160,7300,8200,"Sub-basin 4"
3616,100,5,1200,1300,"Sub-basin 4"
3617,100,2,2700,2800,"Sub-basin 4"
3618,300,14,2400,2700,"Sub-basin 4"
3619,200,2,900,1100,"Sub-basin 4"
3620,1700,129,6800,8500,"Sub-basin 4"
3621,1000,361,6600,7600,"Sub-basin 4"
3622,400,14,1400,1800,"Sub-basin 4"
3623,100,2,1100,1200,"Sub-basin 4"
3624,1000,116,6600,7600,"Sub-basin 4"
3625,500,31,7100,7600,"Sub-basin 4"
3626,400,21,2400,2800,"Sub-basin 4"
3627,100,2,1500,1600,"Sub-basin 4"
3628,2200,196,5600,7800,"Sub-basin 4"
3629,200,9,3000,3200,"Sub-basin 4"
3630,100,1,1200,1300,"Sub-basin 4"
3631,400,8,3300,3700,"Sub-basin 4"
3632,400,42,4700,5100,"Sub-basin 4"
3633,100,1,900,1000,"Sub-basin 4"
3634,300,12,1000,1300,"Sub-basin 4"
3635,400,38,3100,3500,"Sub-basin 4"
3636,200,20,2700,2900,"Sub-basin 4"
3637,2100,201,10800,12900,"Sub-basin 4"
3638,4200,256,12700,16900,"Sub-basin 4"
3639,400,42,3000,3400,"Sub-basin 4"
3640,400,13,3600,4000,"Sub-basin 4"
3641,200,4,1900,2100,"Sub-basin 4"
3642,9300,2934.16,23400,32700,"Sub-basin 4"
3643,1000,72,6900,7900,"Sub-basin 4"
3644,100,2,1300,1400,"Sub-basin 4"
3645,1200,206,4300,5500,"Sub-basin 4"
3646,100,3,600,700,"Sub-basin 4"
3647,1700,205,4200,5900,"Sub-basin 4"
3648,700,100,2200,2900,"Sub-basin 4"
3649,500,62,11400,11900,"Sub-basin 4"
3650,200,11,1200,1400,"Sub-basin 4"
3651,1200,118,4300,5500,"Sub-basin 4"
3652,8600,947,26400,35000,"Sub-basin 4"
3653,200,7,2400,2600,"Sub-basin 4"
3654,600,15,1800,2400,"Sub-basin 4"
3655,4600,518,9300,13900,"Sub-basin 4"
3656,200,7,1500,1700,"Sub-basin 4"
3657,12400,6108,18200,30600,"Sub-basin 4"
3658,5100,889,20700,25800,"Sub-basin 4"
3659,200,2,2400,2600,"Sub-basin 4"
3660,100,1,800,900,"Sub-basin 4"
3661,100,3,1500,1600,"Sub-basin 4"
3662,400,71,3600,4000,"Sub-basin 4"
3663,200,21,1500,1700,"Sub-basin 4"
3664,800,190,6000,6800,"Sub-basin 4"
3665,100,3,500,600,"Sub-basin 4"
3666,100,3,500,600,"Sub-basin 4"
3667,300,9,2800,3100,"Sub-basin 4"
3668,400,10,4400,4800,"Sub-basin 4"
3669,900,258,5400,6300,"Sub-basin 4"
3670,100,1,700,800,"Sub-basin 4"
3671,1000,222,7100,8100,"Sub-basin 4"
3672,300,35,2300,2600,"Sub-basin 4"
3673,100,1,1300,1400,"Sub-basin 4"
3674,100,4,700,800,"Sub-basin 4"
3675,200,5,2400,2600,"Sub-basin 4"
3676,200,12,3100,3300,"Sub-basin 4"
3677,1500,560,5100,6600,"Sub-basin 4"
3678,900,78,5700,6600,"Sub-basin 4"
3679,300,25,2400,2700,"Sub-basin 4"
3680,3500,128,8900,12400,"Sub-basin 4"
3681,33100,2336,48700,81800,"Sub-basin 4"
3682,100,4,1200,1300,"Sub-basin 4"
3683,200,9,1300,1500,"Sub-basin 4"
3684,100,2,1100,1200,"Sub-basin 4"
3685,700,151,3800,4500,"Sub-basin 4"
3686,500,54,6600,7100,"Sub-basin 4"
3687,300,13,1900,2200,"Sub-basin 4"
3688,100,4,300,400,"Sub-basin 4"
3689,600,21,2400,3000,"Sub-basin 4"
3690,500,16,6400,6900,"Sub-basin 4"
3691,500,52,5300,5800,"Sub-basin 4"
3692,200,17,2500,2700,"Sub-basin 4"
3693,100,2,2100,2200,"Sub-basin 4"
3694,100,5,1600,1700,"Sub-basin 4"
3695,1300,66,6200,7500,"Sub-basin 4"
3696,100,1,800,900,"Sub-basin 4"
3697,100,1,1000,1100,"Sub-basin 4"
3698,100,7,1600,1700,"Sub-basin 4"
3699,200,12,1100,1300,"Sub-basin 4"
3700,100,5,1000,1100,"Sub-basin 4"
3701,6300,342,16000,22300,"Sub-basin 4"
3702,600,46,2600,3200,"Sub-basin 4"
3703,1400,195,2000,3400,"Sub-basin 4"
3704,200,6,4600,4800,"Sub-basin 4"
3705,100,9,900,1000,"Sub-basin 4"
3706,100,4,1500,1600,"Sub-basin 4"
3707,600,8,4200,4800,"Sub-basin 4"
3708,100,1,100,200,"Sub-basin 4"
3709,800,158,3900,4700,"Sub-basin 4"
3710,400,19,2900,3300,"Sub-basin 4"
3711,46900,18253,85700,132600,"Sub-basin 4"
3712,600,40,8000,8600,"Sub-basin 4"
3713,100,6,3800,3900,"Sub-basin 4"
3714,900,116,5000,5900,"Sub-basin 4"
3715,100,1,2000,2100,"Sub-basin 4"
3716,5900,555,14300,20200,"Sub-basin 4"
3717,100,5,1200,1300,"Sub-basin 4"
3718,100,1,800,900,"Sub-basin 4"
3719,200,9,400,600,"Sub-basin 4"
3720,800,47,2200,3000,"Sub-basin 4"
3721,400,30,6700,7100,"Sub-basin 4"
3722,200,7,1800,2000,"Sub-basin 4"
3723,100,1,700,800,"Sub-basin 4"
3724,4300,227,15800,20100,"Sub-basin 4"
3725,1100,195,7000,8100,"Sub-basin 4"
3726,100,2,1200,1300,"Sub-basin 4"
3727,2100,193,6500,8600,"Sub-basin 4"
3728,54600,3992.67,62900,117500,"Sub-basin 4"
3729,19500,1200.66,30000,49500,"Sub-basin 4"
3730,3800,147,15400,19200,"Sub-basin 4"
3731,400,18,2500,2900,"Sub-basin 4"
3732,100,2,2500,2600,"Sub-basin 4"
3733,400,61,2300,2700,"Sub-basin 4"
3734,400,23,1900,2300,"Sub-basin 4"
3735,600,55,1800,2400,"Sub-basin 4"
3736,700,87,3800,4500,"Sub-basin 4"
3737,100,3,1100,1200,"Sub-basin 4"
3738,1600,59,5000,6600,"Sub-basin 4"
3739,200,9,1100,1300,"Sub-basin 4"
3740,100,1,1100,1200,"Sub-basin 4"
3741,200,2,2700,2900,"Sub-basin 4"
3742,18900,1102,31100,50000,"Sub-basin 4"
3743,1200,131,2300,3500,"Sub-basin 4"
3744,100,5,700,800,"Sub-basin 4"
3745,800,160,4500,5300,"Sub-basin 4"
3746,400,13,3800,4200,"Sub-basin 4"
3747,1500,87,9200,10700,"Sub-basin 4"
3748,100,4,1300,1400,"Sub-basin 4"
3749,200,5,1900,2100,"Sub-basin 4"
3750,400,9,2100,2500,"Sub-basin 4"
3751,100,2,1000,1100,"Sub-basin 4"
3752,2400,497,10200,12600,"Sub-basin 4"
3753,900,184,5400,6300,"Sub-basin 4"
3754,400,19,5200,5600,"Sub-basin 4"
3755,200,2,2300,2500,"Sub-basin 4"
3756,100,1,700,800,"Sub-basin 4"
3757,1200,119,4000,5200,"Sub-basin 4"
3758,16900,3095,25000,41900,"Sub-basin 4"
3759,500,12,2300,2800,"Sub-basin 4"
3760,4000,217,12100,16100,"Sub-basin 4"
3761,100,3,900,1000,"Sub-basin 4"
3762,600,119,7500,8100,"Sub-basin 4"
3763,200,44,4600,4800,"Sub-basin 4"
3764,600,29,5000,5600,"Sub-basin 4"
3765,500,60,1800,2300,"Sub-basin 4"
3766,300,20,1700,2000,"Sub-basin 4"
3767,900,109,4600,5500,"Sub-basin 4"
3768,200,2,600,800,"Sub-basin 4"
3769,200,5,3500,3700,"Sub-basin 4"
3770,4600,1425,14400,19000,"Sub-basin 4"
3771,200,13,3000,3200,"Sub-basin 4"
3772,1300,177,14000,15300,"Sub-basin 4"
3773,1300,234,11600,12900,"Sub-basin 4"
3774,5500,1185,18800,24300,"Sub-basin 4"
3775,19200,2210,30500,49700,"Sub-basin 4"
3776,500,55,2300,2800,"Sub-basin 4"
3777,100,2,1700,1800,"Sub-basin 4"
3778,500,16,4100,4600,"Sub-basin 4"
3779,300,7,2800,3100,"Sub-basin 4"
3780,100,4,1400,1500,"Sub-basin 4"
3781,200,11,3000,3200,"Sub-basin 4"
3782,100,3,1600,1700,"Sub-basin 4"
3783,700,29,3600,4300,"Sub-basin 4"
3784,500,74,1300,1800,"Sub-basin 4"
3785,100,3,1100,1200,"Sub-basin 4"
3786,300,21,2000,2300,"Sub-basin 4"
3787,200,3,1800,2000,"Sub-basin 4"
3788,2800,825.67,18200,21000,"Sub-basin 4"
3789,900,133,8600,9500,"Sub-basin 4"
3790,400,9,4700,5100,"Sub-basin 4"
3791,700,17,8200,8900,"Sub-basin 4"
3792,900,82,4400,5300,"Sub-basin 4"
3793,200,8,2700,2900,"Sub-basin 4"
3794,400,62,1900,2300,"Sub-basin 4"
3795,300,15,2400,2700,"Sub-basin 4"
3796,100,5,1300,1400,"Sub-basin 4"
3797,900,196,3300,4200,"Sub-basin 4"
3798,100,1,800,900,"Sub-basin 4"
3799,300,4,400,700,"Sub-basin 4"
3800,400,11,1900,2300,"Sub-basin 4"
3801,100,1,1200,1300,"Sub-basin 4"
3802,900,21,12200,13100,"Sub-basin 4"
3803,800,26,3900,4700,"Sub-basin 4"
3804,5400,824,16700,22100,"Sub-basin 4"
3805,500,22,2400,2900,"Sub-basin 4"
3806,100,3,1700,1800,"Sub-basin 4"
3807,100,2,1000,1100,"Sub-basin 4"
3808,300,16,2300,2600,"Sub-basin 4"
3809,400,45,1200,1600,"Sub-basin 4"
3810,400,28,4900,5300,"Sub-basin 4"
3811,100,2,700,800,"Sub-basin 4"
3812,100,2,1000,1100,"Sub-basin 4"
3813,100,1,100,200,"Sub-basin 4"
3814,500,9,2900,3400,"Sub-basin 4"
3815,5800,266.67,14600,20400,"Sub-basin 4"
3816,100,3,1500,1600,"Sub-basin 4"
3817,400,122,1600,2000,"Sub-basin 4"
3818,1000,213,9300,10300,"Sub-basin 4"
3819,1800,332,15200,17000,"Sub-basin 4"
3820,200,11,1700,1900,"Sub-basin 4"
3821,300,18,2400,2700,"Sub-basin 4"
3822,500,55,2800,3300,"Sub-basin 4"
3823,3000,158,11600,14600,"Sub-basin 4"
3824,1200,37,9400,10600,"Sub-basin 4"
3825,100,2,1200,1300,"Sub-basin 4"
3826,100,1,600,700,"Sub-basin 4"
3827,300,6,3100,3400,"Sub-basin 4"
3828,100,1,800,900,"Sub-basin 4"
3829,400,13,1800,2200,"Sub-basin 4"
3830,4800,1565,15900,20700,"Sub-basin 4"
3831,400,32,6000,6400,"Sub-basin 4"
3832,100,1,2400,2500,"Sub-basin 4"
3833,1600,260,5700,7300,"Sub-basin 4"
3834,700,42,5800,6500,"Sub-basin 4"
3835,1300,295,2800,4100,"Sub-basin 4"
3836,200,15,1300,1500,"Sub-basin 4"
3837,2400,129,5700,8100,"Sub-basin 4"
3838,400,67,1500,1900,"Sub-basin 4"
3839,100,1,1600,1700,"Sub-basin 4"
3840,400,54,4100,4500,"Sub-basin 4"
3841,2200,387,7100,9300,"Sub-basin 4"
3842,100,2,1100,1200,"Sub-basin 4"
3843,5200,1191,8700,13900,"Sub-basin 4"
3844,500,19,1200,1700,"Sub-basin 4"
3845,1400,342,4900,6300,"Sub-basin 4"
3846,3200,160,17200,20400,"Sub-basin 4"
3847,2800,319,6800,9600,"Sub-basin 4"
3848,300,25,1100,1400,"Sub-basin 4"
3849,200,6,2100,2300,"Sub-basin 4"
3850,100,3,1200,1300,"Sub-basin 4"
3851,9800,2178,20600,30400,"Sub-basin 4"
3852,100,7,1000,1100,"Sub-basin 4"
3853,100,1,700,800,"Sub-basin 4"
3854,400,5,3000,3400,"Sub-basin 4"
3855,100,2,1400,1500,"Sub-basin 4"
3856,1100,100,2300,3400,"Sub-basin 4"
3857,800,82,13300,14100,"Sub-basin 4"
3858,100,1,2800,2900,"Sub-basin 4"
3859,6600,1092,38000,44600,"Sub-basin 4"
3860,300,30,2500,2800,"Sub-basin 4"
3861,200,10,2600,2800,"Sub-basin 4"
3862,100,3,300,400,"Sub-basin 4"
3863,4400,382,10300,14700,"Sub-basin 4"
3864,500,110,2300,2800,"Sub-basin 4"
3865,100,3,800,900,"Sub-basin 4"
3866,200,13,1400,1600,"Sub-basin 4"
3867,200,6,3400,3600,"Sub-basin 4"
3868,200,6,4700,4900,"Sub-basin 4"
3869,200,15,2000,2200,"Sub-basin 4"
3870,1300,165,8600,9900,"Sub-basin 4"
3871,800,40,12300,13100,"Sub-basin 4"
3872,600,14,5600,6200,"Sub-basin 4"
3873,100,1,700,800,"Sub-basin 4"
3874,12100,998,21800,33900,"Sub-basin 4"
3875,100,2,500,600,"Sub-basin 4"
3876,900,119,3400,4300,"Sub-basin 4"
3877,6500,417,12900,19400,"Sub-basin 4"
3878,7400,1233,33500,40900,"Sub-basin 4"
3879,500,24,8800,9300,"Sub-basin 4"
3880,100,4,2000,2100,"Sub-basin 4"
3881,100,1,1700,1800,"Sub-basin 4"
3882,1000,81,5800,6800,"Sub-basin 4"
3883,100,1,1700,1800,"Sub-basin 4"
3884,5600,400,7900,13500,"Sub-basin 4"
3885,1000,48,6000,7000,"Sub-basin 4"
3886,1300,85,2600,3900,"Sub-basin 4"
3887,1000,264,2400,3400,"Sub-basin 4"
3888,100,2,1400,1500,"Sub-basin 4"
3889,3300,438,12700,16000,"Sub-basin 4"
3890,4100,157,13600,17700,"Sub-basin 4"
3891,100,2,1400,1500,"Sub-basin 4"
3892,100,2,1600,1700,"Sub-basin 4"
3893,600,17,6500,7100,"Sub-basin 4"
3894,500,19,3500,4000,"Sub-basin 4"
3895,100,4,1100,1200,"Sub-basin 4"
3896,700,80,5000,5700,"Sub-basin 4"
3897,400,75,2000,2400,"Sub-basin 4"
3898,13200,1735.17,12300,25500,"Sub-basin 4"
3899,600,58,3200,3800,"Sub-basin 4"
3900,700,57,5000,5700,"Sub-basin 4"
3901,200,19,1800,2000,"Sub-basin 4"
3902,100,3,1600,1700,"Sub-basin 4"
3903,100,4,400,500,"Sub-basin 4"
3904,3300,171,9500,12800,"Sub-basin 4"
3905,1000,58,7000,8000,"Sub-basin 4"
3906,4500,519.17,23900,28400,"Sub-basin 4"
3907,300,3,2500,2800,"Sub-basin 4"
3908,200,6,1600,1800,"Sub-basin 4"
3909,100,1,1800,1900,"Sub-basin 4"
3910,400,16,3800,4200,"Sub-basin 4"
3911,100,2,2100,2200,"Sub-basin 4"
3912,1500,375,10100,11600,"Sub-basin 4"
3913,300,8,2400,2700,"Sub-basin 4"
3914,2000,145,6000,8000,"Sub-basin 4"
3915,4700,307,10900,15600,"Sub-basin 4"
3916,800,92,4800,5600,"Sub-basin 4"
3917,200,7,800,1000,"Sub-basin 4"
3918,200,6,2000,2200,"Sub-basin 4"
3919,1200,90,4600,5800,"Sub-basin 4"
3920,100,5,1000,1100,"Sub-basin 4"
3921,700,25,1900,2600,"Sub-basin 4"
3922,200,11,2500,2700,"Sub-basin 4"
3923,300,21,1800,2100,"Sub-basin 4"
3924,100,1,800,900,"Sub-basin 4"
3925,200,3,1700,1900,"Sub-basin 4"
3926,100,2,1200,1300,"Sub-basin 4"
3927,100,1,700,800,"Sub-basin 4"
3928,200,6,800,1000,"Sub-basin 4"
3929,100,2,1000,1100,"Sub-basin 4"
3930,100,2,900,1000,"Sub-basin 4"
3931,100,2,1000,1100,"Sub-basin 4"
3932,1000,106,3200,4200,"Sub-basin 4"
3933,300,14,1900,2200,"Sub-basin 4"
3934,400,12,4000,4400,"Sub-basin 4"
3935,100,2,1100,1200,"Sub-basin 4"
3936,2000,360,8600,10600,"Sub-basin 4"
3937,400,38,2000,2400,"Sub-basin 4"
3938,400,10,3200,3600,"Sub-basin 4"
3939,400,32,1500,1900,"Sub-basin 4"
3940,32600,5149.5,43000,75600,"Sub-basin 4"
3941,800,194,3200,4000,"Sub-basin 4"
3942,400,18,2800,3200,"Sub-basin 4"
3943,100,1,1100,1200,"Sub-basin 4"
3944,5200,881,18500,23700,"Sub-basin 4"
3945,400,17,1400,1800,"Sub-basin 4"
3946,400,18,2200,2600,"Sub-basin 4"
3947,400,19,3700,4100,"Sub-basin 4"
3948,100,1,1000,1100,"Sub-basin 4"
3949,100,4,1200,1300,"Sub-basin 4"
3950,200,6,3700,3900,"Sub-basin 4"
3951,100,1,2400,2500,"Sub-basin 4"
3952,1000,271,2500,3500,"Sub-basin 4"
3953,7800,449,18800,26600,"Sub-basin 4"
3954,100,2,600,700,"Sub-basin 4"
3955,400,31,3600,4000,"Sub-basin 4"
3956,200,8,3900,4100,"Sub-basin 4"
3957,900,36,11900,12800,"Sub-basin 4"
3958,9400,2950,14100,23500,"Sub-basin 4"
3959,400,49,3800,4200,"Sub-basin 4"
3960,100,3,800,900,"Sub-basin 4"
3961,4300,100,15300,19600,"Sub-basin 4"
3962,300,6,2400,2700,"Sub-basin 4"
3963,253800,72545.35,180500,434300,"Sub-basin 4"
3964,1200,179,5200,6400,"Sub-basin 4"
3965,37300,7752.34,32900,70200,"Sub-basin 4"
3966,11800,4804,27500,39300,"Sub-basin 4"
3967,700,32,8300,9000,"Sub-basin 4"
3968,400,13,5700,6100,"Sub-basin 4"
3969,600,24,9200,9800,"Sub-basin 4"
3970,5100,514.67,26300,31400,"Sub-basin 4"
3971,400,52,5700,6100,"Sub-basin 4"
3972,400,23,5400,5800,"Sub-basin 4"
3973,1900,112,10300,12200,"Sub-basin 4"
3974,800,193,2500,3300,"Sub-basin 4"
3975,1400,36,6300,7700,"Sub-basin 4"
3976,6800,343,11700,18500,"Sub-basin 4"
3977,200,32,700,900,"Sub-basin 4"
3978,200,11,2000,2200,"Sub-basin 4"
3979,300,10,5200,5500,"Sub-basin 4"
3980,33500,16650,45100,78600,"Sub-basin 4"
3981,500,13,7100,7600,"Sub-basin 4"
3982,800,62,7200,8000,"Sub-basin 4"
3983,100,1,1900,2000,"Sub-basin 4"
3984,6300,1178,20100,26400,"Sub-basin 4"
3985,800,126,10500,11300,"Sub-basin 4"
3986,500,58,9800,10300,"Sub-basin 4"
3987,1900,162,16300,18200,"Sub-basin 4"
3988,1200,204,5700,6900,"Sub-basin 4"
3989,700,59,3600,4300,"Sub-basin 4"
3990,300,17,2100,2400,"Sub-basin 4"
3991,100,1,1300,1400,"Sub-basin 4"
3992,200,6,2700,2900,"Sub-basin 4"
3993,600,93,3900,4500,"Sub-basin 4"
3994,2800,239,6700,9500,"Sub-basin 4"
3995,800,73,6500,7300,"Sub-basin 4"
3996,200,6,1600,1800,"Sub-basin 4"
3997,600,69,4700,5300,"Sub-basin 4"
3998,100,2,800,900,"Sub-basin 4"
3999,100,6,700,800,"Sub-basin 4"
4000,300,19,3200,3500,"Sub-basin 4"
4001,600,44.5,2200,2800,"Sub-basin 4"
4002,100,1,1400,1500,"Sub-basin 4"
4003,100,1,500,600,"Sub-basin 4"
4004,800,136,10000,10800,"Sub-basin 4"
4005,1200,32,10000,11200,"Sub-basin 4"
4006,300,22,1300,1600,"Sub-basin 4"
4007,1000,84,4600,5600,"Sub-basin 4"
4008,200,2,1000,1200,"Sub-basin 4"
4009,200,10,4200,4400,"Sub-basin 4"
4010,100,4,1300,1400,"Sub-basin 4"
4011,6500,877,37500,44000,"Sub-basin 4"
4012,1700,306,9500,11200,"Sub-basin 4"
4013,17200,2513,40700,57900,"Sub-basin 4"
4014,300,8,2200,2500,"Sub-basin 4"
4015,100,1,600,700,"Sub-basin 4"
4016,600,19,2300,2900,"Sub-basin 4"
4017,100,2,1300,1400,"Sub-basin 4"
4018,100,4,800,900,"Sub-basin 4"
4019,100,2,1500,1600,"Sub-basin 4"
4020,200,7,1000,1200,"Sub-basin 4"
4021,100,4,1400,1500,"Sub-basin 4"
4022,700,25,10800,11500,"Sub-basin 4"
4023,100,1,1100,1200,"Sub-basin 4"
4024,500,33,2300,2800,"Sub-basin 4"
4025,100,1,500,600,"Sub-basin 4"
4026,100,1,500,600,"Sub-basin 4"
4027,100,1,1000,1100,"Sub-basin 4"
4028,100,3,200,300,"Sub-basin 4"
4029,100,3,1300,1400,"Sub-basin 4"
4030,100,2,1000,1100,"Sub-basin 4"
4031,2000,376,8400,10400,"Sub-basin 4"
4032,1400,191,14600,16000,"Sub-basin 4"
4033,400,32,3200,3600,"Sub-basin 4"
4034,700,213,5400,6100,"Sub-basin 4"
4035,100,5,1400,1500,"Sub-basin 4"
4036,100,1,2400,2500,"Sub-basin 4"
4037,1200,28,7700,8900,"Sub-basin 4"
4038,3700,163,12300,16000,"Sub-basin 4"
4039,1300,82.67,5000,6300,"Sub-basin 4"
4040,200,5,2100,2300,"Sub-basin 4"
4041,600,10,5100,5700,"Sub-basin 4"
4042,200,3,1900,2100,"Sub-basin 4"
4043,100,1,1000,1100,"Sub-basin 4"
4044,100,1,1300,1400,"Sub-basin 4"
4045,1700,231,9500,11200,"Sub-basin 4"
4046,100,3,800,900,"Sub-basin 4"
4047,18200,813,30800,49000,"Sub-basin 4"
4048,400,6,6200,6600,"Sub-basin 4"
4049,100,1,1100,1200,"Sub-basin 4"
4050,100,2,1600,1700,"Sub-basin 4"
4051,500,74,3000,3500,"Sub-basin 4"
4052,2400,108,6300,8700,"Sub-basin 4"
4053,100,1,600,700,"Sub-basin 4"
4054,370900,21298.16,428600,799500,"Sub-basin 4"
4055,700,29,1000,1700,"Sub-basin 4"
4056,1600,128,4800,6400,"Sub-basin 4"
4057,1200,133,7600,8800,"Sub-basin 4"
4058,5600,210,18900,24500,"Sub-basin 4"
4059,100,2,800,900,"Sub-basin 4"
4060,100,1,500,600,"Sub-basin 4"
4061,3200,91,8200,11400,"Sub-basin 4"
4062,300,19,3700,4000,"Sub-basin 4"
4063,1500,131,11700,13200,"Sub-basin 4"
4064,200,4,3900,4100,"Sub-basin 4"
4065,1600,397,5800,7400,"Sub-basin 4"
4066,200,21,1100,1300,"Sub-basin 4"
4067,500,19,2600,3100,"Sub-basin 4"
4068,100,1,1600,1700,"Sub-basin 4"
4069,100,3,1000,1100,"Sub-basin 4"
4070,100,1,600,700,"Sub-basin 4"
4071,900,56,7800,8700,"Sub-basin 4"
4072,2000,210,16600,18600,"Sub-basin 4"
4073,100,2,1000,1100,"Sub-basin 4"
4074,1000,127,5500,6500,"Sub-basin 4"
4075,300,8,1600,1900,"Sub-basin 4"
4076,1300,280,5500,6800,"Sub-basin 4"
4077,1900,61,6700,8600,"Sub-basin 4"
4078,200,3,1800,2000,"Sub-basin 4"
4079,5700,924,6500,12200,"Sub-basin 4"
4080,400,39,900,1300,"Sub-basin 4"
4081,300,4,2800,3100,"Sub-basin 4"
4082,100,1,1000,1100,"Sub-basin 4"
4083,700,28,10400,11100,"Sub-basin 4"
4084,100,2,700,800,"Sub-basin 4"
4085,100,1,600,700,"Sub-basin 4"
4086,300,16,2000,2300,"Sub-basin 4"
4087,200,7,2000,2200,"Sub-basin 4"
4088,200,4,1700,1900,"Sub-basin 4"
4089,100,4,1800,1900,"Sub-basin 4"
4090,200,4,1300,1500,"Sub-basin 4"
4091,1800,180,3400,5200,"Sub-basin 4"
4092,100,5,1500,1600,"Sub-basin 4"
4093,2000,432,3800,5800,"Sub-basin 4"
4094,400,16,2400,2800,"Sub-basin 4"
4095,200,4,3500,3700,"Sub-basin 4"
4096,1200,233,4300,5500,"Sub-basin 4"
4097,1700,452,4200,5900,"Sub-basin 4"
4098,100,2,700,800,"Sub-basin 4"
4099,300,16,1100,1400,"Sub-basin 4"
4100,100,2,2400,2500,"Sub-basin 4"
4101,4200,545,37100,41300,"Sub-basin 4"
4102,100,6,2100,2200,"Sub-basin 4"
4103,400,5.67,3400,3800,"Sub-basin 4"
4104,2400,379,20800,23200,"Sub-basin 4"
4105,8100,805.99,12800,20900,"Sub-basin 4"
4106,3100,88,13700,16800,"Sub-basin 4"
4107,3200,118,11900,15100,"Sub-basin 4"
4108,100,2,900,1000,"Sub-basin 4"
4109,900,100,2400,3300,"Sub-basin 4"
4110,400,23,7100,7500,"Sub-basin 4"
4111,3100,496,10100,13200,"Sub-basin 4"
4112,8000,216,24700,32700,"Sub-basin 4"
4113,600,111,2600,3200,"Sub-basin 4"
4114,100,2,500,600,"Sub-basin 4"
4115,200,4,2000,2200,"Sub-basin 4"
4116,300,7,6300,6600,"Sub-basin 4"
4117,100,3,700,800,"Sub-basin 4"
4118,100,10,1300,1400,"Sub-basin 4"
4119,100,1,800,900,"Sub-basin 4"
4120,200,4,2200,2400,"Sub-basin 4"
4121,500,47,2900,3400,"Sub-basin 4"
4122,700,51,8400,9100,"Sub-basin 4"
4123,300,5,3400,3700,"Sub-basin 4"
4124,100,2,800,900,"Sub-basin 4"
4125,100,1,1300,1400,"Sub-basin 4"
4126,200,20,2300,2500,"Sub-basin 4"
4127,100,1,300,400,"Sub-basin 4"
4128,4200,953,16500,20700,"Sub-basin 4"
4129,300,5,1200,1500,"Sub-basin 4"
4130,1300,356,5200,6500,"Sub-basin 4"
4131,500,44,2900,3400,"Sub-basin 4"
4132,1400,270,3400,4800,"Sub-basin 4"
4133,7900,1263,23500,31400,"Sub-basin 4"
4134,1900,51,7600,9500,"Sub-basin 4"
4135,300,5,1900,2200,"Sub-basin 4"
4136,1100,20,6100,7200,"Sub-basin 4"
4137,300,15,800,1100,"Sub-basin 4"
4138,2800,241,28000,30800,"Sub-basin 4"
4139,3300,1651,12300,15600,"Sub-basin 4"
4140,400,35,4400,4800,"Sub-basin 4"
4141,300,13,2300,2600,"Sub-basin 4"
4142,2500,319,6700,9200,"Sub-basin 4"
4143,200,4,2000,2200,"Sub-basin 4"
4144,100,1,1400,1500,"Sub-basin 4"
4145,400,48,3200,3600,"Sub-basin 4"
4146,700,89,5300,6000,"Sub-basin 4"
4147,200,4,1700,1900,"Sub-basin 4"
4148,100,1,800,900,"Sub-basin 4"
4149,400,11,1200,1600,"Sub-basin 4"
4150,300,10,3100,3400,"Sub-basin 4"
4151,100,2,500,600,"Sub-basin 4"
4152,100,1,300,400,"Sub-basin 4"
4153,1800,407,1400,3200,"Sub-basin 4"
4154,500,55,900,1400,"Sub-basin 4"
4155,100,4,1000,1100,"Sub-basin 4"
4156,2600,314,15600,18200,"Sub-basin 4"
4157,800,253,6000,6800,"Sub-basin 4"
4158,300,7,1700,2000,"Sub-basin 4"
4159,100,1,500,600,"Sub-basin 4"
4160,11100,4931.33,13500,24600,"Sub-basin 4"
4161,100,1,1700,1800,"Sub-basin 4"
4162,100,3,2400,2500,"Sub-basin 4"
4163,4200,929,12000,16200,"Sub-basin 4"
4164,400,18,2400,2800,"Sub-basin 4"
4165,500,74,2700,3200,"Sub-basin 4"
4166,600,67,6800,7400,"Sub-basin 4"
4167,400,26,600,1000,"Sub-basin 4"
4168,500,61,4500,5000,"Sub-basin 4"
4169,500,53,3800,4300,"Sub-basin 4"
4170,300,8,1800,2100,"Sub-basin 4"
4171,400,22,4200,4600,"Sub-basin 4"
4172,100,1,1000,1100,"Sub-basin 4"
4173,400,5,3700,4100,"Sub-basin 4"
4174,200,5,2000,2200,"Sub-basin 4"
4175,600,11,4400,5000,"Sub-basin 4"
4176,2300,522,10900,13200,"Sub-basin 4"
4177,100,1,1000,1100,"Sub-basin 4"
4178,100,2,1000,1100,"Sub-basin 4"
4179,3600,108,10600,14200,"Sub-basin 4"
4180,400,33,2100,2500,"Sub-basin 4"
4181,600,59,2900,3500,"Sub-basin 4"
4182,900,103,2300,3200,"Sub-basin 4"
4183,2300,191,6600,8900,"Sub-basin 4"
4184,4800,1099,10300,15100,"Sub-basin 4"
4185,2700,1518,3900,6600,"Sub-basin 4"
4186,800,140,3200,4000,"Sub-basin 4"
4187,100,5,1400,1500,"Sub-basin 4"
4188,1000,241,4500,5500,"Sub-basin 4"
4189,100,5,1900,2000,"Sub-basin 4"
4190,100,1,800,900,"Sub-basin 4"
4191,100,1,1700,1800,"Sub-basin 4"
4192,4900,693,12600,17500,"Sub-basin 4"
4193,300,14,4700,5000,"Sub-basin 4"
4194,2100,361,11800,13900,"Sub-basin 4"
4195,600,43,5900,6500,"Sub-basin 4"
4196,4900,685,24500,29400,"Sub-basin 4"
4197,200,4,900,1100,"Sub-basin 4"
4198,100,5,1800,1900,"Sub-basin 4"
4199,800,146,5000,5800,"Sub-basin 4"
4200,800,62,4000,4800,"Sub-basin 4"
4201,700,56,7000,7700,"Sub-basin 4"
4202,100,4,400,500,"Sub-basin 4"
4203,100,2,600,700,"Sub-basin 4"
4204,100,2,900,1000,"Sub-basin 4"
4205,100,1,1600,1700,"Sub-basin 4"
4206,100,1,1100,1200,"Sub-basin 4"
4207,800,15,8600,9400,"Sub-basin 4"
4208,100,10,1200,1300,"Sub-basin 4"
4209,2500,347,24500,27000,"Sub-basin 4"
4210,1800,280,8300,10100,"Sub-basin 4"
4211,1500,303,8200,9700,"Sub-basin 4"
4212,100,1,3000,3100,"Sub-basin 4"
4213,5700,1924,11900,17600,"Sub-basin 4"
4214,100,3,200,300,"Sub-basin 4"
4215,100,2,1200,1300,"Sub-basin 4"
4216,100,2,400,500,"Sub-basin 4"
4217,1800,60,6300,8100,"Sub-basin 4"
4218,100,10,1100,1200,"Sub-basin 4"
4219,3600,855,12500,16100,"Sub-basin 4"
4220,100,3,1200,1300,"Sub-basin 4"
4221,100,4,1200,1300,"Sub-basin 4"
4222,100,4,1000,1100,"Sub-basin 4"
4223,100,1,1900,2000,"Sub-basin 4"
4224,300,5,4700,5000,"Sub-basin 4"
4225,100,6,1100,1200,"Sub-basin 4"
4226,300,6,1900,2200,"Sub-basin 4"
4227,200,12,1900,2100,"Sub-basin 4"
4228,700,67,9700,10400,"Sub-basin 4"
4229,3700,962,6600,10300,"Sub-basin 4"
4230,300,5,2300,2600,"Sub-basin 4"
4231,300,5,4100,4400,"Sub-basin 4"
4232,500,13,7100,7600,"Sub-basin 4"
4233,300,12,1700,2000,"Sub-basin 4"
4234,100,3,1000,1100,"Sub-basin 4"
4235,100,2,800,900,"Sub-basin 4"
4236,2700,338,12900,15600,"Sub-basin 4"
4237,1000,118,9600,10600,"Sub-basin 4"
4238,300,11,2600,2900,"Sub-basin 4"
4239,200,21,2000,2200,"Sub-basin 4"
4240,300,17,2800,3100,"Sub-basin 4"
4241,4100,610,15200,19300,"Sub-basin 4"
4242,300,14,1700,2000,"Sub-basin 4"
4243,52100,3000,67900,120000,"Sub-basin 4"
4244,200,3,1700,1900,"Sub-basin 4"
4245,100,2,1500,1600,"Sub-basin 4"
4246,2100,198,5800,7900,"Sub-basin 4"
4247,500,33,4200,4700,"Sub-basin 4"
4248,500,24,2500,3000,"Sub-basin 4"
4249,1600,36,14000,15600,"Sub-basin 4"
4250,100,1,2200,2300,"Sub-basin 4"
4251,100,7,1500,1600,"Sub-basin 4"
4252,200,6,2100,2300,"Sub-basin 4"
4253,400,36,1700,2100,"Sub-basin 4"
4254,200,8,1700,1900,"Sub-basin 4"
4255,200,22,3300,3500,"Sub-basin 4"
4256,2500,480,17800,20300,"Sub-basin 4"
4257,800,121,3400,4200,"Sub-basin 4"
4258,100,1,1100,1200,"Sub-basin 4"
4259,400,5,1700,2100,"Sub-basin 4"
4260,100,1,1900,2000,"Sub-basin 4"
4261,300,24,1700,2000,"Sub-basin 4"
4262,1200,61,12300,13500,"Sub-basin 4"
4263,3100,108,6900,10000,"Sub-basin 4"
4264,2100,93,9700,11800,"Sub-basin 4"
4265,100,4,1200,1300,"Sub-basin 4"
4266,400,37,2000,2400,"Sub-basin 4"
4267,300,12,1800,2100,"Sub-basin 4"
4268,6800,871,43400,50200,"Sub-basin 4"
4269,800,109,3300,4100,"Sub-basin 4"
4270,100,1,1200,1300,"Sub-basin 4"
4271,600,77,2800,3400,"Sub-basin 4"
4272,200,4,2000,2200,"Sub-basin 4"
4273,1300,85,11200,12500,"Sub-basin 4"
4274,400,14.5,4900,5300,"Sub-basin 4"
4275,100,2,1300,1400,"Sub-basin 4"
4276,9200,3502,17700,26900,"Sub-basin 4"
4277,700,71,2600,3300,"Sub-basin 4"
4278,5500,1198,20000,25500,"Sub-basin 4"
4279,300,5,3600,3900,"Sub-basin 4"
4280,100,2,900,1000,"Sub-basin 4"
4281,100,1,1000,1100,"Sub-basin 4"
4282,300,15,1200,1500,"Sub-basin 4"
4283,100,2,2800,2900,"Sub-basin 4"
4284,800,100,1400,2200,"Sub-basin 4"
4285,8600,220,43600,52200,"Sub-basin 4"
4286,100,3,600,700,"Sub-basin 4"
4287,900,42,8600,9500,"Sub-basin 4"
4288,1100,258,6800,7900,"Sub-basin 4"
4289,400,11,2200,2600,"Sub-basin 4"
4290,2300,410,8200,10500,"Sub-basin 4"
4291,900,149,5400,6300,"Sub-basin 4"
4292,100,4,900,1000,"Sub-basin 4"
4293,200,3,2700,2900,"Sub-basin 4"
4294,600,99,1800,2400,"Sub-basin 4"
4295,2800,545,13400,16200,"Sub-basin 4"
4296,1000,56,8000,9000,"Sub-basin 4"
4297,100,2,1100,1200,"Sub-basin 4"
4298,900,84,3800,4700,"Sub-basin 4"
4299,300,34,1600,1900,"Sub-basin 4"
4300,300,18,4400,4700,"Sub-basin 4"
4301,200,10,700,900,"Sub-basin 4"
4302,4000,1131,8300,12300,"Sub-basin 4"
4303,200,2,3300,3500,"Sub-basin 4"
4304,1400,254,5200,6600,"Sub-basin 4"
4305,4600,879,32800,37400,"Sub-basin 4"
4306,100,2,300,400,"Sub-basin 4"
4307,100,2,1600,1700,"Sub-basin 4"
4308,500,51,4000,4500,"Sub-basin 4"
4309,3100,1017,4500,7600,"Sub-basin 4"
4310,400,49,1500,1900,"Sub-basin 4"
4311,100,2,500,600,"Sub-basin 4"
4312,100,1,1800,1900,"Sub-basin 4"
4313,400,30,3200,3600,"Sub-basin 4"
4314,6400,1552,27700,34100,"Sub-basin 4"
4315,2100,691,14500,16600,"Sub-basin 4"
4316,100,2,1400,1500,"Sub-basin 4"
4317,37800,1328,57500,95300,"Sub-basin 4"
4318,100,1,0,100,"Sub-basin 4"
4319,100,1,400,500,"Sub-basin 4"
4320,1000,177,6000,7000,"Sub-basin 4"
4321,500,17,7400,7900,"Sub-basin 4"
4322,4200,2173,12600,16800,"Sub-basin 4"
4323,2200,293,13200,15400,"Sub-basin 4"
4324,2200,412,6000,8200,"Sub-basin 4"
4325,10200,1028,30300,40500,"Sub-basin 4"
4326,100,1,300,400,"Sub-basin 4"
4327,9000,279,18800,27800,"Sub-basin 4"
4328,400,7,3300,3700,"Sub-basin 4"
4329,1300,605,3100,4400,"Sub-basin 4"
4330,1700,521,6500,8200,"Sub-basin 4"
4331,100,2,400,500,"Sub-basin 4"
4332,100,3,1300,1400,"Sub-basin 4"
4333,100,5,3100,3200,"Sub-basin 4"
4334,100,1,1300,1400,"Sub-basin 4"
4335,100,1,1600,1700,"Sub-basin 4"
4336,400,24,2800,3200,"Sub-basin 4"
4337,100,4,1000,1100,"Sub-basin 4"
4338,100,1,2200,2300,"Sub-basin 4"
4339,400,112,3500,3900,"Sub-basin 4"
4340,600,58,3100,3700,"Sub-basin 4"
4341,100,1,200,300,"Sub-basin 4"
4342,500,65,2800,3300,"Sub-basin 4"
4343,700,106,2800,3500,"Sub-basin 4"
4344,100,1,800,900,"Sub-basin 4"
4345,100,2,1000,1100,"Sub-basin 4"
4346,200,4,900,1100,"Sub-basin 4"
4347,400,16,3400,3800,"Sub-basin 4"
4348,93900,12908,125100,219000,"Sub-basin 4"
4349,100,5,300,400,"Sub-basin 4"
4350,100,1,1800,1900,"Sub-basin 4"
4351,300,7,1900,2200,"Sub-basin 4"
4352,3000,884,7400,10400,"Sub-basin 4"
4353,100,2,700,800,"Sub-basin 4"
4354,700,13,6400,7100,"Sub-basin 4"
4355,100,4,1500,1600,"Sub-basin 4"
4356,1500,251,9100,10600,"Sub-basin 4"
4357,400,17,4200,4600,"Sub-basin 4"
4358,100,3,1100,1200,"Sub-basin 4"
4359,5000,1778,7900,12900,"Sub-basin 4"
4360,2100,444,7300,9400,"Sub-basin 4"
4361,2300,481,9200,11500,"Sub-basin 4"
4362,2000,111,5200,7200,"Sub-basin 4"
4363,100,1,1200,1300,"Sub-basin 4"
4364,200,6,2500,2700,"Sub-basin 4"
4365,1700,569,3700,5400,"Sub-basin 4"
4366,1800,415,4100,5900,"Sub-basin 4"
4367,800,97,4700,5500,"Sub-basin 4"
4368,100,1,1200,1300,"Sub-basin 4"
4369,200,3,1500,1700,"Sub-basin 4"
4370,9200,4057,10800,20000,"Sub-basin 4"
4371,3000,905,7100,10100,"Sub-basin 4"
4372,400,22,1700,2100,"Sub-basin 4"
4373,400,10,6200,6600,"Sub-basin 4"
4374,2300,604,16400,18700,"Sub-basin 4"
4375,100,2,1000,1100,"Sub-basin 4"
4376,200,2,1200,1400,"Sub-basin 4"
4377,200,2,2100,2300,"Sub-basin 4"
4378,600,18,2100,2700,"Sub-basin 4"
4379,1200,29,7100,8300,"Sub-basin 4"
4380,1000,28,12800,13800,"Sub-basin 4"
4381,800,211,2700,3500,"Sub-basin 4"
4382,100,1,3000,3100,"Sub-basin 4"
4383,3000,1076,5800,8800,"Sub-basin 4"
4384,200,12,5500,5700,"Sub-basin 4"
4385,100,5,1100,1200,"Sub-basin 4"
4386,1100,282,1900,3000,"Sub-basin 4"
4387,1200,260,2700,3900,"Sub-basin 4"
4388,100,4,300,400,"Sub-basin 4"
4389,6100,2509,13200,19300,"Sub-basin 4"
4390,100,1,800,900,"Sub-basin 4"
4391,500,78,2000,2500,"Sub-basin 4"
4392,100,3,2200,2300,"Sub-basin 4"
4393,4100,410,50400,54500,"Sub-basin 4"
4394,100,2,900,1000,"Sub-basin 4"
4395,200,3,1100,1300,"Sub-basin 4"
4396,200,10,1800,2000,"Sub-basin 4"
4397,200,2,2500,2700,"Sub-basin 4"
4398,100,1,1100,1200,"Sub-basin 4"
4399,100,1,400,500,"Sub-basin 4"
4400,1000,26,4000,5000,"Sub-basin 4"
4401,2900,772,5300,8200,"Sub-basin 4"
4402,200,12,600,800,"Sub-basin 4"
4403,400,16,6200,6600,"Sub-basin 4"
4404,300,12,6100,6400,"Sub-basin 4"
4405,600,30,7900,8500,"Sub-basin 4"
4406,100,5,1000,1100,"Sub-basin 4"
4407,2500,529,9100,11600,"Sub-basin 4"
4408,100,3,2000,2100,"Sub-basin 4"
4409,100,4,1600,1700,"Sub-basin 4"
4410,300,9,1700,2000,"Sub-basin 4"
4411,400,65,1300,1700,"Sub-basin 4"
4412,400,47,1200,1600,"Sub-basin 4"
4413,400,53,1900,2300,"Sub-basin 4"
4414,228100,30562.83,188600,416700,"Sub-basin 4"
4415,100,2,300,400,"Sub-basin 4"
4416,100,1,400,500,"Sub-basin 4"
4417,100,3,1300,1400,"Sub-basin 4"
4418,100,2,2000,2100,"Sub-basin 4"
4419,200,6,2500,2700,"Sub-basin 4"
4420,600,115,2900,3500,"Sub-basin 4"
4421,100,1,800,900,"Sub-basin 4"
4422,100,1,300,400,"Sub-basin 4"
4423,300,23,1500,1800,"Sub-basin 4"
4424,100,2,600,700,"Sub-basin 4"
4425,1400,220,4000,5400,"Sub-basin 4"
4426,200,6,3600,3800,"Sub-basin 4"
4427,100,5,2800,2900,"Sub-basin 4"
4428,500,25,8500,9000,"Sub-basin 4"
4429,100,6,300,400,"Sub-basin 4"
4430,2100,589,3700,5800,"Sub-basin 4"
4431,2200,508,6700,8900,"Sub-basin 4"
4432,600,137,1300,1900,"Sub-basin 4"
4433,600,104,2000,2600,"Sub-basin 4"
4434,100,1,1300,1400,"Sub-basin 4"
4435,700,22,1000,1700,"Sub-basin 4"
4436,700,38,15400,16100,"Sub-basin 4"
4437,100,2,600,700,"Sub-basin 4"
4438,200,2,1600,1800,"Sub-basin 4"
4439,2600,258,29600,32200,"Sub-basin 4"
4440,400,35,7400,7800,"Sub-basin 4"
4441,100,2,1700,1800,"Sub-basin 4"
4442,600,33,1900,2500,"Sub-basin 4"
4443,400,50,2400,2800,"Sub-basin 4"
4444,100,2,500,600,"Sub-basin 4"
4445,9100,368,19400,28500,"Sub-basin 4"
4446,800,150,1000,1800,"Sub-basin 4"
4447,400,49,1600,2000,"Sub-basin 4"
4448,100,1,1600,1700,"Sub-basin 4"
4449,1100,156,5200,6300,"Sub-basin 4"
4450,800,75,5300,6100,"Sub-basin 4"
4451,200,4,2600,2800,"Sub-basin 4"
4452,1100,66,3200,4300,"Sub-basin 4"
4453,900,15,5200,6100,"Sub-basin 4"
4454,2500,422,9100,11600,"Sub-basin 4"
4455,100,1,2100,2200,"Sub-basin 4"
4456,200,4,1300,1500,"Sub-basin 4"
4457,3100,486,10100,13200,"Sub-basin 4"
4458,100,5,2900,3000,"Sub-basin 4"
4459,2800,567,8900,11700,"Sub-basin 4"
4460,33200,9091,57100,90300,"Sub-basin 4"
4461,200,3,4500,4700,"Sub-basin 4"
4462,200,3,3300,3500,"Sub-basin 4"
4463,600,55,3000,3600,"Sub-basin 4"
4464,100,1,2400,2500,"Sub-basin 4"
4465,1000,234,4200,5200,"Sub-basin 4"
4466,100,1,1300,1400,"Sub-basin 4"
4467,700,20,5300,6000,"Sub-basin 4"
4468,700,64,3100,3800,"Sub-basin 4"
4469,100,1,1000,1100,"Sub-basin 4"
4470,100,3,2600,2700,"Sub-basin 4"
4471,100,2,1400,1500,"Sub-basin 4"
4472,100,1,1000,1100,"Sub-basin 4"
4473,3400,487,10300,13700,"Sub-basin 4"
4474,100,1,2400,2500,"Sub-basin 4"
4475,100,1,2100,2200,"Sub-basin 4"
4476,6600,2586,11700,18300,"Sub-basin 4"
4477,100,1,1300,1400,"Sub-basin 4"
4478,300,9,3100,3400,"Sub-basin 4"
4479,100,3,1200,1300,"Sub-basin 4"
4480,100,1,300,400,"Sub-basin 4"
4481,100,3,800,900,"Sub-basin 4"
4482,5800,262,15900,21700,"Sub-basin 4"
4483,300,4,1500,1800,"Sub-basin 4"
4484,100,4,1700,1800,"Sub-basin 4"
4485,4400,596,33900,38300,"Sub-basin 4"
4486,500,33,4000,4500,"Sub-basin 4"
4487,4000,306,15000,19000,"Sub-basin 4"
4488,600,23,3400,4000,"Sub-basin 4"
4489,200,5,1300,1500,"Sub-basin 4"
4490,200,6,1500,1700,"Sub-basin 4"
4491,100,6,2100,2200,"Sub-basin 4"
4492,200,2,2000,2200,"Sub-basin 4"
4493,100,1,400,500,"Sub-basin 4"
4494,400,60,2900,3300,"Sub-basin 4"
4495,100,8,800,900,"Sub-basin 4"
4496,100,2,1500,1600,"Sub-basin 4"
4497,100,2,1800,1900,"Sub-basin 4"
4498,100,1,3200,3300,"Sub-basin 4"
4499,100,1,2100,2200,"Sub-basin 4"
4500,1000,120,6300,7300,"Sub-basin 4"
4501,1300,260,8300,9600,"Sub-basin 4"
4502,100,1,400,500,"Sub-basin 4"
4503,3500,153,11400,14900,"Sub-basin 4"
4504,2100,403,8000,10100,"Sub-basin 4"
4505,200,2,700,900,"Sub-basin 4"
4506,800,83,2400,3200,"Sub-basin 4"
4507,500,23,3000,3500,"Sub-basin 4"
4508,400,52,2200,2600,"Sub-basin 4"
4509,100,8,1500,1600,"Sub-basin 4"
4510,100,1,800,900,"Sub-basin 4"
4511,300,19,4800,5100,"Sub-basin 4"
4512,100,3,2800,2900,"Sub-basin 4"
4513,600,96,2200,2800,"Sub-basin 4"
4514,700,78,2500,3200,"Sub-basin 4"
4515,11600,3174,33800,45400,"Sub-basin 4"
4516,400,43,6500,6900,"Sub-basin 4"
4517,200,8,5200,5400,"Sub-basin 4"
4518,100,1,2300,2400,"Sub-basin 4"
4519,500,9,6100,6600,"Sub-basin 4"
4520,2900,456,12100,15000,"Sub-basin 4"
4521,100,1,800,900,"Sub-basin 4"
4522,600,89,1900,2500,"Sub-basin 4"
4523,83700,6171,69100,152800,"Sub-basin 4"
4524,1100,55,13600,14700,"Sub-basin 4"
4525,2800,393,46500,49300,"Sub-basin 4"
4526,100,1,2000,2100,"Sub-basin 4"
4527,5300,828,25700,31000,"Sub-basin 4"
4528,300,3,1300,1600,"Sub-basin 4"
4529,100,1,600,700,"Sub-basin 4"
4530,400,25,7500,7900,"Sub-basin 4"
4531,2300,159,13400,15700,"Sub-basin 4"
4532,100,1,1100,1200,"Sub-basin 4"
4533,400,11,2000,2400,"Sub-basin 4"
4534,300,11,4700,5000,"Sub-basin 4"
4535,100,1,2300,2400,"Sub-basin 4"
4536,100,1,1400,1500,"Sub-basin 4"
4537,300,6,1700,2000,"Sub-basin 4"
4538,100,1,700,800,"Sub-basin 4"
4539,100,4,500,600,"Sub-basin 4"
4540,100,1,1400,1500,"Sub-basin 4"
4541,100,1,500,600,"Sub-basin 4"
4542,200,2,1800,2000,"Sub-basin 4"
4543,2200,571,5100,7300,"Sub-basin 4"
4544,5100,250,18700,23800,"Sub-basin 4"
4545,700,19,1600,2300,"Sub-basin 4"
4546,1000,21,4400,5400,"Sub-basin 4"
4547,200,5,1500,1700,"Sub-basin 4"
4548,1000,140,4100,5100,"Sub-basin 4"
4549,100,3,1700,1800,"Sub-basin 4"
4550,300,12,7000,7300,"Sub-basin 4"
4551,10000,1883,46000,56000,"Sub-basin 4"
4552,100,2,1200,1300,"Sub-basin 4"
4553,100,1,400,500,"Sub-basin 4"
4554,3500,127,9400,12900,"Sub-basin 4"
4555,100,2,1100,1200,"Sub-basin 4"
4556,400,12,5300,5700,"Sub-basin 4"
4557,100,1,1700,1800,"Sub-basin 4"
4558,300,11,3500,3800,"Sub-basin 4"
4559,1000,130,4400,5400,"Sub-basin 4"
4560,200,9,2300,2500,"Sub-basin 4"
4561,100,5,1500,1600,"Sub-basin 4"
4562,4500,1694,13400,17900,"Sub-basin 4"
4563,2600,349,22100,24700,"Sub-basin 4"
4564,400,20,3100,3500,"Sub-basin 4"
4565,1500,40,5500,7000,"Sub-basin 4"
4566,300,10,2300,2600,"Sub-basin 4"
4567,2600,95,14400,17000,"Sub-basin 4"
4568,4300,840,10200,14500,"Sub-basin 4"
4569,100,2,800,900,"Sub-basin 4"
4570,700,22,4600,5300,"Sub-basin 4"
4571,1400,280,9600,11000,"Sub-basin 4"
4572,2300,215,8600,10900,"Sub-basin 4"
4573,100,3,1300,1400,"Sub-basin 4"
4574,1000,40,2700,3700,"Sub-basin 4"
4575,100,2,900,1000,"Sub-basin 4"
4576,2400,338,11200,13600,"Sub-basin 4"
4577,600,48,7000,7600,"Sub-basin 4"
4578,300,5,1800,2100,"Sub-basin 4"
4579,3800,478,12500,16300,"Sub-basin 4"
4580,900,133,5900,6800,"Sub-basin 4"
4581,500,15,2800,3300,"Sub-basin 4"
4582,3200,839,10500,13700,"Sub-basin 4"
4583,1000,95,8000,9000,"Sub-basin 4"
4584,200,14,2300,2500,"Sub-basin 4"
4585,100,1,1100,1200,"Sub-basin 4"
4586,1400,186,8700,10100,"Sub-basin 4"
4587,100,1,1800,1900,"Sub-basin 4"
4588,100,3,2400,2500,"Sub-basin 4"
4589,100,2,1300,1400,"Sub-basin 4"
4590,400,22,3100,3500,"Sub-basin 4"
4591,700,89,6000,6700,"Sub-basin 4"
4592,1300,381,3800,5100,"Sub-basin 4"
4593,100,4,1300,1400,"Sub-basin 4"
4594,100,3,500,600,"Sub-basin 4"
4595,3100,1147,8400,11500,"Sub-basin 4"
4596,200,7,2700,2900,"Sub-basin 4"
4597,800,68,4500,5300,"Sub-basin 4"
4598,200,4,1100,1300,"Sub-basin 4"
4599,100,7,1300,1400,"Sub-basin 4"
4600,200,2,300,500,"Sub-basin 4"
4601,100,2,1300,1400,"Sub-basin 4"
4602,100,2,1600,1700,"Sub-basin 4"
4603,100,2,1400,1500,"Sub-basin 4"
4604,200,2,400,600,"Sub-basin 4"
4605,100,5,2600,2700,"Sub-basin 4"
4606,1100,193,4700,5800,"Sub-basin 4"
4607,800,153,4900,5700,"Sub-basin 4"
4608,400,9,2700,3100,"Sub-basin 4"
4609,200,3,1300,1500,"Sub-basin 4"
4610,800,16,2700,3500,"Sub-basin 4"
4611,600,33,3900,4500,"Sub-basin 4"
4612,200,10,4100,4300,"Sub-basin 4"
4613,900,144,4200,5100,"Sub-basin 4"
4614,1600,216,14100,15700,"Sub-basin 4"
4615,100,1,700,800,"Sub-basin 4"
4616,1000,63,18100,19100,"Sub-basin 4"
4617,200,4,3600,3800,"Sub-basin 4"
4618,600,183,1900,2500,"Sub-basin 4"
4619,100,1,1600,1700,"Sub-basin 4"
4620,1500,158,23500,25000,"Sub-basin 4"
4621,100,3,1900,2000,"Sub-basin 4"
4622,100,1,1500,1600,"Sub-basin 4"
4623,600,62,4500,5100,"Sub-basin 4"
4624,100,3,600,700,"Sub-basin 4"
4625,400,21,2300,2700,"Sub-basin 4"
4626,3800,262,35400,39200,"Sub-basin 4"
4627,30700,9509,68500,99200,"Sub-basin 4"
4628,900,240,6400,7300,"Sub-basin 4"
4629,1100,110,5700,6800,"Sub-basin 4"
4630,300,8,1500,1800,"Sub-basin 4"
4631,1200,97,5000,6200,"Sub-basin 4"
4632,100,2,2200,2300,"Sub-basin 4"
4633,100,2,2200,2300,"Sub-basin 4"
4634,3000,692,11200,14200,"Sub-basin 4"
4635,3700,560.67,13600,17300,"Sub-basin 4"
4636,2200,302,20300,22500,"Sub-basin 4"
4637,100,1,1200,1300,"Sub-basin 4"
4638,100,2,900,1000,"Sub-basin 4"
4639,300,8,2200,2500,"Sub-basin 4"
4640,1200,208,5200,6400,"Sub-basin 4"
4641,1400,118,8800,10200,"Sub-basin 4"
4642,200,9,2400,2600,"Sub-basin 4"
4643,800,90,2900,3700,"Sub-basin 4"
4644,300,13,900,1200,"Sub-basin 4"
4645,700,28,3200,3900,"Sub-basin 4"
4646,400,9,1300,1700,"Sub-basin 4"
4647,1900,76,8600,10500,"Sub-basin 4"
4648,200,3,3600,3800,"Sub-basin 4"
4649,100,2,400,500,"Sub-basin 4"
4650,100,1,1000,1100,"Sub-basin 4"
4651,100,1,1000,1100,"Sub-basin 4"
4652,1900,91,3800,5700,"Sub-basin 4"
4653,1300,74,8900,10200,"Sub-basin 4"
4654,100,2,3200,3300,"Sub-basin 4"
4655,2700,303,46300,49000,"Sub-basin 4"
4656,5000,172,15900,20900,"Sub-basin 4"
4657,100,1,1300,1400,"Sub-basin 4"
4658,300,9,1000,1300,"Sub-basin 4"
4659,200,15,2300,2500,"Sub-basin 4"
4660,600,153,3600,4200,"Sub-basin 4"
4661,2000,458,5800,7800,"Sub-basin 4"
4662,6300,1770,12000,18300,"Sub-basin 4"
4663,25700,13891.3828,23700,49400,"Sub-basin 4"
4664,700,16.62,3000,3700,"Sub-basin 4"
4665,100,3,1100,1200,"Sub-basin 4"
4666,200,4,800,1000,"Sub-basin 4"
4667,5600,1398.17,12900,18500,"Sub-basin 4"
4668,100,2,700,800,"Sub-basin 4"
4669,3000,373.37,13100,16100,"Sub-basin 4"
4670,500,67,4300,4800,"Sub-basin 4"
4671,1300,153,5800,7100,"Sub-basin 4"
4672,4300,139,10100,14400,"Sub-basin 4"
4673,800,78,3500,4300,"Sub-basin 4"
4674,1800,272,46200,48000,"Sub-basin 4"
4675,300,23,1100,1400,"Sub-basin 4"
4676,300,7,800,1100,"Sub-basin 4"
4677,100,1,400,500,"Sub-basin 4"
4678,1500,333,4000,5500,"Sub-basin 4"
4679,600,76,3100,3700,"Sub-basin 4"
4680,100,7,1700,1800,"Sub-basin 4"
4681,200,6,1700,1900,"Sub-basin 4"
4682,600,403,3300,3900,"Sub-basin 4"
4683,100,1,700,800,"Sub-basin 4"
4684,500,56,3200,3700,"Sub-basin 4"
4685,400,27,4900,5300,"Sub-basin 4"
4686,1700,676,6700,8400,"Sub-basin 4"
4687,300,34,3600,3900,"Sub-basin 4"
4688,1700,171,5600,7300,"Sub-basin 4"
4689,400,18,1900,2300,"Sub-basin 4"
4690,7500,410,71100,78600,"Sub-basin 4"
4691,234100,14227.67,245900,480000,"Sub-basin 4"
4692,300,43,1500,1800,"Sub-basin 4"
4693,15900,2473,16600,32500,"Sub-basin 4"
4694,3900,475,43600,47500,"Sub-basin 4"
4695,100,2,2000,2100,"Sub-basin 4"
4696,1200,179,7200,8400,"Sub-basin 4"
4697,100,1,1800,1900,"Sub-basin 4"
4698,1200,105,13200,14400,"Sub-basin 4"
4699,300,6,2000,2300,"Sub-basin 4"
4700,100,1,2800,2900,"Sub-basin 4"
4701,200,5,3300,3500,"Sub-basin 4"
4702,800,60,3300,4100,"Sub-basin 4"
4703,1600,418,2300,3900,"Sub-basin 4"
4704,200,5,1400,1600,"Sub-basin 4"
4705,2600,569,6200,8800,"Sub-basin 4"
4706,100,1,1100,1200,"Sub-basin 4"
4707,100,3,1900,2000,"Sub-basin 4"
4708,100,4,1100,1200,"Sub-basin 4"
4709,10900,603,24800,35700,"Sub-basin 4"
4710,100,2,2400,2500,"Sub-basin 4"
4711,200,8,2000,2200,"Sub-basin 4"
4712,300,4,3600,3900,"Sub-basin 4"
4713,6800,3231,9400,16200,"Sub-basin 4"
4714,1700,616,4100,5800,"Sub-basin 4"
4715,100,2,900,1000,"Sub-basin 4"
4716,100,1,1100,1200,"Sub-basin 4"
4717,200,2,1200,1400,"Sub-basin 4"
4718,100,1,500,600,"Sub-basin 4"
4719,900,117,3000,3900,"Sub-basin 4"
4720,100,2,200,300,"Sub-basin 4"
4721,400,30,3400,3800,"Sub-basin 4"
4722,800,49,7300,8100,"Sub-basin 4"
4723,100,1,2300,2400,"Sub-basin 4"
4724,800,124,8400,9200,"Sub-basin 4"
4725,3400,824,12300,15700,"Sub-basin 4"
4726,100,1,600,700,"Sub-basin 4"
4727,100,1,500,600,"Sub-basin 4"
4728,400,22,3000,3400,"Sub-basin 4"
4729,2700,196,4600,7300,"Sub-basin 4"
4730,5800,900,51400,57200,"Sub-basin 4"
4731,400,15,3800,4200,"Sub-basin 4"
4732,200,4,2000,2200,"Sub-basin 4"
4733,40000,5027,32900,72900,"Sub-basin 4"
4734,5700,1567,13900,19600,"Sub-basin 4"
4735,100,3,900,1000,"Sub-basin 4"
4736,7000,877,21600,28600,"Sub-basin 4"
4737,200,2,2200,2400,"Sub-basin 4"
4738,200,8,3000,3200,"Sub-basin 4"
4739,200,4,1600,1800,"Sub-basin 4"
4740,5800,1759,10100,15900,"Sub-basin 4"
4741,500,42,4500,5000,"Sub-basin 4"
4742,400,6,1400,1800,"Sub-basin 4"
4743,100,1,900,1000,"Sub-basin 4"
4744,400,25,2100,2500,"Sub-basin 4"
4745,600,64,3300,3900,"Sub-basin 4"
4746,500,20,2400,2900,"Sub-basin 4"
4747,100,3,600,700,"Sub-basin 4"
4748,6500,1106,13200,19700,"Sub-basin 4"
4749,100,1,800,900,"Sub-basin 4"
4750,2800,383,9600,12400,"Sub-basin 4"
4751,800,89,3800,4600,"Sub-basin 4"
4752,600,51,7200,7800,"Sub-basin 4"
4753,600,91,3700,4300,"Sub-basin 4"
4754,200,2,3200,3400,"Sub-basin 4"
4755,200,4,2500,2700,"Sub-basin 4"
4756,100,1,800,900,"Sub-basin 4"
4757,147500,20339.67,156300,303800,"Sub-basin 4"
4758,400,33,1500,1900,"Sub-basin 4"
4759,600,27,9000,9600,"Sub-basin 4"
4760,100,3,1100,1200,"Sub-basin 4"
4761,100,1,900,1000,"Sub-basin 4"
4762,1100,65,6400,7500,"Sub-basin 4"
4763,100,5,1300,1400,"Sub-basin 4"
4764,700,143,2800,3500,"Sub-basin 4"
4765,300,7,3300,3600,"Sub-basin 4"
4766,100,1,1300,1400,"Sub-basin 4"
4767,100,2,1300,1400,"Sub-basin 4"
4768,1400,166,7200,8600,"Sub-basin 4"
4769,400,63,1500,1900,"Sub-basin 4"
4770,500,22,4300,4800,"Sub-basin 4"
4771,100,1,800,900,"Sub-basin 4"
4772,2100,427,6600,8700,"Sub-basin 4"
4773,200,4,4600,4800,"Sub-basin 4"
4774,500,59,4800,5300,"Sub-basin 4"
4775,500,151,1300,1800,"Sub-basin 4"
4776,1100,84,4800,5900,"Sub-basin 4"
4777,200,12,1800,2000,"Sub-basin 4"
4778,200,8,1900,2100,"Sub-basin 4"
4779,600,41,2000,2600,"Sub-basin 4"
4780,13500,1411,73700,87200,"Sub-basin 4"
4781,200,5,2200,2400,"Sub-basin 4"
4782,1600,86,5100,6700,"Sub-basin 4"
4783,200,7,1100,1300,"Sub-basin 4"
4784,500,26,4600,5100,"Sub-basin 4"
4785,600,98,5700,6300,"Sub-basin 4"
4786,500,90,1200,1700,"Sub-basin 4"
4787,100,1,1600,1700,"Sub-basin 4"
4788,300,12,3000,3300,"Sub-basin 4"
4789,100,1,100,200,"Sub-basin 4"
4790,900,52,7900,8800,"Sub-basin 4"
4791,1500,364,2900,4400,"Sub-basin 4"
4792,1900,307,6300,8200,"Sub-basin 4"
4793,100,1,1700,1800,"Sub-basin 4"
4794,700,52,4000,4700,"Sub-basin 4"
4795,100,1,600,700,"Sub-basin 4"
4796,14300,822,40900,55200,"Sub-basin 4"
4797,700,56,4400,5100,"Sub-basin 4"
4798,900,80,7400,8300,"Sub-basin 4"
4799,400,179,6700,7100,"Sub-basin 4"
4800,1200,51,7800,9000,"Sub-basin 4"
4801,1000,121,4600,5600,"Sub-basin 4"
4802,1000,94,6600,7600,"Sub-basin 4"
4803,100,1,300,400,"Sub-basin 4"
4804,100,1,500,600,"Sub-basin 4"
4805,100,2,700,800,"Sub-basin 4"
4806,100,1,1300,1400,"Sub-basin 4"
4807,400,34,3000,3400,"Sub-basin 4"
4808,200,26,4100,4300,"Sub-basin 4"
4809,400,57,3900,4300,"Sub-basin 4"
4810,100,1,1400,1500,"Sub-basin 4"
4811,15800,6951,11400,27200,"Sub-basin 4"
4812,200,10,2300,2500,"Sub-basin 4"
4813,100,1,1100,1200,"Sub-basin 4"
4814,200,15,3500,3700,"Sub-basin 4"
4815,100,1,1600,1700,"Sub-basin 4"
4816,500,50,4900,5400,"Sub-basin 4"
4817,900,56,11300,12200,"Sub-basin 4"
4818,100,1,1500,1600,"Sub-basin 4"
4819,100,2,1200,1300,"Sub-basin 4"
4820,18400,879,57500,75900,"Sub-basin 4"
4821,400,24,2300,2700,"Sub-basin 4"
4822,100,3,3700,3800,"Sub-basin 4"
4823,100,1,1200,1300,"Sub-basin 4"
4824,300,3,4800,5100,"Sub-basin 4"
4825,100,1,1700,1800,"Sub-basin 4"
4826,300,7,1000,1300,"Sub-basin 4"
4827,300,6,1500,1800,"Sub-basin 4"
4828,100,2,900,1000,"Sub-basin 4"
4829,100,3,600,700,"Sub-basin 4"
4830,1000,30,3200,4200,"Sub-basin 4"
4831,200,10,900,1100,"Sub-basin 4"
4832,100,1,600,700,"Sub-basin 4"
4833,600,53,2500,3100,"Sub-basin 4"
4834,300,19,1600,1900,"Sub-basin 4"
4835,1000,188,8400,9400,"Sub-basin 4"
4836,100,1,2900,3000,"Sub-basin 4"
4837,100,2,500,600,"Sub-basin 4"
4838,500,42,2200,2700,"Sub-basin 4"
4839,2500,478,11300,13800,"Sub-basin 4"
4840,4300,175,16700,21000,"Sub-basin 4"
4841,3200,114,5400,8600,"Sub-basin 4"
4842,200,2,1600,1800,"Sub-basin 4"
4843,1600,345,3600,5200,"Sub-basin 4"
4844,3800,975,13600,17400,"Sub-basin 4"
4845,100,22,1200,1300,"Sub-basin 4"
4846,500,62,3700,4200,"Sub-basin 4"
4847,200,4,900,1100,"Sub-basin 4"
4848,100,3,700,800,"Sub-basin 4"
4849,100,9,500,600,"Sub-basin 4"
4850,700,59,4500,5200,"Sub-basin 4"
4851,10700,2956,36000,46700,"Sub-basin 4"
4852,100,1,1700,1800,"Sub-basin 4"
4853,500,6,2400,2900,"Sub-basin 4"
4854,100,1,200,300,"Sub-basin 4"
4855,200,3,1000,1200,"Sub-basin 4"
4856,100,1,900,1000,"Sub-basin 4"
4857,100,4,1200,1300,"Sub-basin 4"
4858,700,36,6700,7400,"Sub-basin 4"
4859,300,18,2200,2500,"Sub-basin 4"
4860,200,11,2100,2300,"Sub-basin 4"
4861,300,10,3200,3500,"Sub-basin 4"
4862,13600,3495,41200,54800,"Sub-basin 4"
4863,600,90,6600,7200,"Sub-basin 4"
4864,100,2,2300,2400,"Sub-basin 4"
4865,1000,89,10500,11500,"Sub-basin 4"
4866,200,6,700,900,"Sub-basin 4"
4867,100,2,500,600,"Sub-basin 4"
4868,1500,94,5200,6700,"Sub-basin 4"
4869,17200,2070,22500,39700,"Sub-basin 4"
4870,100,2,2300,2400,"Sub-basin 4"
4871,200,11,1400,1600,"Sub-basin 4"
4872,400,9,9500,9900,"Sub-basin 4"
4873,700,328,5300,6000,"Sub-basin 4"
4874,500,341.3025,3400,3900,"Sub-basin 4"
4875,500,9,1100,1600,"Sub-basin 4"
4876,100,3,900,1000,"Sub-basin 4"
4877,3700,865,8300,12000,"Sub-basin 4"
4878,900,116,4500,5400,"Sub-basin 4"
4879,200,4,2500,2700,"Sub-basin 4"
4880,100,3,1600,1700,"Sub-basin 4"
4881,3300,376,37700,41000,"Sub-basin 4"
4882,300,20,500,800,"Sub-basin 4"
4883,100,2,2500,2600,"Sub-basin 4"
4884,300,11,4000,4300,"Sub-basin 4"
4885,8500,1104,74100,82600,"Sub-basin 4"
4886,100,5,700,800,"Sub-basin 4"
4887,100,1,1700,1800,"Sub-basin 4"
4888,200,8,3500,3700,"Sub-basin 4"
4889,400,17,3700,4100,"Sub-basin 4"
4890,100,1,1900,2000,"Sub-basin 4"
4891,300,7,5700,6000,"Sub-basin 4"
4892,100,1,1800,1900,"Sub-basin 4"
4893,1000,60,7600,8600,"Sub-basin 4"
4894,400,31,2300,2700,"Sub-basin 4"
4895,200,6,4000,4200,"Sub-basin 4"
4896,600,217,6500,7100,"Sub-basin 4"
4897,200,8,2500,2700,"Sub-basin 4"
4898,500,17,3500,4000,"Sub-basin 4"
4899,1100,28,5100,6200,"Sub-basin 4"
4900,100,2,1900,2000,"Sub-basin 4"
4901,700,64,4100,4800,"Sub-basin 4"
4902,100,1,2300,2400,"Sub-basin 4"
4903,100,5,900,1000,"Sub-basin 4"
4904,100,1,300,400,"Sub-basin 4"
4905,500,8,3300,3800,"Sub-basin 4"
4906,1700,48,4200,5900,"Sub-basin 4"
4907,8000,1153,11300,19300,"Sub-basin 4"
4908,3200,92,9700,12900,"Sub-basin 4"
4909,200,11,3500,3700,"Sub-basin 4"
4910,700,20,8000,8700,"Sub-basin 4"
4911,2700,264,8700,11400,"Sub-basin 4"
4912,1000,78,15700,16700,"Sub-basin 4"
4913,100,2,1200,1300,"Sub-basin 4"
4914,200,4,1300,1500,"Sub-basin 4"
4915,300,21,3900,4200,"Sub-basin 4"
4916,100,6,1700,1800,"Sub-basin 4"
4917,100,2,1200,1300,"Sub-basin 4"
4918,400,19,2300,2700,"Sub-basin 4"
4919,1200,78,6700,7900,"Sub-basin 4"
4920,100,2,800,900,"Sub-basin 4"
4921,6200,315,24300,30500,"Sub-basin 4"
4922,200,2,1400,1600,"Sub-basin 4"
4923,100,2,1800,1900,"Sub-basin 4"
4924,400,13,5500,5900,"Sub-basin 4"
4925,200,6,2300,2500,"Sub-basin 4"
4926,500,17,2400,2900,"Sub-basin 4"
4927,100,1,600,700,"Sub-basin 4"
4928,2900,296,7300,10200,"Sub-basin 4"
4929,2000,194,6200,8200,"Sub-basin 4"
4930,200,12,1200,1400,"Sub-basin 4"
4931,1700,181,3100,4800,"Sub-basin 4"
4932,500,37,2400,2900,"Sub-basin 4"
4933,500,30,3300,3800,"Sub-basin 4"
4934,400,20,1500,1900,"Sub-basin 4"
4935,100,3,1300,1400,"Sub-basin 4"
4936,1300,86,13000,14300,"Sub-basin 4"
4937,100,1,1400,1500,"Sub-basin 4"
4938,100,1,400,500,"Sub-basin 4"
4939,1100,26,5600,6700,"Sub-basin 4"
4940,100,1,100,200,"Sub-basin 4"
4941,100,1.67,500,600,"Sub-basin 4"
4942,100,5,2800,2900,"Sub-basin 4"
4943,45700,6883,78900,124600,"Sub-basin 4"
4944,300,23,3400,3700,"Sub-basin 4"
4945,100,3,1500,1600,"Sub-basin 4"
4946,4000,431,19600,23600,"Sub-basin 4"
4947,100,1,1900,2000,"Sub-basin 4"
4948,100,2,2400,2500,"Sub-basin 4"
4949,200,9,5500,5700,"Sub-basin 4"
4950,800,38,4200,5000,"Sub-basin 4"
4951,13700,695,20400,34100,"Sub-basin 4"
4952,400,8,1300,1700,"Sub-basin 4"
4953,100,3,700,800,"Sub-basin 4"
4954,200,10,2200,2400,"Sub-basin 4"
4955,100,9,1400,1500,"Sub-basin 4"
4956,2900,122,18100,21000,"Sub-basin 4"
4957,200,8,1300,1500,"Sub-basin 4"
4958,600,15,1500,2100,"Sub-basin 4"
4959,1100,21,4000,5100,"Sub-basin 4"
4960,700,106,1800,2500,"Sub-basin 4"
4961,1000,341,2600,3600,"Sub-basin 4"
4962,300,12,5000,5300,"Sub-basin 4"
4963,300,8,2300,2600,"Sub-basin 4"
4964,1900,231,9900,11800,"Sub-basin 4"
4965,100,2,1300,1400,"Sub-basin 4"
4966,200,2,2300,2500,"Sub-basin 4"
4967,100,2,500,600,"Sub-basin 4"
4968,500,42,3700,4200,"Sub-basin 4"
4969,800,105,2300,3100,"Sub-basin 4"
4970,10600,709,28400,39000,"Sub-basin 4"
4971,100,1,800,900,"Sub-basin 4"
4972,29200,3071,29100,58300,"Sub-basin 4"
4973,100,1,800,900,"Sub-basin 4"
4974,100,1,600,700,"Sub-basin 4"
4975,200,14,2100,2300,"Sub-basin 4"
4976,300,10,3400,3700,"Sub-basin 4"
4977,200,2,5200,5400,"Sub-basin 4"
4978,100,3,1600,1700,"Sub-basin 4"
4979,700,18,3400,4100,"Sub-basin 4"
4980,100,2,1300,1400,"Sub-basin 4"
4981,100,1,300,400,"Sub-basin 4"
4982,600,45,6300,6900,"Sub-basin 4"
4983,100,4,2200,2300,"Sub-basin 4"
4984,600,28,5200,5800,"Sub-basin 4"
4985,1500,232,2900,4400,"Sub-basin 4"
4986,100,2,1300,1400,"Sub-basin 4"
4987,200,5,1200,1400,"Sub-basin 4"
4988,200,8,2300,2500,"Sub-basin 4"
4989,100,8,800,900,"Sub-basin 4"
4990,900,63,9900,10800,"Sub-basin 4"
4991,600,58,3200,3800,"Sub-basin 4"
4992,400,31,3100,3500,"Sub-basin 4"
4993,10600,2547,27800,38400,"Sub-basin 4"
4994,300,13,2500,2800,"Sub-basin 4"
4995,8300,1260,34600,42900,"Sub-basin 4"
4996,300,15,1900,2200,"Sub-basin 4"
4997,100,2,800,900,"Sub-basin 4"
4998,700,54,3900,4600,"Sub-basin 4"
4999,300,7,700,1000,"Sub-basin 4"
5000,100,1,1200,1300,"Sub-basin 4"
5001,500,22,3200,3700,"Sub-basin 4"
5002,500,44,4100,4600,"Sub-basin 4"
5003,100,3,700,800,"Sub-basin 4"
5004,200,7,5000,5200,"Sub-basin 4"
5005,100,3,1600,1700,"Sub-basin 4"
5006,5500,2139,9600,15100,"Sub-basin 4"
5007,400,20,1500,1900,"Sub-basin 4"
5008,700,48,9200,9900,"Sub-basin 4"
5009,4600,1476,10000,14600,"Sub-basin 4"
5010,200,6,300,500,"Sub-basin 4"
5011,300,5,3000,3300,"Sub-basin 4"
5012,2800,247,17900,20700,"Sub-basin 4"
5013,100,1,800,900,"Sub-basin 4"
5014,100,1,500,600,"Sub-basin 4"
5015,3000,402,8200,11200,"Sub-basin 4"
5016,5700,472,13100,18800,"Sub-basin 4"
5017,600,51,4100,4700,"Sub-basin 4"
5018,200,8,1400,1600,"Sub-basin 4"
5019,200,3,1700,1900,"Sub-basin 4"
5020,400,25,1300,1700,"Sub-basin 4"
5021,200,3,3700,3900,"Sub-basin 4"
5022,500,54,2800,3300,"Sub-basin 4"
5023,100,1,2600,2700,"Sub-basin 4"
5024,100,1,2600,2700,"Sub-basin 4"
5025,100,4,2600,2700,"Sub-basin 4"
5026,100,3,700,800,"Sub-basin 4"
5027,1200,54,6800,8000,"Sub-basin 4"
5028,900,113,4400,5300,"Sub-basin 4"
5029,200,6,1000,1200,"Sub-basin 4"
5030,100,1,1800,1900,"Sub-basin 4"
5031,600,16,9500,10100,"Sub-basin 4"
5032,100,2,4000,4100,"Sub-basin 4"
5033,100,1,1300,1400,"Sub-basin 4"
5034,100,3,1900,2000,"Sub-basin 4"
5035,700,61,4500,5200,"Sub-basin 4"
5036,1400,121,8700,10100,"Sub-basin 4"
5037,200,5,7400,7600,"Sub-basin 4"
5038,100,5,600,700,"Sub-basin 4"
5039,300,12,4500,4800,"Sub-basin 4"
5040,200,5,3900,4100,"Sub-basin 4"
5041,100,5,1500,1600,"Sub-basin 4"
5042,400,16,5900,6300,"Sub-basin 4"
5043,1000,81,10500,11500,"Sub-basin 4"
5044,600,53,4300,4900,"Sub-basin 4"
5045,100,1,2600,2700,"Sub-basin 4"
5046,100,4,400,500,"Sub-basin 4"
5047,900,123,2800,3700,"Sub-basin 4"
5048,900,46,14400,15300,"Sub-basin 4"
5049,700,15,16400,17100,"Sub-basin 4"
5050,200,3,2800,3000,"Sub-basin 4"
5051,200,2,1800,2000,"Sub-basin 4"
5052,2600,877,4800,7400,"Sub-basin 4"
5053,200,7,500,700,"Sub-basin 4"
5054,200,2,4000,4200,"Sub-basin 4"
5055,3000,343,14700,17700,"Sub-basin 4"
5056,100,1,1100,1200,"Sub-basin 4"
5057,100,5,2800,2900,"Sub-basin 4"
5058,150200,52650,138900,289100,"Sub-basin 4"
5059,100,1,300,400,"Sub-basin 4"
5060,200,9,1600,1800,"Sub-basin 4"
5061,300,27,1300,1600,"Sub-basin 4"
5062,300,7,3600,3900,"Sub-basin 4"
5063,100,3,2100,2200,"Sub-basin 4"
5064,200,6,1900,2100,"Sub-basin 4"
5065,1100,67,7500,8600,"Sub-basin 4"
5066,200,4,6200,6400,"Sub-basin 4"
5067,100,1,2100,2200,"Sub-basin 4"
5068,100,1,2000,2100,"Sub-basin 4"
5069,100,5,3700,3800,"Sub-basin 4"
5070,100,3,2800,2900,"Sub-basin 4"
5071,200,3,4000,4200,"Sub-basin 4"
5072,200,2,1800,2000,"Sub-basin 4"
5073,3800,315,14100,17900,"Sub-basin 4"
5074,100,1,900,1000,"Sub-basin 4"
5075,300,13,1700,2000,"Sub-basin 4"
5076,200,3,1500,1700,"Sub-basin 4"
5077,100,4,2400,2500,"Sub-basin 4"
5078,300,12,6500,6800,"Sub-basin 4"
5079,400,8,2700,3100,"Sub-basin 4"
5080,100,1,500,600,"Sub-basin 4"
5081,400,12,2300,2700,"Sub-basin 4"
5082,2700,214,20100,22800,"Sub-basin 4"
5083,1000,97,9300,10300,"Sub-basin 4"
5084,100,2,1000,1100,"Sub-basin 4"
5085,1200,121,6800,8000,"Sub-basin 4"
5086,100,1,3800,3900,"Sub-basin 4"
5087,300,7,6200,6500,"Sub-basin 4"
5088,200,4,1100,1300,"Sub-basin 4"
5089,100,1,800,900,"Sub-basin 4"
5090,100,1,800,900,"Sub-basin 4"
5091,500,15,4000,4500,"Sub-basin 4"
5092,500,33,1000,1500,"Sub-basin 4"
5093,400,15,9900,10300,"Sub-basin 4"
5094,200,3,2200,2400,"Sub-basin 4"
5095,7800,1285,93900,101700,"Sub-basin 4"
5096,200,6,1900,2100,"Sub-basin 4"
5097,4800,555,15100,19900,"Sub-basin 4"
5098,200,2,100,300,"Sub-basin 4"
5099,100,1,2400,2500,"Sub-basin 4"
5100,3900,510,14000,17900,"Sub-basin 4"
5101,100,4,2100,2200,"Sub-basin 4"
5102,200,4,4300,4500,"Sub-basin 4"
5103,100,1,2400,2500,"Sub-basin 4"
5104,100,1,2100,2200,"Sub-basin 4"
5105,2800,199,58600,61400,"Sub-basin 4"
5106,100,1,1400,1500,"Sub-basin 4"
5107,100,1,700,800,"Sub-basin 4"
5108,36800,6067,69700,106500,"Sub-basin 4"
5109,100,3,1100,1200,"Sub-basin 4"
5110,800,119,2700,3500,"Sub-basin 4"
5111,200,4,800,1000,"Sub-basin 4"
5112,2200,584,11400,13600,"Sub-basin 4"
5113,800,88,6300,7100,"Sub-basin 4"
5114,100,1,400,500,"Sub-basin 4"
5115,600,106,2500,3100,"Sub-basin 4"
5116,500,15,1500,2000,"Sub-basin 4"
5117,2400,148,11300,13700,"Sub-basin 4"
5118,900,138,9100,10000,"Sub-basin 4"
5119,100,1,3300,3400,"Sub-basin 4"
5120,300,78,3400,3700,"Sub-basin 4"
5121,200,4,3300,3500,"Sub-basin 4"
5122,200,2,2100,2300,"Sub-basin 4"
5123,1300,198,8800,10100,"Sub-basin 4"
5124,200,17,1000,1200,"Sub-basin 4"
5125,300,31,1500,1800,"Sub-basin 4"
5126,400,10,12400,12800,"Sub-basin 4"
5127,100,5,3500,3600,"Sub-basin 4"
5128,200,2,4300,4500,"Sub-basin 4"
5129,1800,330,10300,12100,"Sub-basin 4"
5130,200,2,800,1000,"Sub-basin 4"
5131,100,3,1000,1100,"Sub-basin 4"
5132,200,19,1000,1200,"Sub-basin 4"
5133,200,8,1000,1200,"Sub-basin 4"
5134,500,82,2000,2500,"Sub-basin 4"
5135,300,7,2600,2900,"Sub-basin 4"
5136,2200,84,11800,14000,"Sub-basin 4"
5137,200,5,1400,1600,"Sub-basin 4"
5138,100,1,700,800,"Sub-basin 4"
5139,100,1,2200,2300,"Sub-basin 4"
5140,300,9,3800,4100,"Sub-basin 4"
5141,800,21,18100,18900,"Sub-basin 4"
5142,700,78,3000,3700,"Sub-basin 4"
5143,1000,150,2700,3700,"Sub-basin 4"
5144,100,1,2800,2900,"Sub-basin 4"
5145,100,1,1900,2000,"Sub-basin 4"
5146,400,111,5700,6100,"Sub-basin 4"
5147,100,3,300,400,"Sub-basin 4"
5148,600,43,2800,3400,"Sub-basin 4"
5149,33400,14904,25900,59300,"Sub-basin 4"
5150,600,10,3100,3700,"Sub-basin 4"
5151,100,3,700,800,"Sub-basin 4"
5152,400,44,900,1300,"Sub-basin 4"
5153,300,8,5100,5400,"Sub-basin 4"
5154,200,3,3000,3200,"Sub-basin 4"
5155,100,7,1800,1900,"Sub-basin 4"
5156,200,3,1500,1700,"Sub-basin 4"
5157,300,14,1800,2100,"Sub-basin 4"
5158,1500,406,7000,8500,"Sub-basin 4"
5159,5500,1003,15100,20600,"Sub-basin 4"
5160,400,7,1400,1800,"Sub-basin 4"
5161,100,1,2300,2400,"Sub-basin 4"
5162,100,1,2900,3000,"Sub-basin 4"
5163,100,1,500,600,"Sub-basin 4"
5164,600,41,3700,4300,"Sub-basin 4"
5165,8500,1006,20700,29200,"Sub-basin 4"
5166,3200,326,46100,49300,"Sub-basin 4"
5167,800,21,1900,2700,"Sub-basin 4"
5168,200,5,1200,1400,"Sub-basin 4"
5169,1300,164,5700,7000,"Sub-basin 4"
5170,2300,76,10700,13000,"Sub-basin 4"
5171,1000,216,4600,5600,"Sub-basin 4"
5172,400,13,4500,4900,"Sub-basin 4"
5173,500,34,1600,2100,"Sub-basin 4"
5174,5300,2012,9600,14900,"Sub-basin 4"
5175,1000,71,4300,5300,"Sub-basin 4"
5176,200,6,1700,1900,"Sub-basin 4"
5177,100,2,1400,1500,"Sub-basin 4"
5178,600,38,2500,3100,"Sub-basin 4"
5179,100,1,1800,1900,"Sub-basin 4"
5180,100,1,700,800,"Sub-basin 4"
5181,300,7,2600,2900,"Sub-basin 4"
5182,27600,6186.33,35900,63500,"Sub-basin 4"
5183,2100,630,4100,6200,"Sub-basin 4"
5184,100,6,1300,1400,"Sub-basin 4"
5185,700,59,3200,3900,"Sub-basin 4"
5186,3400,413,47300,50700,"Sub-basin 4"
5187,100,1,500,600,"Sub-basin 4"
5188,200,7,900,1100,"Sub-basin 4"
5189,100,1,600,700,"Sub-basin 4"
5190,300,4,2900,3200,"Sub-basin 4"
5191,900,127,2100,3000,"Sub-basin 4"
5192,100,5,2300,2400,"Sub-basin 4"
5193,800,91,9800,10600,"Sub-basin 4"
5194,500,93,4400,4900,"Sub-basin 4"
5195,200,9,9800,10000,"Sub-basin 4"
5196,2500,115,7700,10200,"Sub-basin 4"
5197,8400,399,24300,32700,"Sub-basin 4"
5198,100,5,200,300,"Sub-basin 4"
5199,300,9,1400,1700,"Sub-basin 4"
5200,1900,67,4000,5900,"Sub-basin 4"
5201,100,1,700,800,"Sub-basin 4"
5202,200,4,1300,1500,"Sub-basin 4"
5203,1500,297,6000,7500,"Sub-basin 4"
5204,1000,117.17,4600,5600,"Sub-basin 4"
5205,100,4,2100,2200,"Sub-basin 4"
5206,100,2,1800,1900,"Sub-basin 4"
5207,100,1,1300,1400,"Sub-basin 4"
5208,900,17,7300,8200,"Sub-basin 4"
5209,300,7,900,1200,"Sub-basin 4"
5210,200,5,800,1000,"Sub-basin 4"
5211,400,36,1300,1700,"Sub-basin 4"
5212,500,36,4200,4700,"Sub-basin 4"
5213,1100,174,6900,8000,"Sub-basin 4"
5214,1600,289,4700,6300,"Sub-basin 4"
5215,1500,159,5900,7400,"Sub-basin 4"
5216,300,31,2300,2600,"Sub-basin 4"
5217,600,63,5800,6400,"Sub-basin 4"
5218,100,1,1300,1400,"Sub-basin 4"
5219,400,12,10000,10400,"Sub-basin 4"
5220,300,4,800,1100,"Sub-basin 4"
5221,100,2,800,900,"Sub-basin 4"
5222,400,4,3000,3400,"Sub-basin 4"
5223,100,5,1700,1800,"Sub-basin 4"
5224,2200,109,15300,17500,"Sub-basin 4"
5225,200,4,1600,1800,"Sub-basin 4"
5226,100,4,1100,1200,"Sub-basin 4"
5227,100,5,1300,1400,"Sub-basin 4"
5228,100,2,2000,2100,"Sub-basin 4"
5229,700,71,9600,10300,"Sub-basin 4"
5230,800,20,2500,3300,"Sub-basin 4"
5231,100,1,500,600,"Sub-basin 4"
5232,5400,171,11900,17300,"Sub-basin 4"
5233,100,1,900,1000,"Sub-basin 4"
5234,4700,1827,9200,13900,"Sub-basin 4"
5235,500,10,3400,3900,"Sub-basin 4"
5236,100,2,700,800,"Sub-basin 4"
5237,100,1,1100,1200,"Sub-basin 4"
5238,400,11,3700,4100,"Sub-basin 4"
5239,600,72,6900,7500,"Sub-basin 4"
5240,200,18,1100,1300,"Sub-basin 4"
5241,100,1,600,700,"Sub-basin 4"
5242,700,16,3600,4300,"Sub-basin 4"
5243,11400,1965,17800,29200,"Sub-basin 4"
5244,100,1,800,900,"Sub-basin 4"
5245,100,2,500,600,"Sub-basin 4"
5246,300,12,2100,2400,"Sub-basin 4"
5247,100,3,1800,1900,"Sub-basin 4"
5248,200,5,300,500,"Sub-basin 4"
5249,4200,429,28400,32600,"Sub-basin 4"
5250,100,1,1400,1500,"Sub-basin 4"
5251,100,1,800,900,"Sub-basin 4"
5252,800,81,2500,3300,"Sub-basin 4"
5253,7200,255,28800,36000,"Sub-basin 4"
5254,700,15.5,3300,4000,"Sub-basin 4"
5255,200,3,300,500,"Sub-basin 4"
5256,400,73,5200,5600,"Sub-basin 4"
5257,200,4,1600,1800,"Sub-basin 4"
5258,400,70,4400,4800,"Sub-basin 4"
5259,100,6,2000,2100,"Sub-basin 4"
5260,100,1,1400,1500,"Sub-basin 4"
5261,7900,1671,9900,17800,"Sub-basin 4"
5262,100,1,200,300,"Sub-basin 4"
5263,200,5,1700,1900,"Sub-basin 4"
5264,100,2,1400,1500,"Sub-basin 4"
5265,600,54,3200,3800,"Sub-basin 4"
5266,100,2,1000,1100,"Sub-basin 4"
5267,100,6,1000,1100,"Sub-basin 4"
5268,700,39,3800,4500,"Sub-basin 4"
5269,100,3,1400,1500,"Sub-basin 4"
5270,300,38,3600,3900,"Sub-basin 4"
5271,200,8,2700,2900,"Sub-basin 4"
5272,400,27,4800,5200,"Sub-basin 4"
5273,800,50,12700,13500,"Sub-basin 4"
5274,800,85,3100,3900,"Sub-basin 4"
5275,200,4,1500,1700,"Sub-basin 4"
5276,2400,404,6300,8700,"Sub-basin 4"
5277,9800,699.34,11600,21400,"Sub-basin 4"
5278,400,13,1800,2200,"Sub-basin 4"
5279,100,7,1700,1800,"Sub-basin 4"
5280,200,4,2200,2400,"Sub-basin 4"
5281,500,45,4500,5000,"Sub-basin 4"
5282,100,3,2700,2800,"Sub-basin 4"
5283,300,4,1800,2100,"Sub-basin 4"
5284,100,2,1700,1800,"Sub-basin 4"
5285,600,37,4300,4900,"Sub-basin 4"
5286,5100,526,74300,79400,"Sub-basin 4"
5287,200,6,1600,1800,"Sub-basin 4"
5288,100,2,200,300,"Sub-basin 4"
5289,300,6,2600,2900,"Sub-basin 4"
5290,700,73,900,1600,"Sub-basin 4"
5291,500,24,1400,1900,"Sub-basin 4"
5292,200,3,2500,2700,"Sub-basin 4"
5293,700,49,3300,4000,"Sub-basin 4"
5294,1300,131,9800,11100,"Sub-basin 4"
5295,800,55,4600,5400,"Sub-basin 4"
5296,700,34,2800,3500,"Sub-basin 4"
5297,200,6,1100,1300,"Sub-basin 4"
5298,100,1,2200,2300,"Sub-basin 4"
5299,100,7,400,500,"Sub-basin 4"
5300,12900,1911,18600,31500,"Sub-basin 4"
5301,900,31,3200,4100,"Sub-basin 4"
5302,400,36,3200,3600,"Sub-basin 4"
5303,100,1,1600,1700,"Sub-basin 4"
5304,300,6,2100,2400,"Sub-basin 4"
5305,200,15,1600,1800,"Sub-basin 4"
5306,1700,189,26100,27800,"Sub-basin 4"
5307,100,2,1300,1400,"Sub-basin 4"
5308,400,15,5600,6000,"Sub-basin 4"
5309,4700,369,12400,17100,"Sub-basin 4"
5310,100,2,700,800,"Sub-basin 4"
5311,1500,37,4600,6100,"Sub-basin 4"
5312,100,3,1400,1500,"Sub-basin 4"
5313,600,39,4400,5000,"Sub-basin 4"
5314,100,2,2200,2300,"Sub-basin 4"
5315,100,1,1600,1700,"Sub-basin 4"
5316,2600,790,8400,11000,"Sub-basin 4"
5317,100,6,1400,1500,"Sub-basin 4"
5318,43200,5551.82,135600,178800,"Sub-basin 4"
5319,500,29,4800,5300,"Sub-basin 4"
5320,100,1,1100,1200,"Sub-basin 4"
5321,1200,345,3500,4700,"Sub-basin 4"
5322,100,3,1100,1200,"Sub-basin 4"
5323,900,117,1700,2600,"Sub-basin 4"
5324,3300,1227,6300,9600,"Sub-basin 4"
5325,100,1,1600,1700,"Sub-basin 4"
5326,600,39,3300,3900,"Sub-basin 4"
5327,200,6,3400,3600,"Sub-basin 4"
5328,300,8,7000,7300,"Sub-basin 4"
5329,1800,797,5400,7200,"Sub-basin 4"
5330,100,1,1000,1100,"Sub-basin 4"
5331,100,1,1000,1100,"Sub-basin 4"
5332,100,3,900,1000,"Sub-basin 4"
5333,300,8.66,1900,2200,"Sub-basin 4"
5334,800,43,7000,7800,"Sub-basin 4"
5335,100,1,2100,2200,"Sub-basin 4"
5336,700,74,11700,12400,"Sub-basin 4"
5337,200,9,4200,4400,"Sub-basin 4"
5338,100,4,1200,1300,"Sub-basin 4"
5339,700,47,3700,4400,"Sub-basin 4"
5340,500,37,4500,5000,"Sub-basin 4"
5341,100,1,1600,1700,"Sub-basin 4"
5342,400,15,4200,4600,"Sub-basin 4"
5343,13100,2672,17600,30700,"Sub-basin 4"
5344,200,2,600,800,"Sub-basin 4"
5345,5000,1450,5100,10100,"Sub-basin 4"
5346,300,29,2800,3100,"Sub-basin 4"
5347,700,54,3900,4600,"Sub-basin 4"
5348,100,4,900,1000,"Sub-basin 4"
5349,100,4,1800,1900,"Sub-basin 4"
5350,100,1,1700,1800,"Sub-basin 4"
5351,1100,150,6500,7600,"Sub-basin 4"
5352,2100,224,7100,9200,"Sub-basin 4"
5353,900,33,11500,12400,"Sub-basin 4"
5354,5100,681,23700,28800,"Sub-basin 4"
5355,100,5,2400,2500,"Sub-basin 4"
5356,100,2,200,300,"Sub-basin 4"
5357,1200,56,7300,8500,"Sub-basin 4"
5358,700,79,8700,9400,"Sub-basin 4"
5359,100,1,1100,1200,"Sub-basin 4"
5360,3500,110,13900,17400,"Sub-basin 4"
5361,400,57,1700,2100,"Sub-basin 4"
5362,1400,110,6400,7800,"Sub-basin 4"
5363,100,2,700,800,"Sub-basin 4"
5364,400,34,1200,1600,"Sub-basin 4"
5365,400,20,6600,7000,"Sub-basin 4"
5366,100,1,1200,1300,"Sub-basin 4"
5367,600,9,5300,5900,"Sub-basin 4"
5368,900,69,4800,5700,"Sub-basin 4"
5369,400,13,4000,4400,"Sub-basin 4"
5370,1500,115,19000,20500,"Sub-basin 4"
5371,100,1,1500,1600,"Sub-basin 4"
5372,1500,102,5300,6800,"Sub-basin 4"
5373,200,3,1600,1800,"Sub-basin 4"
5374,200,6,3200,3400,"Sub-basin 4"
5375,100,1,1300,1400,"Sub-basin 4"
5376,100,3,300,400,"Sub-basin 4"
5377,200,13,1900,2100,"Sub-basin 4"
5378,100,1,1500,1600,"Sub-basin 4"
5379,400,12,2200,2600,"Sub-basin 4"
5380,1100,117,11400,12500,"Sub-basin 4"
5381,400,14,3500,3900,"Sub-basin 4"
5382,3000,99,13500,16500,"Sub-basin 4"
5383,100,3,700,800,"Sub-basin 4"
5384,15200,1159,27300,42500,"Sub-basin 4"
5385,400,10,2800,3200,"Sub-basin 4"
5386,1100,222,2900,4000,"Sub-basin 4"
5387,200,2,1700,1900,"Sub-basin 4"
5388,700,124,1100,1800,"Sub-basin 4"
5389,4100,836,6300,10400,"Sub-basin 4"
5390,200,7,4000,4200,"Sub-basin 4"
5391,100,2,1500,1600,"Sub-basin 4"
5392,600,44,4600,5200,"Sub-basin 4"
5393,600,93,5700,6300,"Sub-basin 4"
5394,300,14,2700,3000,"Sub-basin 4"
5395,400,34,3500,3900,"Sub-basin 4"
5396,100,1,2800,2900,"Sub-basin 4"
5397,600,34,10700,11300,"Sub-basin 4"
5398,900,54,4700,5600,"Sub-basin 4"
5399,10100,3238,16400,26500,"Sub-basin 4"
5400,600,76,2100,2700,"Sub-basin 4"
5401,200,2,2900,3100,"Sub-basin 4"
5402,100,5,1600,1700,"Sub-basin 4"
5403,100,3,600,700,"Sub-basin 4"
5404,400,23,5400,5800,"Sub-basin 4"
5405,100,1,2100,2200,"Sub-basin 4"
5406,700,32,9400,10100,"Sub-basin 4"
5407,800,73,11500,12300,"Sub-basin 4"
5408,100,2,1500,1600,"Sub-basin 4"
5409,100,3,1200,1300,"Sub-basin 4"
5410,100,10,1600,1700,"Sub-basin 4"
5411,200,6,1300,1500,"Sub-basin 4"
5412,200,3,2500,2700,"Sub-basin 4"
5413,600,10,6100,6700,"Sub-basin 4"
5414,20100,6441,23900,44000,"Sub-basin 4"
5415,300,20,1900,2200,"Sub-basin 4"
5416,100,1,1400,1500,"Sub-basin 4"
5417,1200,65,4300,5500,"Sub-basin 4"
5418,300,4,2200,2500,"Sub-basin 4"
5419,1700,79,5800,7500,"Sub-basin 4"
5420,200,2,2500,2700,"Sub-basin 4"
5421,300,25,2200,2500,"Sub-basin 4"
5422,1200,191,3900,5100,"Sub-basin 4"
5423,1300,296,13100,14400,"Sub-basin 4"
5424,300,109,3200,3500,"Sub-basin 4"
5425,900,129,5100,6000,"Sub-basin 4"
5426,7800,1999,13000,20800,"Sub-basin 4"
5427,1500,47,3600,5100,"Sub-basin 4"
5428,300,11,2900,3200,"Sub-basin 4"
5429,400,8,2900,3300,"Sub-basin 4"
5430,700,58,1600,2300,"Sub-basin 4"
5431,200,15,3200,3400,"Sub-basin 4"
5432,300,18,1800,2100,"Sub-basin 4"
5433,100,1,2300,2400,"Sub-basin 4"
5434,800,54,8100,8900,"Sub-basin 4"
5435,2400,612,6200,8600,"Sub-basin 4"
5436,1200,145,4300,5500,"Sub-basin 4"
5437,100,2,1300,1400,"Sub-basin 4"
5438,800,16,4900,5700,"Sub-basin 4"
5439,100,1,500,600,"Sub-basin 4"
5440,400,19,4200,4600,"Sub-basin 4"
5441,100,1,1400,1500,"Sub-basin 4"
5442,100,5,1600,1700,"Sub-basin 4"
5443,1000,230,2600,3600,"Sub-basin 4"
5444,400,13,3700,4100,"Sub-basin 4"
5445,700,78,3600,4300,"Sub-basin 4"
5446,200,8,1300,1500,"Sub-basin 4"
5447,100,1,1300,1400,"Sub-basin 4"
5448,100,1,900,1000,"Sub-basin 4"
5449,100,11,1800,1900,"Sub-basin 4"
5450,100,9,1300,1400,"Sub-basin 4"
5451,100,3,1300,1400,"Sub-basin 4"
5452,100,2,1000,1100,"Sub-basin 4"
5453,100,2,1000,1100,"Sub-basin 4"
5454,200,3,2300,2500,"Sub-basin 4"
5455,100,1,400,500,"Sub-basin 4"
5456,500,20,2600,3100,"Sub-basin 4"
5457,100,1,700,800,"Sub-basin 4"
5458,100,1,400,500,"Sub-basin 4"
5459,200,6,1400,1600,"Sub-basin 4"
5460,100,1,1600,1700,"Sub-basin 4"
5461,200,11,2100,2300,"Sub-basin 4"
5462,200,3,3100,3300,"Sub-basin 4"
5463,1400,43,6500,7900,"Sub-basin 4"
5464,100,1,800,900,"Sub-basin 4"
5465,100,2,1700,1800,"Sub-basin 4"
5466,1700,238,9700,11400,"Sub-basin 4"
5467,400,30,2700,3100,"Sub-basin 4"
5468,3600,127,12400,16000,"Sub-basin 4"
5469,400,36,3100,3500,"Sub-basin 4"
5470,600,28,10100,10700,"Sub-basin 4"
5471,800,62,6600,7400,"Sub-basin 4"
5472,100,2,3000,3100,"Sub-basin 4"
5473,1500,259,21100,22600,"Sub-basin 4"
5474,300,9,3600,3900,"Sub-basin 4"
5475,1000,30,2600,3600,"Sub-basin 4"
5476,17400,817,43300,60700,"Sub-basin 4"
5477,11200,356,26000,37200,"Sub-basin 4"
5478,100,1,2000,2100,"Sub-basin 4"
5479,200,3,4000,4200,"Sub-basin 4"
5480,500,60,4900,5400,"Sub-basin 4"
5481,100,3,1300,1400,"Sub-basin 4"
5482,1100,158,5100,6200,"Sub-basin 4"
5483,100,2,700,800,"Sub-basin 4"
5484,100,2,900,1000,"Sub-basin 4"
5485,100,1,700,800,"Sub-basin 4"
5486,800,14,8000,8800,"Sub-basin 4"
5487,800,68,7300,8100,"Sub-basin 4"
5488,100,1,500,600,"Sub-basin 4"
5489,100,2,3000,3100,"Sub-basin 4"
5490,100,6,2900,3000,"Sub-basin 4"
5491,100,2,1800,1900,"Sub-basin 4"
5492,900,36,6900,7800,"Sub-basin 4"
5493,600,105,2100,2700,"Sub-basin 4"
5494,100,1,1000,1100,"Sub-basin 4"
5495,100,1,1300,1400,"Sub-basin 4"
5496,200,5,2500,2700,"Sub-basin 4"
5497,100,7,2300,2400,"Sub-basin 4"
5498,1500,138,16900,18400,"Sub-basin 4"
5499,400,51,4600,5000,"Sub-basin 4"
5500,400,33,7100,7500,"Sub-basin 4"
5501,1200,228,3800,5000,"Sub-basin 4"
5502,100,3,2400,2500,"Sub-basin 4"
5503,400,8,4000,4400,"Sub-basin 4"
5504,300,14,1600,1900,"Sub-basin 4"
5505,100,1,100,200,"Sub-basin 4"
5506,100,3,600,700,"Sub-basin 4"
5507,700,55,4900,5600,"Sub-basin 4"
5508,200,7,4700,4900,"Sub-basin 4"
5509,400,9,5200,5600,"Sub-basin 4"
5510,1000,47,12000,13000,"Sub-basin 4"
5511,200,8,2000,2200,"Sub-basin 4"
5512,200,13,3700,3900,"Sub-basin 4"
5513,100,3,900,1000,"Sub-basin 4"
5514,200,7,1600,1800,"Sub-basin 4"
5515,100,1,1300,1400,"Sub-basin 4"
5516,100,2,1100,1200,"Sub-basin 4"
5517,700,33,12300,13000,"Sub-basin 4"
5518,27900,8205,31200,59100,"Sub-basin 4"
5519,100,3,900,1000,"Sub-basin 4"
5520,100,2,1000,1100,"Sub-basin 4"
5521,100,5,2700,2800,"Sub-basin 4"
5522,100,3,2400,2500,"Sub-basin 4"
5523,100,5,1300,1400,"Sub-basin 4"
5524,1100,65,14900,16000,"Sub-basin 4"
5525,100,2,1300,1400,"Sub-basin 4"
5526,600,11,1900,2500,"Sub-basin 4"
5527,1200,25,8300,9500,"Sub-basin 4"
5528,400,10,3900,4300,"Sub-basin 4"
5529,100,2,2800,2900,"Sub-basin 4"
5530,100,1,3300,3400,"Sub-basin 4"
5531,200,7,2500,2700,"Sub-basin 4"
5532,100,1,1700,1800,"Sub-basin 4"
5533,500,19,5400,5900,"Sub-basin 4"
5534,1200,46,18800,20000,"Sub-basin 4"
5535,100,1,1100,1200,"Sub-basin 4"
5536,700,91,1400,2100,"Sub-basin 4"
5537,600,46,3500,4100,"Sub-basin 4"
5538,100,7,1200,1300,"Sub-basin 4"
5539,100,1,2400,2500,"Sub-basin 4"
5540,1300,119,16400,17700,"Sub-basin 4"
5541,200,7,2900,3100,"Sub-basin 4"
5542,100,7,2300,2400,"Sub-basin 4"
5543,100,1,1600,1700,"Sub-basin 4"
5544,600,60,4900,5500,"Sub-basin 4"
5545,1800,601,5500,7300,"Sub-basin 4"
5546,100,1,1400,1500,"Sub-basin 4"
5547,1500,70,11200,12700,"Sub-basin 4"
5548,1400,26,10300,11700,"Sub-basin 4"
5549,200,4,3700,3900,"Sub-basin 4"
5550,100,2,1900,2000,"Sub-basin 4"
5551,100,4,900,1000,"Sub-basin 4"
5552,400,25,3900,4300,"Sub-basin 4"
5553,300,20,5000,5300,"Sub-basin 4"
5554,100,3,1200,1300,"Sub-basin 4"
5555,1300,85,5400,6700,"Sub-basin 4"
5556,400,13,2000,2400,"Sub-basin 4"
5557,100,2,1000,1100,"Sub-basin 4"
5558,200,4,3000,3200,"Sub-basin 4"
5559,300,25,3000,3300,"Sub-basin 4"
5560,300,5,6100,6400,"Sub-basin 4"
5561,100,1,1500,1600,"Sub-basin 4"
5562,100,2,800,900,"Sub-basin 4"
5563,100,1,1000,1100,"Sub-basin 4"
5564,300,10,3400,3700,"Sub-basin 4"
5565,100,4,2000,2100,"Sub-basin 4"
5566,300,12,5900,6200,"Sub-basin 4"
5567,800,116,2600,3400,"Sub-basin 4"
5568,3700,217,8100,11800,"Sub-basin 4"
5569,1000,75,6100,7100,"Sub-basin 4"
5570,500,11,2200,2700,"Sub-basin 4"
5571,300,13,1700,2000,"Sub-basin 4"
5572,200,15,3800,4000,"Sub-basin 4"
5573,100,7,1600,1700,"Sub-basin 4"
5574,2000,160,16300,18300,"Sub-basin 4"
5575,1100,123,15500,16600,"Sub-basin 4"
5576,800,70,10700,11500,"Sub-basin 4"
5577,700,55,5500,6200,"Sub-basin 4"
5578,100,3,2200,2300,"Sub-basin 4"
5579,800,81,4800,5600,"Sub-basin 4"
5580,400,55,3900,4300,"Sub-basin 4"
5581,600,88,2900,3500,"Sub-basin 4"
5582,200,6,3300,3500,"Sub-basin 4"
5583,100,1,700,800,"Sub-basin 4"
5584,100,2,1100,1200,"Sub-basin 4"
5585,500,54,3300,3800,"Sub-basin 4"
5586,600,31,3500,4100,"Sub-basin 4"
5587,6000,593,46100,52100,"Sub-basin 4"
5588,200,9,2400,2600,"Sub-basin 4"
5589,400,17,6900,7300,"Sub-basin 4"
5590,4700,1141,16400,21100,"Sub-basin 4"
5591,500,9,4100,4600,"Sub-basin 4"
5592,100,3,1100,1200,"Sub-basin 4"
5593,1300,88,5200,6500,"Sub-basin 4"
5594,100,2,500,600,"Sub-basin 4"
5595,5300,599,10800,16100,"Sub-basin 4"
5596,100,2,2100,2200,"Sub-basin 4"
5597,100,1,600,700,"Sub-basin 4"
5598,200,8,2900,3100,"Sub-basin 4"
5599,100,1,500,600,"Sub-basin 4"
5600,100,3,1200,1300,"Sub-basin 4"
5601,200,3,1300,1500,"Sub-basin 4"
5602,200,3,2700,2900,"Sub-basin 4"
5603,1800,300,10400,12200,"Sub-basin 4"
5604,600,111,5100,5700,"Sub-basin 4"
5605,300,30,2000,2300,"Sub-basin 4"
5606,300,8,4200,4500,"Sub-basin 4"
5607,400,40,1400,1800,"Sub-basin 4"
5608,100,1,1100,1200,"Sub-basin 4"
5609,100,1,1200,1300,"Sub-basin 4"
5610,1400,24,9300,10700,"Sub-basin 4"
5611,600,42,3300,3900,"Sub-basin 4"
5612,1400,343.83,2500,3900,"Sub-basin 4"
5613,100,2,1600,1700,"Sub-basin 4"
5614,300,8,4000,4300,"Sub-basin 4"
5615,400,19,2500,2900,"Sub-basin 4"
5616,100,2,900,1000,"Sub-basin 4"
5617,500,47,4400,4900,"Sub-basin 4"
5618,3500,644,11700,15200,"Sub-basin 4"
5619,100,8,1800,1900,"Sub-basin 4"
5620,39600,5981,135600,175200,"Sub-basin 4"
5621,4000,1042,13000,17000,"Sub-basin 4"
5622,300,6,4400,4700,"Sub-basin 4"
5623,100,1,1400,1500,"Sub-basin 4"
5624,10400,2810,19600,30000,"Sub-basin 4"
5625,100,2,1000,1100,"Sub-basin 4"
5626,100,1,1300,1400,"Sub-basin 4"
5627,200,5,3000,3200,"Sub-basin 4"
5628,800,146,3600,4400,"Sub-basin 4"
5629,300,12,2600,2900,"Sub-basin 4"
5630,100,2,800,900,"Sub-basin 4"
5631,300,10,3000,3300,"Sub-basin 4"
5632,200,2,2400,2600,"Sub-basin 4"
5633,400,17,2200,2600,"Sub-basin 4"
5634,100,1,1800,1900,"Sub-basin 4"
5635,400,13,8300,8700,"Sub-basin 4"
5636,100,1,1700,1800,"Sub-basin 4"
5637,200,5,2300,2500,"Sub-basin 4"
5638,200,12,2900,3100,"Sub-basin 4"
5639,800,58,5400,6200,"Sub-basin 4"
5640,300,10,1100,1400,"Sub-basin 4"
5641,500,64,4400,4900,"Sub-basin 4"
5642,100,2,2200,2300,"Sub-basin 4"
5643,300,25,4300,4600,"Sub-basin 4"
5644,100,1,1300,1400,"Sub-basin 4"
5645,300,6,1900,2200,"Sub-basin 4"
5646,200,18,4500,4700,"Sub-basin 4"
5647,2400,312,26800,29200,"Sub-basin 4"
5648,300,18,2100,2400,"Sub-basin 4"
5649,7200,3124,11300,18500,"Sub-basin 4"
5650,7100,942.67,25100,32200,"Sub-basin 4"
5651,900,166,4600,5500,"Sub-basin 4"
5652,300,6,4000,4300,"Sub-basin 4"
5653,2100,54,13600,15700,"Sub-basin 4"
5654,400,40,4300,4700,"Sub-basin 4"
5655,300,21,4100,4400,"Sub-basin 4"
5656,800,30,11500,12300,"Sub-basin 4"
5657,3100,208,11900,15000,"Sub-basin 4"
5658,100,3,1700,1800,"Sub-basin 4"
5659,600,22,7600,8200,"Sub-basin 4"
5660,500,10,4700,5200,"Sub-basin 4"
5661,100,2,900,1000,"Sub-basin 4"
5662,100,1,800,900,"Sub-basin 4"
5663,200,3,2200,2400,"Sub-basin 4"
5664,700,88,4500,5200,"Sub-basin 4"
5665,100,1,1300,1400,"Sub-basin 4"
5666,200,4,2200,2400,"Sub-basin 4"
5667,100,2,900,1000,"Sub-basin 4"
5668,100,4,1500,1600,"Sub-basin 4"
5669,100,4,1500,1600,"Sub-basin 4"
5670,300,4,1900,2200,"Sub-basin 4"
5671,100,3,1700,1800,"Sub-basin 4"
5672,24300,4563,120500,144800,"Sub-basin 4"
5673,100,4,1000,1100,"Sub-basin 4"
5674,100,1,1200,1300,"Sub-basin 4"
5675,200,3,1500,1700,"Sub-basin 4"
5676,600,34,6700,7300,"Sub-basin 4"
5677,100,4,700,800,"Sub-basin 4"
5678,700,23,4300,5000,"Sub-basin 4"
5679,400,33,5300,5700,"Sub-basin 4"
5680,600,31,4200,4800,"Sub-basin 4"
5681,500,27,3500,4000,"Sub-basin 4"
5682,800,127,6300,7100,"Sub-basin 4"
5683,100,2,2500,2600,"Sub-basin 4"
5684,1600,167,18000,19600,"Sub-basin 4"
5685,3700,314,9500,13200,"Sub-basin 4"
5686,900,22,6400,7300,"Sub-basin 4"
5687,3500,691,17800,21300,"Sub-basin 4"
5688,200,2,1800,2000,"Sub-basin 4"
5689,100,2,1200,1300,"Sub-basin 4"
5690,400,65.17,5100,5500,"Sub-basin 4"
5691,600,66,4700,5300,"Sub-basin 4"
5692,100,7,1200,1300,"Sub-basin 4"
5693,100,2,1400,1500,"Sub-basin 4"
5694,100,1,1600,1700,"Sub-basin 4"
5695,13300,1850,46800,60100,"Sub-basin 4"
5696,100,3,1600,1700,"Sub-basin 4"
5697,21700,7124,31700,53400,"Sub-basin 4"
5698,1500,106,8200,9700,"Sub-basin 4"
5699,100,1,1400,1500,"Sub-basin 4"
5700,200,3,3300,3500,"Sub-basin 4"
5701,4000,170,11300,15300,"Sub-basin 4"
5702,100,2,900,1000,"Sub-basin 4"
5703,100,2,700,800,"Sub-basin 4"
5704,300,19,1800,2100,"Sub-basin 4"
5705,1400,125,2900,4300,"Sub-basin 4"
5706,2300,135,17000,19300,"Sub-basin 4"
5707,1800,155,6300,8100,"Sub-basin 4"
5708,100,1,700,800,"Sub-basin 4"
5709,100,1,1200,1300,"Sub-basin 4"
5710,600,82,4800,5400,"Sub-basin 4"
5711,100,2,1300,1400,"Sub-basin 4"
5712,1500,140,6000,7500,"Sub-basin 4"
5713,7000,684,12400,19400,"Sub-basin 4"
5714,100,3,900,1000,"Sub-basin 4"
5715,200,12,2200,2400,"Sub-basin 4"
5716,400,76,3600,4000,"Sub-basin 4"
5717,1900,48,14700,16600,"Sub-basin 4"
5718,200,19,2400,2600,"Sub-basin 4"
5719,12200,721,29800,42000,"Sub-basin 4"
5720,1700,489,5700,7400,"Sub-basin 4"
5721,200,12,3200,3400,"Sub-basin 4"
5722,100,1,1300,1400,"Sub-basin 4"
5723,100,2,1000,1100,"Sub-basin 4"
5724,4100,330,11900,16000,"Sub-basin 4"
5725,100,2,600,700,"Sub-basin 4"
5726,100,5,500,600,"Sub-basin 4"
5727,100,6,1600,1700,"Sub-basin 4"
5728,3200,70,13600,16800,"Sub-basin 4"
5729,2900,447,18800,21700,"Sub-basin 4"
5730,200,12,3100,3300,"Sub-basin 4"
5731,100,1,1400,1500,"Sub-basin 4"
5732,500,9,1200,1700,"Sub-basin 4"
5733,100,1,1000,1100,"Sub-basin 4"
5734,1400,104,4100,5500,"Sub-basin 4"
5735,100,2,300,400,"Sub-basin 4"
5736,1300,292,6000,7300,"Sub-basin 4"
5737,500,18,3200,3700,"Sub-basin 4"
5738,100,1,1800,1900,"Sub-basin 4"
5739,300,10,2500,2800,"Sub-basin 4"
5740,100,2,1900,2000,"Sub-basin 4"
5741,400,12,2200,2600,"Sub-basin 4"
5742,200,3,3600,3800,"Sub-basin 4"
5743,100,2,2300,2400,"Sub-basin 4"
5744,100,2,1300,1400,"Sub-basin 4"
5745,100,1,1200,1300,"Sub-basin 4"
5746,400,7,4100,4500,"Sub-basin 4"
5747,26600,969,62000,88600,"Sub-basin 4"
5748,200,8,4100,4300,"Sub-basin 4"
5749,400,43,3800,4200,"Sub-basin 4"
5750,200,9,1600,1800,"Sub-basin 4"
5751,100,1,300,400,"Sub-basin 4"
5752,900,61,5600,6500,"Sub-basin 4"
5753,300,13,1500,1800,"Sub-basin 4"
5754,100,2,1400,1500,"Sub-basin 4"
5755,300,8,2900,3200,"Sub-basin 4"
5756,600,19,4800,5400,"Sub-basin 4"
5757,1700,46,5900,7600,"Sub-basin 4"
5758,1400,343,6600,8000,"Sub-basin 4"
5759,100,4,2000,2100,"Sub-basin 4"
5760,100,1,600,700,"Sub-basin 4"
5761,400,29,4900,5300,"Sub-basin 4"
5762,1100,53,11500,12600,"Sub-basin 4"
5763,100,4,400,500,"Sub-basin 4"
5764,100,2,400,500,"Sub-basin 4"
5765,400,6,2900,3300,"Sub-basin 4"
5766,100,1,1500,1600,"Sub-basin 4"
5767,100,1,1100,1200,"Sub-basin 4"
5768,500,20,3600,4100,"Sub-basin 4"
5769,100,1,1000,1100,"Sub-basin 4"
5770,600,40,3200,3800,"Sub-basin 4"
5771,1700,173,15600,17300,"Sub-basin 4"
5772,100,3,400,500,"Sub-basin 4"
5773,1100,157,15700,16800,"Sub-basin 4"
5774,700,76,2100,2800,"Sub-basin 4"
5775,15400,2959.67,63900,79300,"Sub-basin 4"
5776,7400,842.66,61000,68400,"Sub-basin 4"
5777,100,1,400,500,"Sub-basin 4"
5778,100,1,600,700,"Sub-basin 4"
5779,100,1,1700,1800,"Sub-basin 4"
5780,2900,66,17500,20400,"Sub-basin 4"
5781,100,1,2000,2100,"Sub-basin 4"
5782,400,16,3200,3600,"Sub-basin 4"
5783,200,2,2600,2800,"Sub-basin 4"
5784,100,4,1500,1600,"Sub-basin 4"
5785,100,3,800,900,"Sub-basin 4"
5786,300,8,900,1200,"Sub-basin 4"
5787,1100,42,7700,8800,"Sub-basin 4"
5788,200,9,2100,2300,"Sub-basin 4"
5789,1800,134,20700,22500,"Sub-basin 4"
5790,3100,360,22900,26000,"Sub-basin 4"
5791,4100,201,13700,17800,"Sub-basin 4"
5792,100,2,1100,1200,"Sub-basin 4"
5793,9800,693,41100,50900,"Sub-basin 4"
5794,300,17,2200,2500,"Sub-basin 4"
5795,500,32,4100,4600,"Sub-basin 4"
5796,1700,189,6200,7900,"Sub-basin 4"
5797,300,7,2100,2400,"Sub-basin 4"
5798,700,104,2800,3500,"Sub-basin 4"
5799,1400,580,2100,3500,"Sub-basin 4"
5800,700,40,3900,4600,"Sub-basin 4"
5801,800,152,7600,8400,"Sub-basin 4"
5802,100,1,1600,1700,"Sub-basin 4"
5803,200,5,2100,2300,"Sub-basin 4"
5804,100,1,2100,2200,"Sub-basin 4"
5805,100,4,1600,1700,"Sub-basin 4"
5806,1300,222,1900,3200,"Sub-basin 4"
5807,1400,99,4500,5900,"Sub-basin 4"
5808,100,5,1300,1400,"Sub-basin 4"
5809,800,81,1900,2700,"Sub-basin 4"
5810,100,12,0,100,"Sub-basin 4"
5811,800,464,3800,4600,"Sub-basin 4"
5812,400,112,2600,3000,"Sub-basin 4"
5813,100,1,1300,1400,"Sub-basin 4"
5814,100,2,1300,1400,"Sub-basin 4"
5815,100,1,1200,1300,"Sub-basin 4"
5816,200,22,3400,3600,"Sub-basin 4"
5817,185500,18045.81,324500,510000,"Sub-basin 4"
5818,100,2,500,600,"Sub-basin 4"
5819,100,3,300,400,"Sub-basin 4"
5820,400,26,5200,5600,"Sub-basin 4"
5821,1800,256,7900,9700,"Sub-basin 4"
5822,300,5,1500,1800,"Sub-basin 4"
5823,100,4,1000,1100,"Sub-basin 4"
5824,1400,93,6000,7400,"Sub-basin 4"
5825,200,4,1500,1700,"Sub-basin 4"
5826,1100,18,9000,10100,"Sub-basin 4"
5827,6100,782,33600,39700,"Sub-basin 4"
5828,900,34,6000,6900,"Sub-basin 4"
5829,1300,192,5000,6300,"Sub-basin 4"
5830,100,2,2000,2100,"Sub-basin 4"
5831,3200,153,9000,12200,"Sub-basin 4"
5832,100,1,1400,1500,"Sub-basin 4"
5833,100,3,600,700,"Sub-basin 4"
5834,1300,141,5900,7200,"Sub-basin 4"
5835,3200,145,7700,10900,"Sub-basin 4"
5836,3000,954,5300,8300,"Sub-basin 4"
5837,200,8,2400,2600,"Sub-basin 4"
5838,300,20,4800,5100,"Sub-basin 4"
5839,100,2,900,1000,"Sub-basin 4"
5840,3200,107,10800,14000,"Sub-basin 4"
5841,100,1,600,700,"Sub-basin 4"
5842,400,28,1500,1900,"Sub-basin 4"
5843,900,47,7700,8600,"Sub-basin 4"
5844,300,13,1700,2000,"Sub-basin 4"
5845,1500,124,7100,8600,"Sub-basin 4"
5846,200,3,2300,2500,"Sub-basin 4"
5847,1800,117,7900,9700,"Sub-basin 4"
5848,600,33,3300,3900,"Sub-basin 4"
5849,100,2,600,700,"Sub-basin 4"
5850,2300,246,9000,11300,"Sub-basin 4"
5851,200,8,600,800,"Sub-basin 4"
5852,200,10,1100,1300,"Sub-basin 4"
5853,100,3,400,500,"Sub-basin 4"
5854,100,1,500,600,"Sub-basin 4"
5855,200,10,2100,2300,"Sub-basin 4"
5856,200,11,3100,3300,"Sub-basin 4"
5857,100,1,2500,2600,"Sub-basin 4"
5858,3700,992,7300,11000,"Sub-basin 4"
5859,200,2,2200,2400,"Sub-basin 4"
5860,400,11,5300,5700,"Sub-basin 4"
5861,1800,422,14200,16000,"Sub-basin 4"
5862,5100,906,24000,29100,"Sub-basin 4"
5863,5300,714,32300,37600,"Sub-basin 4"
5864,177500,39977,176400,353900,"Sub-basin 4"
5865,5500,186,21600,27100,"Sub-basin 4"
5866,300,6,1000,1300,"Sub-basin 4"
5867,1000,115,3900,4900,"Sub-basin 4"
5868,1300,119,7100,8400,"Sub-basin 4"
5869,100,2,1300,1400,"Sub-basin 4"
5870,100,2,600,700,"Sub-basin 4"
5871,2500,409,8900,11400,"Sub-basin 4"
5872,100,1,200,300,"Sub-basin 4"
5873,200,3,2200,2400,"Sub-basin 4"
5874,400,9,7200,7600,"Sub-basin 4"
5875,1800,121,10100,11900,"Sub-basin 4"
5876,2500,163,5600,8100,"Sub-basin 4"
5877,100,2,800,900,"Sub-basin 4"
5878,200,2,2000,2200,"Sub-basin 4"
5879,100,1,200,300,"Sub-basin 4"
5880,400,39,4700,5100,"Sub-basin 4"
5881,7200,1557,40900,48100,"Sub-basin 4"
5882,200,8,3900,4100,"Sub-basin 4"
5883,800,126,5200,6000,"Sub-basin 4"
5884,1000,73,6100,7100,"Sub-basin 4"
5885,700,51,13800,14500,"Sub-basin 4"
5886,100,3,1100,1200,"Sub-basin 4"
5887,1700,96,4500,6200,"Sub-basin 4"
5888,100,1,1100,1200,"Sub-basin 4"
5889,1600,40,8400,10000,"Sub-basin 4"
5890,200,8,1700,1900,"Sub-basin 4"
5891,100,8,500,600,"Sub-basin 4"
5892,100,1,1100,1200,"Sub-basin 4"
5893,200,10,4000,4200,"Sub-basin 4"
5894,100,4,3400,3500,"Sub-basin 4"
5895,300,14,2000,2300,"Sub-basin 4"
5896,100,2,900,1000,"Sub-basin 4"
5897,100,2,1100,1200,"Sub-basin 4"
5898,600,43,10800,11400,"Sub-basin 4"
5899,100,2,500,600,"Sub-basin 4"
5900,200,3,1700,1900,"Sub-basin 4"
5901,600,26,4200,4800,"Sub-basin 4"
5902,100,3,500,600,"Sub-basin 4"
5903,200,6,1700,1900,"Sub-basin 4"
5904,200,2,2300,2500,"Sub-basin 4"
5905,100,1,300,400,"Sub-basin 4"
5906,100,3,500,600,"Sub-basin 4"
5907,100,1,1200,1300,"Sub-basin 4"
5908,4100,852,2900,7000,"Sub-basin 4"
5909,200,3,2200,2400,"Sub-basin 4"
5910,200,4,300,500,"Sub-basin 4"
5911,200,10,2600,2800,"Sub-basin 4"
5912,600,42,6900,7500,"Sub-basin 4"
5913,600,44,5500,6100,"Sub-basin 4"
5914,100,2,700,800,"Sub-basin 4"
5915,700,19,3200,3900,"Sub-basin 4"
5916,200,2,900,1100,"Sub-basin 4"
5917,500,20,2300,2800,"Sub-basin 4"
5918,100,1,4000,4100,"Sub-basin 4"
5919,11400,4382.5,17300,28700,"Sub-basin 4"
5920,100,3,500,600,"Sub-basin 4"
5921,100,4,900,1000,"Sub-basin 4"
5922,100,3,1000,1100,"Sub-basin 4"
5923,3100,614,10600,13700,"Sub-basin 4"
5924,2000,211,7900,9900,"Sub-basin 4"
5925,1100,204,3100,4200,"Sub-basin 4"
5926,200,5,1600,1800,"Sub-basin 4"
5927,5100,1562,19200,24300,"Sub-basin 4"
5928,100,10,600,700,"Sub-basin 4"
5929,100,5,1300,1400,"Sub-basin 4"
5930,400,17,3700,4100,"Sub-basin 4"
5931,200,7,2500,2700,"Sub-basin 4"
5932,100,4,1600,1700,"Sub-basin 4"
5933,1400,216,3000,4400,"Sub-basin 4"
5934,100,2,700,800,"Sub-basin 4"
5935,500,7,4000,4500,"Sub-basin 4"
5936,100,2,800,900,"Sub-basin 4"
5937,1800,450,9600,11400,"Sub-basin 4"
5938,1200,177,7200,8400,"Sub-basin 4"
5939,200,6,2900,3100,"Sub-basin 4"
5940,200,5,3400,3600,"Sub-basin 4"
5941,200,5,900,1100,"Sub-basin 4"
5942,100,1,1300,1400,"Sub-basin 4"
5943,51000,3052.34,83800,134800,"Sub-basin 4"
5944,100,3,900,1000,"Sub-basin 4"
5945,400,16,2800,3200,"Sub-basin 4"
5946,400,37,7600,8000,"Sub-basin 4"
5947,400,49,2700,3100,"Sub-basin 4"
5948,100,1,1600,1700,"Sub-basin 4"
5949,300,4,4200,4500,"Sub-basin 4"
5950,300,14,1400,1700,"Sub-basin 4"
5951,1700,409,4900,6600,"Sub-basin 4"
5952,1500,27,6100,7600,"Sub-basin 4"
5953,1400,25,3300,4700,"Sub-basin 4"
5954,300,20,5200,5500,"Sub-basin 4"
5955,400,56,2700,3100,"Sub-basin 4"
5956,700,99,4000,4700,"Sub-basin 4"
5957,100,1,1700,1800,"Sub-basin 4"
5958,400,22,1400,1800,"Sub-basin 4"
5959,1100,310,7000,8100,"Sub-basin 4"
5960,100,3,2200,2300,"Sub-basin 4"
5961,100,3,200,300,"Sub-basin 4"
5962,300,13,3100,3400,"Sub-basin 4"
5963,100,5,800,900,"Sub-basin 4"
5964,100,1,900,1000,"Sub-basin 4"
5965,200,3,3700,3900,"Sub-basin 4"
5966,100,2,1100,1200,"Sub-basin 4"
5967,300,5,2400,2700,"Sub-basin 4"
5968,1100,114,6200,7300,"Sub-basin 4"
5969,300,23,3600,3900,"Sub-basin 4"
5970,100,4,1000,1100,"Sub-basin 4"
5971,5700,1479,15600,21300,"Sub-basin 4"
5972,500,37,4100,4600,"Sub-basin 4"
5973,1100,149,5100,6200,"Sub-basin 4"
5974,34700,19763,37300,72000,"Sub-basin 4"
5975,54700,15471.34,59000,113700,"Sub-basin 4"
5976,1100,89,7100,8200,"Sub-basin 4"
5977,200,7,3500,3700,"Sub-basin 4"
5978,1200,259,5000,6200,"Sub-basin 4"
5979,200,18,600,800,"Sub-basin 4"
5980,1800,438,8500,10300,"Sub-basin 4"
5981,800,85,6200,7000,"Sub-basin 4"
5982,300,28,2300,2600,"Sub-basin 4"
5983,300,50,3800,4100,"Sub-basin 4"
5984,100,4,2000,2100,"Sub-basin 4"
5985,700,90,4500,5200,"Sub-basin 4"
5986,400,60,2800,3200,"Sub-basin 4"
5987,700,78,6200,6900,"Sub-basin 4"
5988,200,2,2100,2300,"Sub-basin 4"
5989,100,2,1500,1600,"Sub-basin 4"
5990,1000,173,5300,6300,"Sub-basin 4"
5991,25600,5316,86900,112500,"Sub-basin 4"
5992,1800,436,8100,9900,"Sub-basin 4"
5993,1600,475,6000,7600,"Sub-basin 4"
5994,1400,154,4500,5900,"Sub-basin 4"
5995,400,16,2800,3200,"Sub-basin 4"
5996,200,23,2300,2500,"Sub-basin 4"
5997,500,39,3300,3800,"Sub-basin 4"
5998,100,2,400,500,"Sub-basin 4"
5999,900,128,2800,3700,"Sub-basin 4"
6000,700,34,2500,3200,"Sub-basin 4"
6001,18200,4128,76600,94800,"Sub-basin 4"
6002,200,7,800,1000,"Sub-basin 4"
6003,100,3,400,500,"Sub-basin 4"
6004,3000,430,5900,8900,"Sub-basin 4"
6005,100,7,1300,1400,"Sub-basin 4"
6006,2800,227,14300,17100,"Sub-basin 4"
6007,100,2,600,700,"Sub-basin 4"
6008,1500,72,12300,13800,"Sub-basin 4"
6009,100,2,0,100,"Sub-basin 4"
6010,200,6,1500,1700,"Sub-basin 4"
6011,800,129,4000,4800,"Sub-basin 4"
6012,300,13,3200,3500,"Sub-basin 4"
6013,400,18,3200,3600,"Sub-basin 4"
6014,100,4,700,800,"Sub-basin 4"
6015,500,62,500,1000,"Sub-basin 4"
6016,400,15,5200,5600,"Sub-basin 4"
6017,600,39.67,900,1500,"Sub-basin 4"
6018,1000,68,4300,5300,"Sub-basin 4"
6019,200,13,2000,2200,"Sub-basin 4"
6020,100,1,700,800,"Sub-basin 4"
6021,1000,116,9000,10000,"Sub-basin 4"
6022,200,7,1400,1600,"Sub-basin 4"
6023,1700,335,6200,7900,"Sub-basin 4"
6024,500,47,3500,4000,"Sub-basin 4"
6025,400,23,3000,3400,"Sub-basin 4"
6026,14300,2494,20000,34300,"Sub-basin 4"
6027,100,2,700,800,"Sub-basin 4"
6028,100,3,900,1000,"Sub-basin 4"
6029,200,4,1600,1800,"Sub-basin 4"
6030,200,5,700,900,"Sub-basin 4"
6031,3000,614,10700,13700,"Sub-basin 4"
6032,500,73,4400,4900,"Sub-basin 4"
6033,1800,271,6300,8100,"Sub-basin 4"
6034,200,4,2100,2300,"Sub-basin 4"
6035,200,3,400,600,"Sub-basin 4"
6036,1200,92,7800,9000,"Sub-basin 4"
6037,900,76,5900,6800,"Sub-basin 4"
6038,600,58,4000,4600,"Sub-basin 4"
6039,46700,28102,35100,81800,"Sub-basin 4"
6040,57800,28216,52400,110200,"Sub-basin 4"
6041,300,4,2500,2800,"Sub-basin 4"
6042,800,32,4000,4800,"Sub-basin 4"
6043,700,121,2700,3400,"Sub-basin 4"
6044,1700,137,5300,7000,"Sub-basin 4"
6045,300,12,1700,2000,"Sub-basin 4"
6046,400,23,1500,1900,"Sub-basin 4"
6047,400,59,3000,3400,"Sub-basin 4"
6048,300,20,1700,2000,"Sub-basin 4"
6049,100,4,1600,1700,"Sub-basin 4"
6050,500,44,5300,5800,"Sub-basin 4"
6051,100,3,700,800,"Sub-basin 4"
6052,100,2,1900,2000,"Sub-basin 4"
6053,100,3,500,600,"Sub-basin 4"
6054,1300,445,2400,3700,"Sub-basin 4"
6055,200,7,1500,1700,"Sub-basin 4"
6056,3100,202,10000,13100,"Sub-basin 4"
6057,10000,3438,13600,23600,"Sub-basin 4"
6058,5900,1333,7500,13400,"Sub-basin 4"
6059,1000,97,2500,3500,"Sub-basin 4"
6060,400,53,3000,3400,"Sub-basin 4"
6061,200,4,1500,1700,"Sub-basin 4"
6062,1000,70,5800,6800,"Sub-basin 4"
6063,2000,173,11000,13000,"Sub-basin 4"
6064,500,10,3100,3600,"Sub-basin 4"
6065,1400,389,4300,5700,"Sub-basin 4"
6066,3400,743,13900,17300,"Sub-basin 4"
6067,21100,1700,30900,52000,"Sub-basin 4"
6068,100,3,500,600,"Sub-basin 4"
6069,400,31,2200,2600,"Sub-basin 4"
6070,100,2,1200,1300,"Sub-basin 4"
6071,300,8,2800,3100,"Sub-basin 4"
6072,100,1,1100,1200,"Sub-basin 4"
6073,100,1,1100,1200,"Sub-basin 4"
6074,100,1,600,700,"Sub-basin 4"
6075,1200,171,6900,8100,"Sub-basin 4"
6076,1000,132,6000,7000,"Sub-basin 4"
6077,600,68,2200,2800,"Sub-basin 4"
6078,100,3,2000,2100,"Sub-basin 4"
6079,100,1,800,900,"Sub-basin 4"
6080,900,68,7100,8000,"Sub-basin 4"
6081,200,15,2100,2300,"Sub-basin 4"
6082,12800,2560,41800,54600,"Sub-basin 4"
6083,100,1,1000,1100,"Sub-basin 4"
6084,800,127,2400,3200,"Sub-basin 4"
6085,400,96,2400,2800,"Sub-basin 4"
6086,300,17,1200,1500,"Sub-basin 4"
6087,100,3,900,1000,"Sub-basin 4"
6088,100,2,700,800,"Sub-basin 4"
6089,600,55,1800,2400,"Sub-basin 4"
6090,1000,65,5200,6200,"Sub-basin 4"
6091,100,1,800,900,"Sub-basin 4"
6092,100,5,1700,1800,"Sub-basin 4"
6093,100,4,1700,1800,"Sub-basin 4"
6094,2100,321,7500,9600,"Sub-basin 4"
6095,100,2,400,500,"Sub-basin 4"
6096,400,26,5400,5800,"Sub-basin 4"
6097,200,3,2000,2200,"Sub-basin 4"
6098,600,38,2500,3100,"Sub-basin 4"
6099,45200,10494.83,80400,125600,"Sub-basin 4"
6100,600,64,3800,4400,"Sub-basin 4"
6101,100,2,700,800,"Sub-basin 4"
6102,200,6,1000,1200,"Sub-basin 4"
6103,2500,773,9200,11700,"Sub-basin 4"
6104,900,148,4100,5000,"Sub-basin 4"
6105,200,10,600,800,"Sub-basin 4"
6106,5600,583,20300,25900,"Sub-basin 4"
6107,2500,892,5100,7600,"Sub-basin 4"
6108,100,3,800,900,"Sub-basin 4"
6109,700,56,1900,2600,"Sub-basin 4"
6110,900,161,3900,4800,"Sub-basin 4"
6111,800,206,2900,3700,"Sub-basin 4"
6112,100,7,1000,1100,"Sub-basin 4"
6113,100,1,600,700,"Sub-basin 4"
6114,2100,379,7800,9900,"Sub-basin 4"
6115,700,58,7700,8400,"Sub-basin 4"
6116,600,25,2400,3000,"Sub-basin 4"
6117,13100,2666,46000,59100,"Sub-basin 4"
6118,8400,455,22900,31300,"Sub-basin 4"
6119,600,56,6600,7200,"Sub-basin 4"
6120,11600,1734,43400,55000,"Sub-basin 4"
6121,400,31,4000,4400,"Sub-basin 4"
6122,300,7,2400,2700,"Sub-basin 4"
6123,32600,5583,41600,74200,"Sub-basin 4"
6124,1900,141,7500,9400,"Sub-basin 4"
6125,100,3,800,900,"Sub-basin 4"
6126,100,1,1400,1500,"Sub-basin 4"
6127,100,1,500,600,"Sub-basin 4"
6128,1700,267,8800,10500,"Sub-basin 4"
6129,1100,37,6000,7100,"Sub-basin 4"
6130,200,4,1400,1600,"Sub-basin 4"
6131,1600,240,4100,5700,"Sub-basin 4"
6132,2500,260,17600,20100,"Sub-basin 4"
6133,1500,244.5,7900,9400,"Sub-basin 4"
6134,600,63,2200,2800,"Sub-basin 4"
6135,200,8,3800,4000,"Sub-basin 4"
6136,1000,92,4900,5900,"Sub-basin 4"
6137,300,6,1300,1600,"Sub-basin 4"
6138,300,26,3000,3300,"Sub-basin 4"
6139,100,4,300,400,"Sub-basin 4"
6140,900,53,1800,2700,"Sub-basin 4"
6141,500,64,2000,2500,"Sub-basin 4"
6142,100,1,300,400,"Sub-basin 4"
6143,500,27,3700,4200,"Sub-basin 4"
6144,1500,109,12100,13600,"Sub-basin 4"
6145,400,45,6000,6400,"Sub-basin 4"
6146,400,20,2200,2600,"Sub-basin 4"
6147,400,11,700,1100,"Sub-basin 4"
6148,100,1,1100,1200,"Sub-basin 4"
6149,6900,491,30300,37200,"Sub-basin 4"
6150,400,36,2200,2600,"Sub-basin 4"
6151,900,29,7200,8100,"Sub-basin 4"
6152,100,2,1700,1800,"Sub-basin 4"
6153,800,79,7500,8300,"Sub-basin 4"
6154,2000,392,5100,7100,"Sub-basin 4"
6155,400,22,3500,3900,"Sub-basin 4"
6156,200,6,900,1100,"Sub-basin 4"
6157,100,3,1100,1200,"Sub-basin 4"
6158,300,3,2400,2700,"Sub-basin 4"
6159,300,17,1500,1800,"Sub-basin 4"
6160,600,48,3000,3600,"Sub-basin 4"
6161,200,12,2100,2300,"Sub-basin 4"
6162,3200,389,5800,9000,"Sub-basin 4"
6163,2700,540,14600,17300,"Sub-basin 4"
6164,900,69,1300,2200,"Sub-basin 4"
6165,200,2,200,400,"Sub-basin 4"
6166,100,2,1000,1100,"Sub-basin 4"
6167,100,3,900,1000,"Sub-basin 4"
6168,100,4,1400,1500,"Sub-basin 4"
6169,36600,12829,37100,73700,"Sub-basin 4"
6170,100,1,300,400,"Sub-basin 4"
6171,200,5,600,800,"Sub-basin 4"
6172,300,5,4400,4700,"Sub-basin 4"
6173,400,24,3000,3400,"Sub-basin 4"
6174,100,1,1600,1700,"Sub-basin 4"
6175,200,5,1900,2100,"Sub-basin 4"
6176,100,1,200,300,"Sub-basin 4"
6177,300,13,1800,2100,"Sub-basin 4"
6178,900,117,5800,6700,"Sub-basin 4"
6179,800,53,3800,4600,"Sub-basin 4"
6180,400,23,1700,2100,"Sub-basin 4"
6181,100,6,1900,2000,"Sub-basin 4"
6182,400,38,2300,2700,"Sub-basin 4"
6183,600,50,3300,3900,"Sub-basin 4"
6184,100,2,1100,1200,"Sub-basin 4"
6185,12400,1065.33,46900,59300,"Sub-basin 4"
6186,100,1,700,800,"Sub-basin 4"
6187,300,11,1000,1300,"Sub-basin 4"
6188,600,40,2400,3000,"Sub-basin 4"
6189,300,26,1800,2100,"Sub-basin 4"
6190,7500,1015,25100,32600,"Sub-basin 4"
6191,28500,10827.32,30700,59200,"Sub-basin 4"
6192,100,3,600,700,"Sub-basin 4"
6193,3000,690,5800,8800,"Sub-basin 4"
6194,200,4,600,800,"Sub-basin 4"
6195,400,17,1500,1900,"Sub-basin 4"
6196,600,48,2900,3500,"Sub-basin 4"
6197,1300,103,13100,14400,"Sub-basin 4"
6198,300,7,3900,4200,"Sub-basin 4"
6199,400,28,2100,2500,"Sub-basin 4"
6200,139200,46265.18,149100,288300,"Sub-basin 4"
6201,4500,1111,9700,14200,"Sub-basin 4"
6202,2000,204,19000,21000,"Sub-basin 4"
6203,200,16,1400,1600,"Sub-basin 4"
6204,2000,343,10300,12300,"Sub-basin 4"
6205,1100,152,4100,5200,"Sub-basin 4"
6206,200,19,1200,1400,"Sub-basin 4"
6207,1100,67,7900,9000,"Sub-basin 4"
6208,200,3,1700,1900,"Sub-basin 4"
6209,100,2,700,800,"Sub-basin 4"
6210,500,30,1700,2200,"Sub-basin 4"
6211,2700,241,9500,12200,"Sub-basin 4"
6212,6600,1134,11200,17800,"Sub-basin 4"
6213,100,2,1000,1100,"Sub-basin 4"
6214,800,60,4300,5100,"Sub-basin 4"
6215,200,7,1500,1700,"Sub-basin 4"
6216,1000,21,12100,13100,"Sub-basin 4"
6217,200,22,2300,2500,"Sub-basin 4"
6218,200,20,800,1000,"Sub-basin 4"
6219,500,14,4800,5300,"Sub-basin 4"
6220,600,37,1500,2100,"Sub-basin 4"
6221,100,1,1300,1400,"Sub-basin 4"
6222,800,37,4400,5200,"Sub-basin 4"
6223,200,5,3700,3900,"Sub-basin 4"
6224,300,8,1400,1700,"Sub-basin 4"
6225,100,6,1000,1100,"Sub-basin 4"
6226,1400,60,13800,15200,"Sub-basin 4"
6227,100,3,1200,1300,"Sub-basin 4"
6228,6800,634,38100,44900,"Sub-basin 4"
6229,300,33,1000,1300,"Sub-basin 4"
6230,100,5,2000,2100,"Sub-basin 4"
6231,100,1,800,900,"Sub-basin 4"
6232,200,13,1400,1600,"Sub-basin 4"
6233,500,19,2300,2800,"Sub-basin 4"
6234,200,13,1600,1800,"Sub-basin 4"
6235,400,34,2200,2600,"Sub-basin 4"
6236,200,4,1400,1600,"Sub-basin 4"
6237,100,13,1700,1800,"Sub-basin 4"
6238,700,131,3100,3800,"Sub-basin 4"
6239,100,2,1300,1400,"Sub-basin 4"
6240,300,13,2000,2300,"Sub-basin 4"
6241,5100,1328,11400,16500,"Sub-basin 4"
6242,5600,314,20500,26100,"Sub-basin 4"
6243,200,5,1900,2100,"Sub-basin 4"
6244,100,1,2700,2800,"Sub-basin 4"
6245,300,4,5300,5600,"Sub-basin 4"
6246,200,5,800,1000,"Sub-basin 4"
6247,200,3,1100,1300,"Sub-basin 4"
6248,18600,4641,23600,42200,"Sub-basin 4"
6249,100,2,700,800,"Sub-basin 4"
6250,400,11,6200,6600,"Sub-basin 4"
6251,200,4,2500,2700,"Sub-basin 4"
6252,100,6,1200,1300,"Sub-basin 4"
6253,100,3,1800,1900,"Sub-basin 4"
6254,1400,202.38,3200,4600,"Sub-basin 4"
6255,15200,5266,23300,38500,"Sub-basin 4"
6256,1700,155,6500,8200,"Sub-basin 4"
6257,10600,1595,19500,30100,"Sub-basin 4"
6258,300,21,3300,3600,"Sub-basin 4"
6259,200,4,2900,3100,"Sub-basin 4"
6260,600,32,1200,1800,"Sub-basin 4"
6261,400,11,5200,5600,"Sub-basin 4"
6262,900,85,4900,5800,"Sub-basin 4"
6263,1500,253.17,4900,6400,"Sub-basin 4"
6264,500,28,3000,3500,"Sub-basin 4"
6265,700,67,1200,1900,"Sub-basin 4"
6266,300,23,2300,2600,"Sub-basin 4"
6267,100,3,900,1000,"Sub-basin 4"
6268,11800,1600,67700,79500,"Sub-basin 4"
6269,400,15,2700,3100,"Sub-basin 4"
6270,500,68,2800,3300,"Sub-basin 4"
6271,600,60,1800,2400,"Sub-basin 4"
6272,1800,258,4400,6200,"Sub-basin 4"
6273,100,2,1400,1500,"Sub-basin 4"
6274,2000,381,8700,10700,"Sub-basin 4"
6275,99400,21592,158500,257900,"Sub-basin 4"
6276,400,21,5000,5400,"Sub-basin 4"
6277,400,43,2600,3000,"Sub-basin 4"
6278,2700,285,10800,13500,"Sub-basin 4"
6279,200,15,1200,1400,"Sub-basin 4"
6280,200,3,3900,4100,"Sub-basin 4"
6281,600,56,3000,3600,"Sub-basin 4"
6282,800,46,6000,6800,"Sub-basin 4"
6283,600,66,1400,2000,"Sub-basin 4"
6284,100,2,800,900,"Sub-basin 4"
6285,2200,925,4300,6500,"Sub-basin 4"
6286,2700,650,9000,11700,"Sub-basin 4"
6287,1000,288,1700,2700,"Sub-basin 4"
6288,200,2,1100,1300,"Sub-basin 4"
6289,200,9,900,1100,"Sub-basin 4"
6290,49300,15319,58800,108100,"Sub-basin 4"
6291,1500,182,9000,10500,"Sub-basin 4"
6292,3800,311,21100,24900,"Sub-basin 4"
6293,100,4,1600,1700,"Sub-basin 4"
6294,2900,295,26000,28900,"Sub-basin 4"
6295,1900,135,15500,17400,"Sub-basin 4"
6296,200,8,2600,2800,"Sub-basin 4"
6297,1900,80,14600,16500,"Sub-basin 4"
6298,1500,133,7400,8900,"Sub-basin 4"
6299,200,9,2600,2800,"Sub-basin 4"
6300,1600,503,6600,8200,"Sub-basin 4"
6301,600,56,1300,1900,"Sub-basin 4"
6302,200,4,2300,2500,"Sub-basin 4"
6303,1300,212,2200,3500,"Sub-basin 4"
6304,700,87,1300,2000,"Sub-basin 4"
6305,7400,3053,10200,17600,"Sub-basin 4"
6306,900,60,6900,7800,"Sub-basin 4"
6307,100,3,900,1000,"Sub-basin 4"
6308,100,2,2700,2800,"Sub-basin 4"
6309,600,34,4300,4900,"Sub-basin 4"
6310,27100,5389,47100,74200,"Sub-basin 4"
6311,200,2,3200,3400,"Sub-basin 4"
6312,100,5,1200,1300,"Sub-basin 4"
6313,600,24,3100,3700,"Sub-basin 4"
6314,400,68,2000,2400,"Sub-basin 4"
6315,900,96,7800,8700,"Sub-basin 4"
6316,900,183,6100,7000,"Sub-basin 4"
6317,100,3,2100,2200,"Sub-basin 4"
6318,500,16,9000,9500,"Sub-basin 4"
6319,1100,132.33,5200,6300,"Sub-basin 4"
6320,4400,593,10200,14600,"Sub-basin 4"
6321,200,3,3200,3400,"Sub-basin 4"
6322,300,25,1700,2000,"Sub-basin 4"
6323,100,3,1300,1400,"Sub-basin 4"
6324,100,1,600,700,"Sub-basin 4"
6325,700,50,4900,5600,"Sub-basin 4"
6326,1000,167,2200,3200,"Sub-basin 4"
6327,41800,22518.84,60800,102600,"Sub-basin 4"
6328,100,2,900,1000,"Sub-basin 4"
6329,400,12,4300,4700,"Sub-basin 4"
6330,1100,163,5700,6800,"Sub-basin 4"
6331,1900,122,11800,13700,"Sub-basin 4"
6332,300,9,5400,5700,"Sub-basin 4"
6333,3400,1004,7500,10900,"Sub-basin 4"
6334,100,1,500,600,"Sub-basin 4"
6335,100,1,1700,1800,"Sub-basin 4"
6336,200,6,3200,3400,"Sub-basin 4"
6337,700,59,2500,3200,"Sub-basin 4"
6338,100,1,1200,1300,"Sub-basin 4"
6339,100,1,1300,1400,"Sub-basin 4"
6340,100,1,2600,2700,"Sub-basin 4"
6341,11500,1611,78100,89600,"Sub-basin 4"
6342,600,195,2500,3100,"Sub-basin 4"
6343,600,28,8500,9100,"Sub-basin 4"
6344,1100,75,6200,7300,"Sub-basin 4"
6345,2800,433,10800,13600,"Sub-basin 4"
6346,200,2,2100,2300,"Sub-basin 4"
6347,100,1,1300,1400,"Sub-basin 4"
6348,200,10,2700,2900,"Sub-basin 4"
6349,700,48,3200,3900,"Sub-basin 4"
6350,400,37,2800,3200,"Sub-basin 4"
6351,700,57,8200,8900,"Sub-basin 4"
6352,1000,55,7200,8200,"Sub-basin 4"
6353,1500,240,4200,5700,"Sub-basin 4"
6354,100,2,100,200,"Sub-basin 4"
6355,500,23,2300,2800,"Sub-basin 4"
6356,600,70,2400,3000,"Sub-basin 4"
6357,100,2,1200,1300,"Sub-basin 4"
6358,100,2,1300,1400,"Sub-basin 4"
6359,1000,114,4200,5200,"Sub-basin 4"
6360,100,7,1000,1100,"Sub-basin 4"
6361,800,96,5300,6100,"Sub-basin 4"
6362,100,1,1600,1700,"Sub-basin 4"
6363,100,1,2100,2200,"Sub-basin 4"
6364,5400,994,35400,40800,"Sub-basin 4"
6365,200,9,2200,2400,"Sub-basin 4"
6366,200,2,2100,2300,"Sub-basin 4"
6367,100,3,3300,3400,"Sub-basin 4"
6368,200,5,3300,3500,"Sub-basin 4"
6369,100,1,1400,1500,"Sub-basin 4"
6370,600,59,2300,2900,"Sub-basin 4"
6371,100,1,900,1000,"Sub-basin 4"
6372,200,3,2200,2400,"Sub-basin 4"
6373,1300,104,7400,8700,"Sub-basin 4"
6374,700,23,11300,12000,"Sub-basin 4"
6375,1700,116,10900,12600,"Sub-basin 4"
6376,100,6,1600,1700,"Sub-basin 4"
6377,100,1,1300,1400,"Sub-basin 4"
6378,1000,333,3200,4200,"Sub-basin 4"
6379,200,2,700,900,"Sub-basin 4"
6380,900,163,1900,2800,"Sub-basin 4"
6381,100,1,1100,1200,"Sub-basin 4"
6382,200,7,2700,2900,"Sub-basin 4"
6383,200,5,1300,1500,"Sub-basin 4"
6384,400,43,2700,3100,"Sub-basin 4"
6385,1400,70,9300,10700,"Sub-basin 4"
6386,500,21,7200,7700,"Sub-basin 4"
6387,1200,193,2300,3500,"Sub-basin 4"
6388,100,3,1600,1700,"Sub-basin 4"
6389,1000,47,15200,16200,"Sub-basin 4"
6390,4700,1296,9500,14200,"Sub-basin 4"
6391,35800,5490,53200,89000,"Sub-basin 4"
6392,5100,1560,8000,13100,"Sub-basin 4"
6393,100,1,1900,2000,"Sub-basin 4"
6394,200,16,2100,2300,"Sub-basin 4"
6395,200,5,1500,1700,"Sub-basin 4"
6396,600,91,3800,4400,"Sub-basin 4"
6397,200,7,3900,4100,"Sub-basin 4"
6398,300,11,3500,3800,"Sub-basin 4"
6399,1700,182,8700,10400,"Sub-basin 4"
6400,500,48,2900,3400,"Sub-basin 4"
6401,500,23,2600,3100,"Sub-basin 4"
6402,12900,5108,17800,30700,"Sub-basin 4"
6403,1300,215,6500,7800,"Sub-basin 4"
6404,200,2,3700,3900,"Sub-basin 4"
6405,100,1,1300,1400,"Sub-basin 4"
6406,200,7,3100,3300,"Sub-basin 4"
6407,300,12,2300,2600,"Sub-basin 4"
6408,900,18,5200,6100,"Sub-basin 4"
6409,100,1,1000,1100,"Sub-basin 4"
6410,500,11,6700,7200,"Sub-basin 4"
6411,4000,1568,6600,10600,"Sub-basin 4"
6412,100,3,1700,1800,"Sub-basin 4"
6413,600,49,3800,4400,"Sub-basin 4"
6414,100,2,1200,1300,"Sub-basin 4"
6415,900,23,5100,6000,"Sub-basin 4"
6416,1200,127,11700,12900,"Sub-basin 4"
6417,800,64,3400,4200,"Sub-basin 4"
6418,100,2,800,900,"Sub-basin 4"
6419,100,1,800,900,"Sub-basin 4"
6420,100,1,1900,2000,"Sub-basin 4"
6421,700,187,1700,2400,"Sub-basin 4"
6422,500,57,4800,5300,"Sub-basin 4"
6423,10900,1625,31600,42500,"Sub-basin 4"
6424,9300,859,41000,50300,"Sub-basin 4"
6425,200,4,1700,1900,"Sub-basin 4"
6426,300,6,2800,3100,"Sub-basin 4"
6427,2100,262,9400,11500,"Sub-basin 4"
6428,100,1,500,600,"Sub-basin 4"
6429,6600,2143,7800,14400,"Sub-basin 4"
6430,400,17,2900,3300,"Sub-basin 4"
6431,2700,488,9800,12500,"Sub-basin 4"
6432,900,86,3700,4600,"Sub-basin 4"
6433,100,3,1400,1500,"Sub-basin 4"
6434,200,3,1200,1400,"Sub-basin 4"
6435,600,23,2200,2800,"Sub-basin 4"
6436,1200,178,2300,3500,"Sub-basin 4"
6437,400,70,1600,2000,"Sub-basin 4"
6438,600,98,3000,3600,"Sub-basin 4"
6439,900,152.01,2300,3200,"Sub-basin 4"
6440,100,1,2500,2600,"Sub-basin 4"
6441,200,5,200,400,"Sub-basin 4"
6442,3000,496,10200,13200,"Sub-basin 4"
6443,900,100,3000,3900,"Sub-basin 4"
6444,100,4,600,700,"Sub-basin 4"
6445,4900,1124,11700,16600,"Sub-basin 4"
6446,100,3,1200,1300,"Sub-basin 4"
6447,500,23,4700,5200,"Sub-basin 4"
6448,100,1,1500,1600,"Sub-basin 4"
6449,400,37,2000,2400,"Sub-basin 4"
6450,100,1,300,400,"Sub-basin 4"
6451,4200,912,9200,13400,"Sub-basin 4"
6452,700,27,6600,7300,"Sub-basin 4"
6453,700,55,4900,5600,"Sub-basin 4"
6454,100,4,800,900,"Sub-basin 4"
6455,900,74,2300,3200,"Sub-basin 4"
6456,500,17,2800,3300,"Sub-basin 4"
6457,100,3,1400,1500,"Sub-basin 4"
6458,600,70,9800,10400,"Sub-basin 4"
6459,100,1,500,600,"Sub-basin 4"
6460,100,3,800,900,"Sub-basin 4"
6461,800,114,2100,2900,"Sub-basin 4"
6462,400,36,3000,3400,"Sub-basin 4"
6463,100,2,0,100,"Sub-basin 4"
6464,600,24,4000,4600,"Sub-basin 4"
6465,3000,308,16600,19600,"Sub-basin 4"
6466,200,3,800,1000,"Sub-basin 4"
6467,87300,10129.16,136600,223900,"Sub-basin 4"
6468,100,4,1100,1200,"Sub-basin 4"
6469,500,12,2500,3000,"Sub-basin 4"
6470,100,3,1400,1500,"Sub-basin 4"
6471,800,39,2800,3600,"Sub-basin 4"
6472,300,12,3000,3300,"Sub-basin 4"
6473,700,125,1800,2500,"Sub-basin 4"
6474,200,2,500,700,"Sub-basin 4"
6475,600,15,2300,2900,"Sub-basin 4"
6476,17500,6114,25100,42600,"Sub-basin 4"
6477,100,1,2100,2200,"Sub-basin 4"
6478,400,42,1300,1700,"Sub-basin 4"
6479,200,6,400,600,"Sub-basin 4"
6480,1100,374,3100,4200,"Sub-basin 4"
6481,300,12,1500,1800,"Sub-basin 4"
6482,1200,114,9400,10600,"Sub-basin 4"
6483,600,135,2200,2800,"Sub-basin 4"
6484,600,57,1700,2300,"Sub-basin 4"
6485,1600,606,4400,6000,"Sub-basin 4"
6486,700,39,4500,5200,"Sub-basin 4"
6487,1600,509,2900,4500,"Sub-basin 4"
6488,100,1,900,1000,"Sub-basin 4"
6489,10500,3323,13900,24400,"Sub-basin 4"
6490,1100,77,15000,16100,"Sub-basin 4"
6491,900,139,2400,3300,"Sub-basin 4"
6492,9100,2260,14500,23600,"Sub-basin 4"
6493,300,12,700,1000,"Sub-basin 4"
6494,300,21,5800,6100,"Sub-basin 4"
6495,400,11,6000,6400,"Sub-basin 4"
6496,600,54,5100,5700,"Sub-basin 4"
6497,1000,121,6500,7500,"Sub-basin 4"
6498,1600,220,9900,11500,"Sub-basin 4"
6499,300,10,2800,3100,"Sub-basin 4"
6500,300,17,1500,1800,"Sub-basin 4"
6501,200,10,1100,1300,"Sub-basin 4"
6502,2900,185,32400,35300,"Sub-basin 4"
6503,100,3,600,700,"Sub-basin 4"
6504,14100,4232,27200,41300,"Sub-basin 4"
6505,100,1,2700,2800,"Sub-basin 4"
6506,100,1,3400,3500,"Sub-basin 4"
6507,200,8,1900,2100,"Sub-basin 4"
6508,400,41,600,1000,"Sub-basin 4"
6509,400,19,900,1300,"Sub-basin 4"
6510,100,39,900,1000,"Sub-basin 4"
6511,400,6,400,800,"Sub-basin 4"
6512,500,24,6100,6600,"Sub-basin 4"
6513,100,2,1400,1500,"Sub-basin 4"
6514,5800,1252,10100,15900,"Sub-basin 4"
6515,100,3,1200,1300,"Sub-basin 4"
6516,500,12,4100,4600,"Sub-basin 4"
6517,200,8,2300,2500,"Sub-basin 4"
6518,200,7,2700,2900,"Sub-basin 4"
6519,300,22,1300,1600,"Sub-basin 4"
6520,300,23,1300,1600,"Sub-basin 4"
6521,700,81,2000,2700,"Sub-basin 4"
6522,100,2,2300,2400,"Sub-basin 4"
6523,100,11,300,400,"Sub-basin 4"
6524,500,53,2200,2700,"Sub-basin 4"
6525,500,48.33,2700,3200,"Sub-basin 4"
6526,400,41,1000,1400,"Sub-basin 4"
6527,200,12,4400,4600,"Sub-basin 4"
6528,100,2,1200,1300,"Sub-basin 4"
6529,500,47,1700,2200,"Sub-basin 4"
6530,2000,277,13900,15900,"Sub-basin 4"
6531,500,20,5900,6400,"Sub-basin 4"
6532,400,11,5500,5900,"Sub-basin 4"
6533,2700,317,19500,22200,"Sub-basin 4"
6534,2500,362,28300,30800,"Sub-basin 4"
6535,100,5,1200,1300,"Sub-basin 4"
6536,100,3,800,900,"Sub-basin 4"
6537,200,9,1800,2000,"Sub-basin 4"
6538,100,6,800,900,"Sub-basin 4"
6539,200,8,2300,2500,"Sub-basin 4"
6540,800,86,8000,8800,"Sub-basin 4"
6541,800,44,7100,7900,"Sub-basin 4"
6542,700,100,1200,1900,"Sub-basin 4"
6543,100,2,1000,1100,"Sub-basin 4"
6544,1700,219,4200,5900,"Sub-basin 4"
6545,39700,8579.119,243300,283000,"Sub-basin 4"
6546,400,18,3900,4300,"Sub-basin 4"
6547,600,71,4200,4800,"Sub-basin 4"
6548,300,5,2100,2400,"Sub-basin 4"
6549,4100,1070,8000,12100,"Sub-basin 4"
6550,100,2,500,600,"Sub-basin 4"
6551,1300,352,3900,5200,"Sub-basin 4"
6552,400,21,2600,3000,"Sub-basin 4"
6553,100,5,600,700,"Sub-basin 4"
6554,100,3,1700,1800,"Sub-basin 4"
6555,100,2.84,1100,1200,"Sub-basin 4"
6556,300,8,4400,4700,"Sub-basin 4"
6557,1100,210,3000,4100,"Sub-basin 4"
6558,100,3,100,200,"Sub-basin 4"
6559,2200,313,15000,17200,"Sub-basin 4"
6560,500,84,1500,2000,"Sub-basin 4"
6561,1100,89,14400,15500,"Sub-basin 4"
6562,700,39,12200,12900,"Sub-basin 4"
6563,1900,258,11600,13500,"Sub-basin 4"
6564,600,109,1500,2100,"Sub-basin 4"
6565,18500,1566,34800,53300,"Sub-basin 4"
6566,2200,224,11200,13400,"Sub-basin 4"
6567,600,48,5300,5900,"Sub-basin 4"
6568,1400,121,14200,15600,"Sub-basin 4"
6569,900,155,9700,10600,"Sub-basin 4"
6570,400,15,3400,3800,"Sub-basin 4"
6571,100,3,100,200,"Sub-basin 4"
6572,100,1,1200,1300,"Sub-basin 4"
6573,200,4,800,1000,"Sub-basin 4"
6574,100,2,400,500,"Sub-basin 4"
6575,200,15,1900,2100,"Sub-basin 4"
6576,300,5,5900,6200,"Sub-basin 4"
6577,200,16,2600,2800,"Sub-basin 4"
6578,1500,260,13700,15200,"Sub-basin 4"
6579,100,1,800,900,"Sub-basin 4"
6580,400,27,4300,4700,"Sub-basin 4"
6581,600,50.67,2600,3200,"Sub-basin 4"
6582,500,44,2600,3100,"Sub-basin 4"
6583,6900,893,48200,55100,"Sub-basin 4"
6584,500,16,3200,3700,"Sub-basin 4"
6585,5800,906,8300,14100,"Sub-basin 4"
6586,300,9,1600,1900,"Sub-basin 4"
6587,3000,231,17400,20400,"Sub-basin 4"
6588,100,1,1500,1600,"Sub-basin 4"
6589,500,22,2200,2700,"Sub-basin 4"
6590,300,18,2600,2900,"Sub-basin 4"
6591,100,2,1200,1300,"Sub-basin 4"
6592,1000,66,6100,7100,"Sub-basin 4"
6593,100,2,600,700,"Sub-basin 4"
6594,600,21,6900,7500,"Sub-basin 4"
6595,400,52,1200,1600,"Sub-basin 4"
6596,100,5,500,600,"Sub-basin 4"
6597,1600,202,3200,4800,"Sub-basin 4"
6598,100,1,900,1000,"Sub-basin 4"
6599,300,19,2000,2300,"Sub-basin 4"
6600,100,2,1700,1800,"Sub-basin 4"
6601,1000,129,5000,6000,"Sub-basin 4"
6602,100,2,500,600,"Sub-basin 4"
6603,400,51,2600,3000,"Sub-basin 4"
6604,200,7,1500,1700,"Sub-basin 4"
6605,100,2,500,600,"Sub-basin 4"
6606,300,35,1500,1800,"Sub-basin 4"
6607,1400,74,7400,8800,"Sub-basin 4"
6608,100,4,2600,2700,"Sub-basin 4"
6609,100,3,1600,1700,"Sub-basin 4"
6610,2300,384,4800,7100,"Sub-basin 4"
6611,100,4,1800,1900,"Sub-basin 4"
6612,100,15,800,900,"Sub-basin 4"
6613,500,20,3400,3900,"Sub-basin 4"
6614,400,27,2600,3000,"Sub-basin 4"
6615,400,26,3600,4000,"Sub-basin 4"
6616,1600,98,15900,17500,"Sub-basin 4"
6617,100,5,700,800,"Sub-basin 4"
6618,200,4,1700,1900,"Sub-basin 4"
6619,100,2,1100,1200,"Sub-basin 4"
6620,100,1,1300,1400,"Sub-basin 4"
6621,1100,95,10900,12000,"Sub-basin 4"
6622,2200,324,16800,19000,"Sub-basin 4"
6623,5100,835,20600,25700,"Sub-basin 4"
6624,500,25,3000,3500,"Sub-basin 4"
6625,200,14,1900,2100,"Sub-basin 4"
6626,100,5,1500,1600,"Sub-basin 4"
6627,300,4,700,1000,"Sub-basin 4"
6628,200,8,1900,2100,"Sub-basin 4"
6629,400,22,4000,4400,"Sub-basin 4"
6630,2500,395,7400,9900,"Sub-basin 4"
6631,2600,453,18500,21100,"Sub-basin 4"
6632,100,3,1600,1700,"Sub-basin 4"
6633,100,1,1500,1600,"Sub-basin 4"
6634,800,43,3000,3800,"Sub-basin 4"
6635,100,2,1800,1900,"Sub-basin 4"
6636,600,24,3500,4100,"Sub-basin 4"
6637,1300,115,4100,5400,"Sub-basin 4"
6638,300,28,3500,3800,"Sub-basin 4"
6639,100,6,1700,1800,"Sub-basin 4"
6640,500,16,4100,4600,"Sub-basin 4"
6641,1900,106,11300,13200,"Sub-basin 4"
6642,400,7,1000,1400,"Sub-basin 4"
6643,100,1,700,800,"Sub-basin 4"
6644,400,18,500,900,"Sub-basin 4"
6645,400,24,2000,2400,"Sub-basin 4"
6646,100,4,600,700,"Sub-basin 4"
6647,500,11,3800,4300,"Sub-basin 4"
6648,100,1,400,500,"Sub-basin 4"
6649,200,2,1600,1800,"Sub-basin 4"
6650,100,2,2000,2100,"Sub-basin 4"
6651,1300,261,4700,6000,"Sub-basin 4"
6652,100,6,1700,1800,"Sub-basin 4"
6653,100,1,400,500,"Sub-basin 4"
6654,700,82,3200,3900,"Sub-basin 4"
6655,200,3,1900,2100,"Sub-basin 4"
6656,1500,109,12200,13700,"Sub-basin 4"
6657,100,2,1000,1100,"Sub-basin 4"
6658,800,62,5300,6100,"Sub-basin 4"
6659,200,4,3200,3400,"Sub-basin 4"
6660,400,4,2900,3300,"Sub-basin 4"
6661,300,13,3500,3800,"Sub-basin 4"
6662,200,8,2800,3000,"Sub-basin 4"
6663,100,2,800,900,"Sub-basin 4"
6664,100,5,1400,1500,"Sub-basin 4"
6665,33400,5759.67,145400,178800,"Sub-basin 4"
6666,600,19,2800,3400,"Sub-basin 4"
6667,400,15,800,1200,"Sub-basin 4"
6668,300,4,1300,1600,"Sub-basin 4"
6669,100,1,700,800,"Sub-basin 4"
6670,500,31,8500,9000,"Sub-basin 4"
6671,200,15,1100,1300,"Sub-basin 4"
6672,100,3,800,900,"Sub-basin 4"
6673,200,5,4400,4600,"Sub-basin 4"
6674,100,4,500,600,"Sub-basin 4"
6675,400,46,1800,2200,"Sub-basin 4"
6676,100,5,900,1000,"Sub-basin 4"
6677,800,126,5700,6500,"Sub-basin 4"
6678,100,1,900,1000,"Sub-basin 4"
6679,2900,618,40400,43300,"Sub-basin 4"
6680,100,3,1600,1700,"Sub-basin 4"
6681,100,1,1100,1200,"Sub-basin 4"
6682,200,3,2400,2600,"Sub-basin 4"
6683,100,3,1600,1700,"Sub-basin 4"
6684,400,22,2900,3300,"Sub-basin 4"
6685,100,2,800,900,"Sub-basin 4"
6686,100,4,1000,1100,"Sub-basin 4"
6687,600,33,3800,4400,"Sub-basin 4"
6688,200,4,900,1100,"Sub-basin 4"
6689,100,1,1700,1800,"Sub-basin 4"
6690,100,6,2700,2800,"Sub-basin 4"
6691,1200,53,7400,8600,"Sub-basin 4"
6692,200,16,2000,2200,"Sub-basin 4"
6693,700,117,7000,7700,"Sub-basin 4"
6694,2000,190,8400,10400,"Sub-basin 4"
6695,500,38,5400,5900,"Sub-basin 4"
6696,11100,1505,51800,62900,"Sub-basin 4"
6697,800,99,8100,8900,"Sub-basin 4"
6698,300,25,1600,1900,"Sub-basin 4"
6699,3300,561,9300,12600,"Sub-basin 4"
6700,3000,198,14700,17700,"Sub-basin 4"
6701,200,6,3300,3500,"Sub-basin 4"
6702,100,5,1600,1700,"Sub-basin 4"
6703,200,10,4300,4500,"Sub-basin 4"
6704,300,12,5500,5800,"Sub-basin 4"
6705,400,9,8600,9000,"Sub-basin 4"
6706,1800,116,13400,15200,"Sub-basin 4"
6707,900,73,10000,10900,"Sub-basin 4"
6708,100,1,1300,1400,"Sub-basin 4"
6709,100,4,800,900,"Sub-basin 4"
6710,100,2,3300,3400,"Sub-basin 4"
6711,100,1,2300,2400,"Sub-basin 4"
6712,100,1,500,600,"Sub-basin 4"
6713,300,8,1600,1900,"Sub-basin 4"
6714,500,28,4600,5100,"Sub-basin 4"
6715,600,30,7600,8200,"Sub-basin 4"
6716,700,46,4800,5500,"Sub-basin 4"
6717,100,2,1800,1900,"Sub-basin 4"
6718,100,5,3200,3300,"Sub-basin 4"
6719,100,1,100,200,"Sub-basin 4"
6720,200,10,1600,1800,"Sub-basin 4"
6721,200,10,4000,4200,"Sub-basin 4"
6722,9300,1811.17,44200,53500,"Sub-basin 4"
6723,200,8,2200,2400,"Sub-basin 4"
6724,200,2,1800,2000,"Sub-basin 4"
6725,300,13,2100,2400,"Sub-basin 4"
6726,200,2,1600,1800,"Sub-basin 4"
6727,500,32,2100,2600,"Sub-basin 4"
6728,100,2,400,500,"Sub-basin 4"
6729,1200,62,9700,10900,"Sub-basin 4"
6730,500,22,5400,5900,"Sub-basin 4"
6731,100,3,2200,2300,"Sub-basin 4"
6732,100,6,1400,1500,"Sub-basin 4"
6733,2600,218,32200,34800,"Sub-basin 4"
6734,900,30,9000,9900,"Sub-basin 4"
6735,3400,373,16600,20000,"Sub-basin 4"
6736,100,1,900,1000,"Sub-basin 4"
6737,500,25,6300,6800,"Sub-basin 4"
6738,200,2,3600,3800,"Sub-basin 4"
6739,23900,13003,33000,56900,"Sub-basin 4"
6740,900,61,5500,6400,"Sub-basin 4"
6741,4200,733,10800,15000,"Sub-basin 4"
6742,2300,293,10200,12500,"Sub-basin 4"
6743,100,1,200,300,"Sub-basin 4"
6744,300,14,7300,7600,"Sub-basin 4"
6745,300,5,5100,5400,"Sub-basin 4"
6746,200,6,2100,2300,"Sub-basin 4"
6747,300,7,2900,3200,"Sub-basin 4"
6748,200,5,3700,3900,"Sub-basin 4"
6749,100,5,1000,1100,"Sub-basin 4"
6750,100,1,1400,1500,"Sub-basin 4"
6751,600,77,2300,2900,"Sub-basin 4"
6752,100,2,1400,1500,"Sub-basin 4"
6753,100,1,2200,2300,"Sub-basin 4"
6754,100,1,2100,2200,"Sub-basin 4"
6755,700,44,5600,6300,"Sub-basin 4"
6756,11400,1143,77900,89300,"Sub-basin 4"
6757,400,10,5200,5600,"Sub-basin 4"
6758,100,1,800,900,"Sub-basin 4"
6759,400,15,4700,5100,"Sub-basin 4"
6760,200,7,3400,3600,"Sub-basin 4"
6761,400,43,3100,3500,"Sub-basin 4"
6762,1600,125,7700,9300,"Sub-basin 4"
6763,800,46,4000,4800,"Sub-basin 4"
6764,100,2,700,800,"Sub-basin 4"
6765,300,10,2800,3100,"Sub-basin 4"
6766,400,17,1100,1500,"Sub-basin 4"
6767,1500,706,5700,7200,"Sub-basin 4"
6768,400,56,3900,4300,"Sub-basin 4"
6769,300,15,6400,6700,"Sub-basin 4"
6770,100,1,900,1000,"Sub-basin 4"
6771,600,57.5,1300,1900,"Sub-basin 4"
6772,400,13,2800,3200,"Sub-basin 4"
6773,600,14,7500,8100,"Sub-basin 4"
6774,18400,6075,42900,61300,"Sub-basin 4"
6775,700,69,2500,3200,"Sub-basin 4"
6776,100,1,1100,1200,"Sub-basin 4"
6777,100,2,2900,3000,"Sub-basin 4"
6778,700,68,2900,3600,"Sub-basin 4"
6779,400,10,4700,5100,"Sub-basin 4"
6780,300,5,1900,2200,"Sub-basin 4"
6781,200,6,2500,2700,"Sub-basin 4"
6782,100,1,2400,2500,"Sub-basin 4"
6783,4000,629,18100,22100,"Sub-basin 4"
6784,100,1,1300,1400,"Sub-basin 4"
6785,300,4,3800,4100,"Sub-basin 4"
6786,500,23,3400,3900,"Sub-basin 4"
6787,100,2,1800,1900,"Sub-basin 4"
6788,200,15,4700,4900,"Sub-basin 4"
6789,300,15,2300,2600,"Sub-basin 4"
6790,100,2,900,1000,"Sub-basin 4"
6791,100,1,1600,1700,"Sub-basin 4"
6792,100,4,700,800,"Sub-basin 4"
6793,200,2,3200,3400,"Sub-basin 4"
6794,500,14,1400,1900,"Sub-basin 4"
6795,1000,64,5500,6500,"Sub-basin 4"
6796,100,3,1700,1800,"Sub-basin 4"
6797,70500,18642.35,184400,254900,"Sub-basin 4"
6798,200,3,1800,2000,"Sub-basin 4"
6799,300,8,5000,5300,"Sub-basin 4"
6800,100,1,2200,2300,"Sub-basin 4"
6801,500,12,3800,4300,"Sub-basin 4"
6802,700,18,6400,7100,"Sub-basin 4"
6803,3600,451,11000,14600,"Sub-basin 4"
6804,600,71,4500,5100,"Sub-basin 4"
6805,100,2,2900,3000,"Sub-basin 4"
6806,23500,5262.84,16400,39900,"Sub-basin 4"
6807,300,7,900,1200,"Sub-basin 4"
6808,100,5,300,400,"Sub-basin 4"
6809,900,98,5900,6800,"Sub-basin 4"
6810,1600,188,11400,13000,"Sub-basin 4"
6811,100,2,700,800,"Sub-basin 4"
6812,100,1,800,900,"Sub-basin 4"
6813,5300,1260,13200,18500,"Sub-basin 4"
6814,100,5,2400,2500,"Sub-basin 4"
6815,200,33,3500,3700,"Sub-basin 4"
6816,200,4,3600,3800,"Sub-basin 4"
6817,400,18,1500,1900,"Sub-basin 4"
6818,100,2,600,700,"Sub-basin 4"
6819,100,1,800,900,"Sub-basin 4"
6820,200,5,2100,2300,"Sub-basin 4"
6821,100,1,800,900,"Sub-basin 4"
6822,200,10,1400,1600,"Sub-basin 4"
6823,4700,561.85,12900,17600,"Sub-basin 4"
6824,1000,64,5500,6500,"Sub-basin 4"
6825,600,29,5000,5600,"Sub-basin 4"
6826,400,34,3400,3800,"Sub-basin 4"
6827,800,128,2500,3300,"Sub-basin 4"
6828,1800,262,14200,16000,"Sub-basin 4"
6829,1200,172,3700,4900,"Sub-basin 4"
6830,600,40,2600,3200,"Sub-basin 4"
6831,200,4,500,700,"Sub-basin 4"
6832,500,38,5300,5800,"Sub-basin 4"
6833,800,102,4900,5700,"Sub-basin 4"
6834,100,1,2600,2700,"Sub-basin 4"
6835,900,104,1900,2800,"Sub-basin 4"
6836,900,106,3200,4100,"Sub-basin 4"
6837,100,1,2400,2500,"Sub-basin 4"
6838,100,10,1000,1100,"Sub-basin 4"
6839,2300,419,5100,7400,"Sub-basin 4"
6840,700,128,4800,5500,"Sub-basin 4"
6841,200,5,1500,1700,"Sub-basin 4"
6842,100,1,2400,2500,"Sub-basin 4"
6843,100,1,2700,2800,"Sub-basin 4"
6844,100,1,700,800,"Sub-basin 4"
6845,600,52,3500,4100,"Sub-basin 4"
6846,400,20,6000,6400,"Sub-basin 4"
6847,1100,74,9600,10700,"Sub-basin 4"
6848,100,2,1100,1200,"Sub-basin 4"
6849,1900,290,10400,12300,"Sub-basin 4"
6850,100,1,600,700,"Sub-basin 4"
6851,100,4,600,700,"Sub-basin 4"
6852,400,16,1700,2100,"Sub-basin 4"
6853,400,29,2000,2400,"Sub-basin 4"
6854,2200,343,9400,11600,"Sub-basin 4"
6855,1200,113,8500,9700,"Sub-basin 4"
6856,100,2,1500,1600,"Sub-basin 4"
6857,200,7,2600,2800,"Sub-basin 4"
6858,600,67.0039,4600,5200,"Sub-basin 4"
6859,100,1,600,700,"Sub-basin 4"
6860,100,1,400,500,"Sub-basin 4"
6861,300,14,2300,2600,"Sub-basin 4"
6862,600,54,3200,3800,"Sub-basin 4"
6863,100,1,1000,1100,"Sub-basin 4"
6864,1400,209,4900,6300,"Sub-basin 4"
6865,100,2,1300,1400,"Sub-basin 4"
6866,200,11,1900,2100,"Sub-basin 4"
6867,3100,632,4900,8000,"Sub-basin 4"
6868,500,24,4400,4900,"Sub-basin 4"
6869,100,4,700,800,"Sub-basin 4"
6870,300,16,2800,3100,"Sub-basin 4"
6871,1400,80,11400,12800,"Sub-basin 4"
6872,1200,51,5000,6200,"Sub-basin 4"
6873,100,3,1200,1300,"Sub-basin 4"
6874,400,13,5600,6000,"Sub-basin 4"
6875,1400,57,11600,13000,"Sub-basin 4"
6876,1900,219,10800,12700,"Sub-basin 4"
6877,900,86,2600,3500,"Sub-basin 4"
6878,100,2,500,600,"Sub-basin 4"
6879,400,122,1000,1400,"Sub-basin 4"
6880,400,34.0018,5100,5500,"Sub-basin 4"
6881,1900,150,9100,11000,"Sub-basin 4"
6882,200,17,1000,1200,"Sub-basin 4"
6883,6100,2612.83,13800,19900,"Sub-basin 4"
6884,127900,33214.32,186800,314700,"Sub-basin 4"
6885,200,20,2600,2800,"Sub-basin 4"
6886,100,4,1800,1900,"Sub-basin 4"
6887,1400,109,12400,13800,"Sub-basin 4"
6888,1200,137,11800,13000,"Sub-basin 4"
6889,600,51,3700,4300,"Sub-basin 4"
6890,800,54,7000,7800,"Sub-basin 4"
6891,300,5,1800,2100,"Sub-basin 4"
6892,5500,972,15500,21000,"Sub-basin 4"
6893,1000,174,7200,8200,"Sub-basin 4"
6894,2400,231,16600,19000,"Sub-basin 4"
6895,100,2,100,200,"Sub-basin 4"
6896,100,1,300,400,"Sub-basin 4"
6897,1700,530,5500,7200,"Sub-basin 4"
6898,200,17,3700,3900,"Sub-basin 4"
6899,400,14,2900,3300,"Sub-basin 4"
6900,6900,1942,9600,16500,"Sub-basin 4"
6901,800,181,2400,3200,"Sub-basin 4"
6902,11700,1221.535,40900,52600,"Sub-basin 4"
6903,500,31,3500,4000,"Sub-basin 4"
6904,1300,115,7300,8600,"Sub-basin 4"
6905,500,12,7300,7800,"Sub-basin 4"
6906,400,31,2100,2500,"Sub-basin 4"
6907,100,6,600,700,"Sub-basin 4"
6908,800,72,3600,4400,"Sub-basin 4"
6909,400,59,3100,3500,"Sub-basin 4"
6910,1300,265,5100,6400,"Sub-basin 4"
6911,1300,237,2200,3500,"Sub-basin 4"
6912,100,6.0003,1900,2000,"Sub-basin 4"
6913,100,1,100,200,"Sub-basin 4"
6914,100,1,1000,1100,"Sub-basin 4"
6915,1100,167,2200,3300,"Sub-basin 4"
6916,3700,378.0111,11300,15000,"Sub-basin 4"
6917,700,38.003,7000,7700,"Sub-basin 4"
6918,100,2.0003,1800,1900,"Sub-basin 4"
6919,200,5.0007,3900,4100,"Sub-basin 4"
6920,2400,353.0168,13600,16000,"Sub-basin 4"
6921,200,7.0008,1200,1400,"Sub-basin 4"
6922,14100,2635,24800,38900,"Sub-basin 4"
6923,200,22.0004,3200,3400,"Sub-basin 4"
6924,200,9,3200,3400,"Sub-basin 4"
6925,200,9,3000,3200,"Sub-basin 4"
6926,1600,283,9600,11200,"Sub-basin 4"
6927,13800,2010.1518,50500,64300,"Sub-basin 4"
6928,10200,4438,22600,32800,"Sub-basin 4"
6929,200,6,500,700,"Sub-basin 4"
6930,200,4.0007,2300,2500,"Sub-basin 4"
6931,100,1,400,500,"Sub-basin 4"
6932,100,1,1000,1100,"Sub-basin 4"
6933,200,4,1500,1700,"Sub-basin 4"
6934,400,27,2200,2600,"Sub-basin 4"
6935,600,156,4900,5500,"Sub-basin 4"
6936,100,2,600,700,"Sub-basin 4"
6937,400,28,1800,2200,"Sub-basin 4"
6938,1200,207,4400,5600,"Sub-basin 4"
6939,600,77,1900,2500,"Sub-basin 4"
6940,400,32,1200,1600,"Sub-basin 4"
6941,100,4,1000,1100,"Sub-basin 4"
6942,2300,690,1100,3400,"Sub-basin 4"
6943,100,1,1600,1700,"Sub-basin 4"
6944,2800,860,4900,7700,"Sub-basin 4"
6945,100,3,1300,1400,"Sub-basin 4"
6946,400,74,1100,1500,"Sub-basin 4"
6947,1200,150,2000,3200,"Sub-basin 4"
6948,100,2,400,500,"Sub-basin 4"
6949,900,120,2200,3100,"Sub-basin 4"
6950,100,3,700,800,"Sub-basin 4"
6951,100,8,400,500,"Sub-basin 4"
6952,2000,147,4000,6000,"Sub-basin 4"
6953,100,1,500,600,"Sub-basin 4"
6954,500,41,1200,1700,"Sub-basin 4"
6955,1600,384,3400,5000,"Sub-basin 4"
6956,1000,197,4300,5300,"Sub-basin 4"
6957,3500,3470,6200,9700,"Sub-basin 4"
6958,100,5,600,700,"Sub-basin 4"
6959,700,82,3600,4300,"Sub-basin 4"
6960,100,3,1400,1500,"Sub-basin 4"
6961,1000,121,3200,4200,"Sub-basin 4"
6962,400,133,1200,1600,"Sub-basin 4"
6963,800,155,2800,3600,"Sub-basin 4"
6964,300,23,800,1100,"Sub-basin 4"
6965,200,7,1500,1700,"Sub-basin 4"
6966,100,9,700,800,"Sub-basin 4"
6967,12300,4848,18300,30600,"Sub-basin 4"
6968,500,151,1800,2300,"Sub-basin 4"
6969,300,12,3300,3600,"Sub-basin 4"
6970,700,56,3700,4400,"Sub-basin 4"
6971,100,1,1300,1400,"Sub-basin 4"
6972,100,1,1000,1100,"Sub-basin 4"
6973,800,114,3500,4300,"Sub-basin 4"
6974,3300,910,8400,11700,"Sub-basin 4"
6975,100,3,500,600,"Sub-basin 4"
6976,13000,3713,22600,35600,"Sub-basin 4"
6977,1200,83,4300,5500,"Sub-basin 4"
6978,1400,356,6600,8000,"Sub-basin 4"
6979,100,4,900,1000,"Sub-basin 4"
6980,300,34.0011,3700,4000,"Sub-basin 4"
6981,600,44,5600,6200,"Sub-basin 4"
6982,700,81,2300,3000,"Sub-basin 4"
6983,100,2,700,800,"Sub-basin 4"
6984,400,18,2800,3200,"Sub-basin 4"
6985,100,6,1200,1300,"Sub-basin 4"
6986,200,4,1300,1500,"Sub-basin 4"
6987,600,38.004,7200,7800,"Sub-basin 4"
6988,1900,493,6600,8500,"Sub-basin 4"
6989,1100,144,3400,4500,"Sub-basin 4"
6990,700,62,6800,7500,"Sub-basin 4"
6991,200,4,2800,3000,"Sub-basin 4"
6992,100,4,900,1000,"Sub-basin 4"
6993,600,22.0022,5700,6300,"Sub-basin 4"
6994,600,42,3900,4500,"Sub-basin 4"
6995,2700,474,6200,8900,"Sub-basin 4"
6996,100,4,1300,1400,"Sub-basin 4"
6997,100,5,1200,1300,"Sub-basin 4"
6998,5500,1262,11000,16500,"Sub-basin 4"
6999,200,13,2200,2400,"Sub-basin 4"
7000,600,31,2300,2900,"Sub-basin 4"
7001,1200,215,4200,5400,"Sub-basin 4"
7002,100,2,700,800,"Sub-basin 4"
7003,100,1,1000,1100,"Sub-basin 4"
7004,1200,251,2900,4100,"Sub-basin 4"
7005,100,10,700,800,"Sub-basin 4"
7006,500,23,3700,4200,"Sub-basin 4"
7007,100,2,100,200,"Sub-basin 4"
7008,600,113,2900,3500,"Sub-basin 4"
7009,3100,487,16000,19100,"Sub-basin 4"
7010,1000,122,3500,4500,"Sub-basin 4"
7011,1300,164,7300,8600,"Sub-basin 4"
7012,100,16.0016,2000,2100,"Sub-basin 4"
7013,300,11,4500,4800,"Sub-basin 4"
7014,1100,122,3300,4400,"Sub-basin 4"
7015,1600,286,4800,6400,"Sub-basin 4"
7016,100,2,1900,2000,"Sub-basin 4"
7017,200,3,800,1000,"Sub-basin 4"
7018,100,3,700,800,"Sub-basin 4"
7019,1700,378,5100,6800,"Sub-basin 4"
7020,1200,228,2500,3700,"Sub-basin 4"
7021,100,1,800,900,"Sub-basin 4"
7022,11100,2761,35800,46900,"Sub-basin 4"
7023,2700,749,8600,11300,"Sub-basin 4"
7024,400,15.0035,5800,6200,"Sub-basin 4"
7025,4000,1581,5700,9700,"Sub-basin 4"
7026,11000,5064,13200,24200,"Sub-basin 4"
7027,100,3,400,500,"Sub-basin 4"
7028,100,1,600,700,"Sub-basin 4"
7029,400,27,800,1200,"Sub-basin 4"
7030,100,1,600,700,"Sub-basin 4"
7031,2600,452,4100,6700,"Sub-basin 4"
7032,300,11,2500,2800,"Sub-basin 4"
7033,700,101,5300,6000,"Sub-basin 4"
7034,400,25,2700,3100,"Sub-basin 4"
7035,400,30,1700,2100,"Sub-basin 4"
7036,400,46,1500,1900,"Sub-basin 4"
7037,600,33,3600,4200,"Sub-basin 4"
7038,1000,83,7300,8300,"Sub-basin 4"
7039,800,118,3000,3800,"Sub-basin 4"
7040,31500,8115,37700,69200,"Sub-basin 4"
7041,600,123,2900,3500,"Sub-basin 4"
7042,1100,86,5900,7000,"Sub-basin 4"
7043,600,28,2800,3400,"Sub-basin 4"
7044,300,10,1700,2000,"Sub-basin 4"
7045,700,153,2400,3100,"Sub-basin 4"
7046,1000,144,4100,5100,"Sub-basin 4"
7047,2000,552,4500,6500,"Sub-basin 4"
7048,400,41,2900,3300,"Sub-basin 4"
7049,600,59.0049,11800,12400,"Sub-basin 4"
7050,400,33,1900,2300,"Sub-basin 4"
7051,400,125,1500,1900,"Sub-basin 4"
7052,200,15,2200,2400,"Sub-basin 4"
7053,200,17,3000,3200,"Sub-basin 4"
7054,600,72,3900,4500,"Sub-basin 4"
7055,300,25,3300,3600,"Sub-basin 4"
7056,300,11,1900,2200,"Sub-basin 4"
7057,3900,333,21400,25300,"Sub-basin 4"
7058,200,18,4200,4400,"Sub-basin 4"
7059,4800,1695,6700,11500,"Sub-basin 4"
7060,3800,647,13100,16900,"Sub-basin 4"
7061,300,5,3200,3500,"Sub-basin 4"
7062,900,125,1800,2700,"Sub-basin 4"
7063,3300,426,9600,12900,"Sub-basin 4"
7064,200,12,900,1100,"Sub-basin 4"
7065,800,125,4300,5100,"Sub-basin 4"
7066,1100,102,2800,3900,"Sub-basin 4"
7067,400,34,3300,3700,"Sub-basin 4"
7068,1100,69,9000,10100,"Sub-basin 4"
7069,1600,390,4000,5600,"Sub-basin 4"
7070,600,76.004,7700,8300,"Sub-basin 4"
7071,500,41,2800,3300,"Sub-basin 4"
7072,100,6,1300,1400,"Sub-basin 4"
7073,300,4.67,1700,2000,"Sub-basin 4"
7074,400,36,3900,4300,"Sub-basin 4"
7075,800,56,11700,12500,"Sub-basin 4"
7076,200,6,1700,1900,"Sub-basin 4"
7077,400,31,2300,2700,"Sub-basin 4"
7078,2600,1301,9000,11600,"Sub-basin 4"
7079,100,3,700,800,"Sub-basin 4"
7080,100,2,1000,1100,"Sub-basin 4"
7081,100,3,1100,1200,"Sub-basin 4"
7082,800,122,5400,6200,"Sub-basin 4"
7083,1000,196,2000,3000,"Sub-basin 4"
7084,100,1,1100,1200,"Sub-basin 4"
7085,1400,241,6000,7400,"Sub-basin 4"
7086,100,1,200,300,"Sub-basin 4"
7087,400,85,1500,1900,"Sub-basin 4"
7088,600,117,1200,1800,"Sub-basin 4"
7089,400,30,1900,2300,"Sub-basin 4"
7090,20500,4121.1282,99000,119500,"Sub-basin 4"
7091,200,13,1200,1400,"Sub-basin 4"
7092,200,7,1800,2000,"Sub-basin 4"
7093,1000,108,5200,6200,"Sub-basin 4"
7094,25700,9229,20900,46600,"Sub-basin 4"
7095,100,1,1200,1300,"Sub-basin 4"
7096,400,21,1800,2200,"Sub-basin 4"
7097,400,48,2000,2400,"Sub-basin 4"
7098,400,18,2200,2600,"Sub-basin 4"
7099,100,3,1900,2000,"Sub-basin 4"
7100,100,2,2300,2400,"Sub-basin 4"
7101,100,3,1500,1600,"Sub-basin 4"
7102,200,2,3800,4000,"Sub-basin 4"
7103,2700,811,4400,7100,"Sub-basin 4"
7104,1700,369,4800,6500,"Sub-basin 4"
7105,3100,746,10900,14000,"Sub-basin 4"
7106,100,1,600,700,"Sub-basin 4"
7107,100,5,1300,1400,"Sub-basin 4"
7108,2400,490,5000,7400,"Sub-basin 4"
7109,5000,1158,11900,16900,"Sub-basin 4"
7110,100,1,500,600,"Sub-basin 4"
7111,2000,760,2600,4600,"Sub-basin 4"
7112,1000,171,5000,6000,"Sub-basin 4"
7113,400,11,5100,5500,"Sub-basin 4"
7114,500,38,4300,4800,"Sub-basin 4"
7115,400,53,1400,1800,"Sub-basin 4"
7116,600,27,3100,3700,"Sub-basin 4"
7117,1100,97.0047,8900,10000,"Sub-basin 4"
7118,1100,173,5900,7000,"Sub-basin 4"
7119,700,63,4500,5200,"Sub-basin 4"
7120,200,16.0009,1800,2000,"Sub-basin 4"
7121,200,3,1600,1800,"Sub-basin 4"
7122,1500,288,1000,2500,"Sub-basin 4"
7123,900,54,2200,3100,"Sub-basin 4"
7124,500,37,8400,8900,"Sub-basin 4"
7125,1200,101,7100,8300,"Sub-basin 4"
7126,200,7,800,1000,"Sub-basin 4"
7127,200,4,3100,3300,"Sub-basin 4"
7128,900,71.0087,10800,11700,"Sub-basin 4"
7129,100,2,1000,1100,"Sub-basin 4"
7130,1100,296,3200,4300,"Sub-basin 4"
7131,700,85,2000,2700,"Sub-basin 4"
7132,6200,1766,7000,13200,"Sub-basin 4"
7133,400,60,1600,2000,"Sub-basin 4"
7134,100,5,1600,1700,"Sub-basin 4"
7135,400,25,6200,6600,"Sub-basin 4"
7136,1800,107,8800,10600,"Sub-basin 4"
7137,200,9,900,1100,"Sub-basin 4"
7138,100,2,900,1000,"Sub-basin 4"
7139,400,15,6600,7000,"Sub-basin 4"
7140,1500,345,1800,3300,"Sub-basin 4"
7141,400,30,900,1300,"Sub-basin 4"
7142,2700,362,16100,18800,"Sub-basin 4"
7143,200,7,3200,3400,"Sub-basin 4"
7144,200,6,2800,3000,"Sub-basin 4"
7145,100,1,700,800,"Sub-basin 4"
7146,100,2,600,700,"Sub-basin 4"
7147,1200,96,1300,2500,"Sub-basin 4"
7148,700,112,2200,2900,"Sub-basin 4"
7149,2900,1052.33,7500,10400,"Sub-basin 4"
7150,200,16.001,3200,3400,"Sub-basin 4"
7151,400,7,4500,4900,"Sub-basin 4"
7152,200,5,3200,3400,"Sub-basin 4"
7153,1100,236,1200,2300,"Sub-basin 4"
7154,400,64,500,900,"Sub-basin 4"
7155,200,8,700,900,"Sub-basin 4"
7156,400,18,4200,4600,"Sub-basin 4"
7157,600,91,1600,2200,"Sub-basin 4"
7158,900,59,6500,7400,"Sub-basin 4"
7159,400,33,5300,5700,"Sub-basin 4"
7160,1200,502,1100,2300,"Sub-basin 4"
7161,400,32,500,900,"Sub-basin 4"
7162,1400,335,4500,5900,"Sub-basin 4"
7163,200,9,3000,3200,"Sub-basin 4"
7164,1400,162.0229,19600,21000,"Sub-basin 4"
7165,200,2,3900,4100,"Sub-basin 4"
7166,3500,566,8400,11900,"Sub-basin 4"
7167,800,128,2800,3600,"Sub-basin 4"
7168,200,4,1800,2000,"Sub-basin 4"
7169,900,97,4900,5800,"Sub-basin 4"
7170,1100,82,11200,12300,"Sub-basin 4"
7171,800,89,1600,2400,"Sub-basin 4"
7172,100,3,1900,2000,"Sub-basin 4"
7173,700,37,5400,6100,"Sub-basin 4"
7174,100,6,900,1000,"Sub-basin 4"
7175,400,64,2200,2600,"Sub-basin 4"
7176,100,3,2800,2900,"Sub-basin 4"
7177,400,25,5900,6300,"Sub-basin 4"
7178,2400,406,5400,7800,"Sub-basin 4"
7179,100,14,2200,2300,"Sub-basin 4"
7180,500,53,4100,4600,"Sub-basin 4"
7181,1700,89,8000,9700,"Sub-basin 4"
7182,700,58,7300,8000,"Sub-basin 4"
7183,600,41,5700,6300,"Sub-basin 4"
7184,100,3,1900,2000,"Sub-basin 4"
7185,300,17,400,700,"Sub-basin 4"
7186,100,6,2300,2400,"Sub-basin 4"
7187,2800,372.33,6800,9600,"Sub-basin 4"
7188,400,38,2800,3200,"Sub-basin 4"
7189,600,67,3900,4500,"Sub-basin 4"
7190,1200,62,7800,9000,"Sub-basin 4"
7191,200,5,1100,1300,"Sub-basin 4"
7192,400,19,2500,2900,"Sub-basin 4"
7193,400,19,1900,2300,"Sub-basin 4"
7194,500,15,6000,6500,"Sub-basin 4"
7195,3200,852,5100,8300,"Sub-basin 4"
7196,100,11,900,1000,"Sub-basin 4"
7197,100,1,1300,1400,"Sub-basin 4"
7198,100,1,1600,1700,"Sub-basin 4"
7199,900,128.0088,12200,13100,"Sub-basin 4"
7200,5700,801,19800,25500,"Sub-basin 4"
7201,600,41,3600,4200,"Sub-basin 4"
7202,17300,7722.67,23000,40300,"Sub-basin 4"
7203,300,9,2900,3200,"Sub-basin 4"
7204,700,58,4300,5000,"Sub-basin 4"
7205,1500,104,10700,12200,"Sub-basin 4"
7206,200,7,3000,3200,"Sub-basin 4"
7207,300,10,3400,3700,"Sub-basin 4"
7208,1200,99,4600,5800,"Sub-basin 4"
7209,100,1,900,1000,"Sub-basin 4"
7210,600,46.67,3100,3700,"Sub-basin 4"
7211,700,47,1000,1700,"Sub-basin 4"
7212,1400,316,2200,3600,"Sub-basin 4"
7213,400,40,3300,3700,"Sub-basin 4"
7214,1600,284,2900,4500,"Sub-basin 4"
7215,1100,191,600,1700,"Sub-basin 4"
7216,200,5,2400,2600,"Sub-basin 4"
7217,100,4,1300,1400,"Sub-basin 4"
7218,200,9,700,900,"Sub-basin 4"
7219,100,1,1100,1200,"Sub-basin 4"
7220,2700,418,8900,11600,"Sub-basin 4"
7221,2400,253,25400,27800,"Sub-basin 4"
7222,100,1,700,800,"Sub-basin 4"
7223,200,6.0042,4100,4300,"Sub-basin 4"
7224,1700,254,2900,4600,"Sub-basin 4"
7225,6300,2060,5600,11900,"Sub-basin 4"
7226,100,1,800,900,"Sub-basin 4"
7227,1400,93.17,8000,9400,"Sub-basin 4"
7228,500,44,1400,1900,"Sub-basin 4"
7229,1800,615,2400,4200,"Sub-basin 4"
7230,1300,78,6800,8100,"Sub-basin 4"
7231,500,25,5300,5800,"Sub-basin 4"
7232,1600,208.0166,18400,20000,"Sub-basin 4"
7233,200,17,2800,3000,"Sub-basin 4"
7234,700,58,2200,2900,"Sub-basin 4"
7235,600,57,1900,2500,"Sub-basin 4"
7236,1400,182,6300,7700,"Sub-basin 4"
7237,5000,1157,5300,10300,"Sub-basin 4"
7238,7800,2631.16,9900,17700,"Sub-basin 4"
7239,1700,130,7300,9000,"Sub-basin 4"
7240,100,3,1500,1600,"Sub-basin 4"
7241,100,4,1000,1100,"Sub-basin 4"
7242,1000,49,8900,9900,"Sub-basin 4"
7243,1200,85,3200,4400,"Sub-basin 4"
7244,400,16,1700,2100,"Sub-basin 4"
7245,1200,108,5300,6500,"Sub-basin 4"
7246,100,1,1500,1600,"Sub-basin 4"
7247,100,4,1200,1300,"Sub-basin 4"
7248,1100,49,7300,8400,"Sub-basin 4"
7249,300,14,3300,3600,"Sub-basin 4"
7250,300,15,1800,2100,"Sub-basin 4"
7251,1500,236,1700,3200,"Sub-basin 4"
7252,100,4,1100,1200,"Sub-basin 4"
7253,200,3,1000,1200,"Sub-basin 4"
7254,1100,128,2900,4000,"Sub-basin 4"
7255,100,6,1200,1300,"Sub-basin 4"
7256,100,1,1300,1400,"Sub-basin 4"
7257,600,50,3700,4300,"Sub-basin 4"
7258,300,13,2900,3200,"Sub-basin 4"
7259,400,26,1700,2100,"Sub-basin 4"
7260,1200,182,12700,13900,"Sub-basin 4"
7261,3100,355.0674,22600,25700,"Sub-basin 4"
7262,300,22,2100,2400,"Sub-basin 4"
7263,9500,1394,26600,36100,"Sub-basin 4"
7264,900,227,1400,2300,"Sub-basin 4"
7265,100,2,1400,1500,"Sub-basin 4"
7266,300,12,3300,3600,"Sub-basin 4"
7267,1200,132,7200,8400,"Sub-basin 4"
7268,200,11,2500,2700,"Sub-basin 4"
7269,100,2,800,900,"Sub-basin 4"
7270,200,16,900,1100,"Sub-basin 4"
7271,300,15,1800,2100,"Sub-basin 4"
7272,500,23,3200,3700,"Sub-basin 4"
7273,100,1,700,800,"Sub-basin 4"
7274,200,8,1500,1700,"Sub-basin 4"
7275,900,67,5500,6400,"Sub-basin 4"
7276,2300,218,11900,14200,"Sub-basin 4"
7277,700,82,2100,2800,"Sub-basin 4"
7278,200,5,2200,2400,"Sub-basin 4"
7279,400,20,3600,4000,"Sub-basin 4"
7280,200,14,300,500,"Sub-basin 4"
7281,200,4,0,200,"Sub-basin 4"
7282,100,3,800,900,"Sub-basin 4"
7283,200,6,1200,1400,"Sub-basin 4"
7284,100,1,1500,1600,"Sub-basin 4"
7285,200,9,900,1100,"Sub-basin 4"
7286,400,23,3400,3800,"Sub-basin 4"
7287,100,2,1600,1700,"Sub-basin 4"
7288,100,2,1100,1200,"Sub-basin 4"
7289,1200,180,3200,4400,"Sub-basin 4"
7290,1500,281,11400,12900,"Sub-basin 4"
7291,200,6,1200,1400,"Sub-basin 4"
7292,200,13,1500,1700,"Sub-basin 4"
7293,100,2,700,800,"Sub-basin 4"
7294,200,11,1400,1600,"Sub-basin 4"
7295,300,13,1400,1700,"Sub-basin 4"
7296,4500,650.0787,25200,29700,"Sub-basin 4"
7297,200,4,600,800,"Sub-basin 4"
7298,1900,438.0217,17700,19600,"Sub-basin 4"
7299,400,33.0099,5000,5400,"Sub-basin 4"
7300,100,1,1300,1400,"Sub-basin 4"
7301,6400,3544,5700,12100,"Sub-basin 4"
7302,2600,482,6500,9100,"Sub-basin 4"
7303,5800,2436,5600,11400,"Sub-basin 4"
7304,2100,271,8500,10600,"Sub-basin 4"
7305,6600,1752,11300,17900,"Sub-basin 4"
7306,1700,463,4900,6600,"Sub-basin 4"
7307,200,7.0012,1400,1600,"Sub-basin 4"
7308,200,3,200,400,"Sub-basin 4"
7309,800,71.0184,5800,6600,"Sub-basin 4"
7310,2500,663,6700,9200,"Sub-basin 4"
7311,700,39,2600,3300,"Sub-basin 4"
7312,400,26,2200,2600,"Sub-basin 4"
7313,800,85,3200,4000,"Sub-basin 4"
7314,400,41.0033,4500,4900,"Sub-basin 4"
7315,100,3.0005,1200,1300,"Sub-basin 4"
7316,1600,180.0177,7500,9100,"Sub-basin 4"
7317,1700,375,5700,7400,"Sub-basin 4"
7318,300,13.0013,2600,2900,"Sub-basin 4"
7319,600,155,2000,2600,"Sub-basin 4"
7320,200,8.0026,2300,2500,"Sub-basin 4"
7321,100,5.0005,1500,1600,"Sub-basin 4"
7322,2500,744,7100,9600,"Sub-basin 4"
7323,100,2.0005,1400,1500,"Sub-basin 4"
7324,300,26.0014,4000,4300,"Sub-basin 4"
7325,1000,186,2600,3600,"Sub-basin 4"
7326,400,14.0019,3200,3600,"Sub-basin 4"
1,1900,411,700,2600,"Sub-basin 5"
2,1000,154,2100,3100,"Sub-basin 5"
3,400,65,500,900,"Sub-basin 5"
4,600,74,1400,2000,"Sub-basin 5"
5,1700,527,3100,4800,"Sub-basin 5"
6,500,24,1400,1900,"Sub-basin 5"
7,1200,232,3500,4700,"Sub-basin 5"
8,1000,144,2500,3500,"Sub-basin 5"
9,3000,439.17,4300,7300,"Sub-basin 5"
10,800,228,1600,2400,"Sub-basin 5"
11,1000,154,800,1800,"Sub-basin 5"
12,200,10,1600,1800,"Sub-basin 5"
13,8800,3260,18000,26800,"Sub-basin 5"
14,3400,1065,5300,8700,"Sub-basin 5"
15,400,12,1400,1800,"Sub-basin 5"
16,500,28,1600,2100,"Sub-basin 5"
17,9300,3828,10900,20200,"Sub-basin 5"
18,1100,189,2200,3300,"Sub-basin 5"
19,5900,1389,12500,18400,"Sub-basin 5"
20,600,95,600,1200,"Sub-basin 5"
21,300,10,2100,2400,"Sub-basin 5"
22,1100,135,2600,3700,"Sub-basin 5"
23,100,4,800,900,"Sub-basin 5"
24,1500,106,5400,6900,"Sub-basin 5"
25,2200,345,7000,9200,"Sub-basin 5"
26,1000,233,800,1800,"Sub-basin 5"
27,1000,159,2100,3100,"Sub-basin 5"
28,3900,804.5,8700,12600,"Sub-basin 5"
29,1600,547,3800,5400,"Sub-basin 5"
30,1600,716,4100,5700,"Sub-basin 5"
31,800,116,2300,3100,"Sub-basin 5"
32,1500,178,5000,6500,"Sub-basin 5"
33,500,42,1200,1700,"Sub-basin 5"
34,200,7,100,300,"Sub-basin 5"
35,400,47,1900,2300,"Sub-basin 5"
36,1900,496,4600,6500,"Sub-basin 5"
37,6100,3332,10000,16100,"Sub-basin 5"
38,300,33,1800,2100,"Sub-basin 5"
39,1700,161,6800,8500,"Sub-basin 5"
40,2600,884,4000,6600,"Sub-basin 5"
41,11100,2521,20800,31900,"Sub-basin 5"
42,900,282,2100,3000,"Sub-basin 5"
43,5700,1226,16600,22300,"Sub-basin 5"
44,300,25,2200,2500,"Sub-basin 5"
45,6400,1360.51,8400,14800,"Sub-basin 5"
46,600,126,2400,3000,"Sub-basin 5"
47,1400,142,3700,5100,"Sub-basin 5"
48,7100,1858,8700,15800,"Sub-basin 5"
49,300,6,2400,2700,"Sub-basin 5"
50,1500,353,2000,3500,"Sub-basin 5"
51,1000,56,3600,4600,"Sub-basin 5"
52,4000,962,7500,11500,"Sub-basin 5"
53,100,1,1200,1300,"Sub-basin 5"
54,1100,311,1700,2800,"Sub-basin 5"
55,1100,244,2200,3300,"Sub-basin 5"
56,1000,234,4000,5000,"Sub-basin 5"
57,100,3,1100,1200,"Sub-basin 5"
58,200,10,2200,2400,"Sub-basin 5"
59,400,37,2300,2700,"Sub-basin 5"
60,200,5,600,800,"Sub-basin 5"
61,800,94,1600,2400,"Sub-basin 5"
62,200,4,400,600,"Sub-basin 5"
63,1100,218,2900,4000,"Sub-basin 5"
64,900,176,2700,3600,"Sub-basin 5"
65,1700,272,5200,6900,"Sub-basin 5"
66,500,110,2200,2700,"Sub-basin 5"
67,200,3,2800,3000,"Sub-basin 5"
68,1300,363,4200,5500,"Sub-basin 5"
69,4500,1226,7000,11500,"Sub-basin 5"
70,600,70,1500,2100,"Sub-basin 5"
71,300,18,1900,2200,"Sub-basin 5"
72,200,3,600,800,"Sub-basin 5"
73,500,27,3300,3800,"Sub-basin 5"
74,300,13,800,1100,"Sub-basin 5"
75,1100,287,1900,3000,"Sub-basin 5"
76,1600,283,12600,14200,"Sub-basin 5"
77,400,44,800,1200,"Sub-basin 5"
78,200,6,1700,1900,"Sub-basin 5"
79,11200,3574,19200,30400,"Sub-basin 5"
80,6800,2367,6400,13200,"Sub-basin 5"
81,3000,231,8400,11400,"Sub-basin 5"
82,200,11,1400,1600,"Sub-basin 5"
83,900,213,4600,5500,"Sub-basin 5"
84,1100,133,5700,6800,"Sub-basin 5"
85,900,84,2800,3700,"Sub-basin 5"
86,500,93,1400,1900,"Sub-basin 5"
87,1500,589,2800,4300,"Sub-basin 5"
88,700,132,1400,2100,"Sub-basin 5"
89,500,45,1100,1600,"Sub-basin 5"
90,4600,1142,10900,15500,"Sub-basin 5"
91,1000,88,3000,4000,"Sub-basin 5"
92,1700,452,7200,8900,"Sub-basin 5"
93,1800,405,3900,5700,"Sub-basin 5"
94,1500,417,1900,3400,"Sub-basin 5"
95,1300,132,5900,7200,"Sub-basin 5"
96,400,43,2000,2400,"Sub-basin 5"
97,200,7,400,600,"Sub-basin 5"
98,3400,1114,7400,10800,"Sub-basin 5"
99,700,32,2600,3300,"Sub-basin 5"
100,100,1,600,700,"Sub-basin 5"
101,5200,2060,6700,11900,"Sub-basin 5"
102,300,23,3000,3300,"Sub-basin 5"
103,1300,191,3700,5000,"Sub-basin 5"
104,8200,2334,10000,18200,"Sub-basin 5"
105,800,141,2300,3100,"Sub-basin 5"
106,200,28,1200,1400,"Sub-basin 5"
107,4800,1350,7200,12000,"Sub-basin 5"
108,900,116,1800,2700,"Sub-basin 5"
109,400,24,2400,2800,"Sub-basin 5"
110,300,16,1800,2100,"Sub-basin 5"
111,200,12,1500,1700,"Sub-basin 5"
112,600,27,2400,3000,"Sub-basin 5"
113,400,27,1400,1800,"Sub-basin 5"
114,500,71,1600,2100,"Sub-basin 5"
115,600,110,1500,2100,"Sub-basin 5"
116,400,12,2000,2400,"Sub-basin 5"
117,600,127,2900,3500,"Sub-basin 5"
118,200,19,1400,1600,"Sub-basin 5"
119,2300,511,4500,6800,"Sub-basin 5"
120,1300,158,4900,6200,"Sub-basin 5"
121,1700,303,5800,7500,"Sub-basin 5"
122,300,24,1500,1800,"Sub-basin 5"
123,6400,1887,8400,14800,"Sub-basin 5"
124,700,200,1600,2300,"Sub-basin 5"
125,6600,1807,15800,22400,"Sub-basin 5"
126,400,23,1000,1400,"Sub-basin 5"
127,100,5,700,800,"Sub-basin 5"
128,5800,1830,13200,19000,"Sub-basin 5"
129,100,1,1000,1100,"Sub-basin 5"
130,400,34,2000,2400,"Sub-basin 5"
131,400,9,2600,3000,"Sub-basin 5"
132,200,7,2200,2400,"Sub-basin 5"
133,1100,125,5400,6500,"Sub-basin 5"
134,34300,12247.17,50100,84400,"Sub-basin 5"
135,1600,512,6500,8100,"Sub-basin 5"
136,500,22,3300,3800,"Sub-basin 5"
137,2400,526,7200,9600,"Sub-basin 5"
138,1300,230,1700,3000,"Sub-basin 5"
139,1300,159,3100,4400,"Sub-basin 5"
140,700,23,2900,3600,"Sub-basin 5"
141,600,119,2700,3300,"Sub-basin 5"
142,200,11,1500,1700,"Sub-basin 5"
143,100,10,1300,1400,"Sub-basin 5"
144,200,6,2400,2600,"Sub-basin 5"
145,3800,1655,6400,10200,"Sub-basin 5"
146,1300,219,7900,9200,"Sub-basin 5"
147,200,13,1900,2100,"Sub-basin 5"
148,3200,627,10100,13300,"Sub-basin 5"
149,300,42,2000,2300,"Sub-basin 5"
150,400,75,3300,3700,"Sub-basin 5"
151,5300,2221,7500,12800,"Sub-basin 5"
152,3200,604,8500,11700,"Sub-basin 5"
153,5800,1968,9400,15200,"Sub-basin 5"
154,13300,1641,59400,72700,"Sub-basin 5"
155,900,127,4100,5000,"Sub-basin 5"
156,900,91,2700,3600,"Sub-basin 5"
157,2100,583,4800,6900,"Sub-basin 5"
158,3100,636.16,5200,8300,"Sub-basin 5"
159,600,33,3300,3900,"Sub-basin 5"
160,200,20,1100,1300,"Sub-basin 5"
161,100,13,900,1000,"Sub-basin 5"
162,1100,448,3800,4900,"Sub-basin 5"
163,400,33,2600,3000,"Sub-basin 5"
164,800,132,1600,2400,"Sub-basin 5"
165,100,2,1600,1700,"Sub-basin 5"
166,700,15,6500,7200,"Sub-basin 5"
167,200,19,1300,1500,"Sub-basin 5"
168,1400,71,4600,6000,"Sub-basin 5"
169,100,2,800,900,"Sub-basin 5"
170,1200,282,2500,3700,"Sub-basin 5"
171,200,28,1500,1700,"Sub-basin 5"
172,1000,110,4600,5600,"Sub-basin 5"
173,5000,1456,12900,17900,"Sub-basin 5"
174,200,3,1000,1200,"Sub-basin 5"
175,500,79,2300,2800,"Sub-basin 5"
176,1200,391,5100,6300,"Sub-basin 5"
177,1600,538,3100,4700,"Sub-basin 5"
178,17800,5685.82,18800,36600,"Sub-basin 5"
179,3100,346,9100,12200,"Sub-basin 5"
180,400,11,1100,1500,"Sub-basin 5"
181,100,1,1100,1200,"Sub-basin 5"
182,500,18,3300,3800,"Sub-basin 5"
183,200,7,800,1000,"Sub-basin 5"
184,40300,16741.84,55900,96200,"Sub-basin 5"
185,300,19,1100,1400,"Sub-basin 5"
186,500,11,1300,1800,"Sub-basin 5"
187,100,1,900,1000,"Sub-basin 5"
188,2900,825,5300,8200,"Sub-basin 5"
189,4000,944,12100,16100,"Sub-basin 5"
190,9700,3442,14000,23700,"Sub-basin 5"
191,700,75,4500,5200,"Sub-basin 5"
192,2500,661,6900,9400,"Sub-basin 5"
193,100,3,1200,1300,"Sub-basin 5"
194,1600,159,4800,6400,"Sub-basin 5"
195,3000,446,8500,11500,"Sub-basin 5"
196,6100,1909.16,11500,17600,"Sub-basin 5"
197,2600,677,6300,8900,"Sub-basin 5"
198,600,84,2100,2700,"Sub-basin 5"
199,500,37,4500,5000,"Sub-basin 5"
200,1000,134,3200,4200,"Sub-basin 5"
201,500,80,2400,2900,"Sub-basin 5"
202,1300,231,3000,4300,"Sub-basin 5"
203,100,3,1700,1800,"Sub-basin 5"
204,3000,1453,4400,7400,"Sub-basin 5"
205,200,22,600,800,"Sub-basin 5"
206,200,5,1100,1300,"Sub-basin 5"
207,8800,2650,14600,23400,"Sub-basin 5"
208,400,41,2200,2600,"Sub-basin 5"
209,500,43,1700,2200,"Sub-basin 5"
210,100,1,900,1000,"Sub-basin 5"
211,100,1,400,500,"Sub-basin 5"
212,300,4,900,1200,"Sub-basin 5"
213,200,2,1900,2100,"Sub-basin 5"
214,200,9,1900,2100,"Sub-basin 5"
215,9700,5115.66,7200,16900,"Sub-basin 5"
216,500,51,5200,5700,"Sub-basin 5"
217,6800,1788.65,19900,26700,"Sub-basin 5"
218,3100,793.5,14200,17300,"Sub-basin 5"
219,100,2,1100,1200,"Sub-basin 5"
220,100,7,900,1000,"Sub-basin 5"
221,1900,627.33,4700,6600,"Sub-basin 5"
222,1100,168,5200,6300,"Sub-basin 5"
223,900,141,6300,7200,"Sub-basin 5"
224,4000,718.33,17000,21000,"Sub-basin 5"
225,2000,648.5,4700,6700,"Sub-basin 5"
226,41600,21469.49,31000,72600,"Sub-basin 5"
227,400,25,2600,3000,"Sub-basin 5"
228,400,60,1500,1900,"Sub-basin 5"
229,400,34,3200,3600,"Sub-basin 5"
230,1600,323,4700,6300,"Sub-basin 5"
231,200,9,600,800,"Sub-basin 5"
232,200,10,2300,2500,"Sub-basin 5"
233,1300,311,3700,5000,"Sub-basin 5"
234,1900,725,2700,4600,"Sub-basin 5"
235,200,8,1000,1200,"Sub-basin 5"
236,3200,674,11100,14300,"Sub-basin 5"
237,100,2,800,900,"Sub-basin 5"
238,200,12,2600,2800,"Sub-basin 5"
239,500,107,1400,1900,"Sub-basin 5"
240,300,28,3200,3500,"Sub-basin 5"
241,600,75,1900,2500,"Sub-basin 5"
242,400,14,3300,3700,"Sub-basin 5"
243,200,21,2100,2300,"Sub-basin 5"
244,600,34,4100,4700,"Sub-basin 5"
245,1400,404,4400,5800,"Sub-basin 5"
246,600,173,1700,2300,"Sub-basin 5"
247,1800,239,3900,5700,"Sub-basin 5"
248,1000,89,4200,5200,"Sub-basin 5"
249,900,29,1600,2500,"Sub-basin 5"
250,300,16,600,900,"Sub-basin 5"
251,600,85,1600,2200,"Sub-basin 5"
252,600,125,1000,1600,"Sub-basin 5"
253,1500,515,3400,4900,"Sub-basin 5"
254,3300,923,7000,10300,"Sub-basin 5"
255,100,2,300,400,"Sub-basin 5"
256,1800,460,4800,6600,"Sub-basin 5"
257,600,19,2300,2900,"Sub-basin 5"
258,800,279,2600,3400,"Sub-basin 5"
259,100,2,1600,1700,"Sub-basin 5"
260,3500,518,12500,16000,"Sub-basin 5"
261,1900,582,8000,9900,"Sub-basin 5"
262,300,17,1900,2200,"Sub-basin 5"
263,6200,1853.83,10800,17000,"Sub-basin 5"
264,1100,67,4400,5500,"Sub-basin 5"
265,200,5,2800,3000,"Sub-basin 5"
266,1500,159,3100,4600,"Sub-basin 5"
267,2200,469,7600,9800,"Sub-basin 5"
268,700,94,2200,2900,"Sub-basin 5"
269,200,7,1600,1800,"Sub-basin 5"
270,1500,244,4200,5700,"Sub-basin 5"
271,2000,614,5700,7700,"Sub-basin 5"
272,600,197,3600,4200,"Sub-basin 5"
273,500,54,3000,3500,"Sub-basin 5"
274,3300,522,11600,14900,"Sub-basin 5"
275,3200,848,12900,16100,"Sub-basin 5"
276,300,11,4500,4800,"Sub-basin 5"
277,200,3,1900,2100,"Sub-basin 5"
278,600,88,1700,2300,"Sub-basin 5"
279,700,51,3800,4500,"Sub-basin 5"
280,800,78,3600,4400,"Sub-basin 5"
281,400,20,4600,5000,"Sub-basin 5"
282,700,108,1300,2000,"Sub-basin 5"
283,500,36,2400,2900,"Sub-basin 5"
284,700,118,1400,2100,"Sub-basin 5"
285,2300,252,6700,9000,"Sub-basin 5"
286,900,149,3900,4800,"Sub-basin 5"
287,6300,1125,10000,16300,"Sub-basin 5"
288,2000,271,4900,6900,"Sub-basin 5"
289,210800,78813.34,146800,357600,"Sub-basin 5"
290,300,12,1500,1800,"Sub-basin 5"
291,3900,368,11300,15200,"Sub-basin 5"
292,1200,206,3200,4400,"Sub-basin 5"
293,1600,452,1800,3400,"Sub-basin 5"
294,300,17,700,1000,"Sub-basin 5"
295,700,57,4300,5000,"Sub-basin 5"
296,200,8,600,800,"Sub-basin 5"
297,700,17,3200,3900,"Sub-basin 5"
298,500,49,1900,2400,"Sub-basin 5"
299,700,137,2300,3000,"Sub-basin 5"
300,200,13,2200,2400,"Sub-basin 5"
301,400,51,3800,4200,"Sub-basin 5"
302,29100,13899,14800,43900,"Sub-basin 5"
303,100,2,1800,1900,"Sub-basin 5"
304,1000,120,2600,3600,"Sub-basin 5"
305,2300,440,3900,6200,"Sub-basin 5"
306,7800,3377,7400,15200,"Sub-basin 5"
307,800,129,1900,2700,"Sub-basin 5"
308,400,40,1100,1500,"Sub-basin 5"
309,100,4,100,200,"Sub-basin 5"
310,2500,785,6600,9100,"Sub-basin 5"
311,1100,75,1800,2900,"Sub-basin 5"
312,10000,2654,12500,22500,"Sub-basin 5"
313,100,1,1500,1600,"Sub-basin 5"
314,500,55,1300,1800,"Sub-basin 5"
315,69000,16401,123000,192000,"Sub-basin 5"
316,500,49,3500,4000,"Sub-basin 5"
317,1000,123,2400,3400,"Sub-basin 5"
318,1000,87,4400,5400,"Sub-basin 5"
319,500,42,3300,3800,"Sub-basin 5"
320,100,2,1000,1100,"Sub-basin 5"
321,400,15,1600,2000,"Sub-basin 5"
322,8800,2682,15500,24300,"Sub-basin 5"
323,100,2,200,300,"Sub-basin 5"
324,1600,451,9300,10900,"Sub-basin 5"
325,800,340,1900,2700,"Sub-basin 5"
326,200,7,1400,1600,"Sub-basin 5"
327,1100,175,4300,5400,"Sub-basin 5"
328,200,14,1200,1400,"Sub-basin 5"
329,100,1,1200,1300,"Sub-basin 5"
330,500,16,1100,1600,"Sub-basin 5"
331,400,12,1000,1400,"Sub-basin 5"
332,100,1,300,400,"Sub-basin 5"
333,4800,719,13900,18700,"Sub-basin 5"
334,100,2,900,1000,"Sub-basin 5"
335,400,22,2000,2400,"Sub-basin 5"
336,900,163,2000,2900,"Sub-basin 5"
337,5000,1780,7700,12700,"Sub-basin 5"
338,800,154,1400,2200,"Sub-basin 5"
339,700,164,1900,2600,"Sub-basin 5"
340,13700,4007,20700,34400,"Sub-basin 5"
341,1500,581,4200,5700,"Sub-basin 5"
342,2400,433,2200,4600,"Sub-basin 5"
343,600,68,2900,3500,"Sub-basin 5"
344,100,2,0,100,"Sub-basin 5"
345,300,19,2100,2400,"Sub-basin 5"
346,1400,132,6600,8000,"Sub-basin 5"
347,1000,160,2900,3900,"Sub-basin 5"
348,100,1,1500,1600,"Sub-basin 5"
349,700,161,2200,2900,"Sub-basin 5"
350,100,3,900,1000,"Sub-basin 5"
351,200,14,1600,1800,"Sub-basin 5"
352,3300,492,6900,10200,"Sub-basin 5"
353,300,12,800,1100,"Sub-basin 5"
354,400,12,1800,2200,"Sub-basin 5"
355,1500,347,6200,7700,"Sub-basin 5"
356,200,5,2100,2300,"Sub-basin 5"
357,2100,281,6300,8400,"Sub-basin 5"
358,1800,364,5500,7300,"Sub-basin 5"
359,7600,3009,5200,12800,"Sub-basin 5"
360,18400,5813,26600,45000,"Sub-basin 5"
361,200,3,500,700,"Sub-basin 5"
362,100,1,1000,1100,"Sub-basin 5"
363,100,4,300,400,"Sub-basin 5"
364,1300,260,5900,7200,"Sub-basin 5"
365,3800,515,17200,21000,"Sub-basin 5"
366,500,57,2200,2700,"Sub-basin 5"
367,100,1,1400,1500,"Sub-basin 5"
368,1500,257,4500,6000,"Sub-basin 5"
369,200,7,700,900,"Sub-basin 5"
370,4500,1181,8200,12700,"Sub-basin 5"
371,600,47,1600,2200,"Sub-basin 5"
372,200,16,1800,2000,"Sub-basin 5"
373,800,126,2000,2800,"Sub-basin 5"
374,800,64,1700,2500,"Sub-basin 5"
375,2600,613,8200,10800,"Sub-basin 5"
376,9900,3025,13700,23600,"Sub-basin 5"
377,300,10,2700,3000,"Sub-basin 5"
378,36800,11129.33,37200,74000,"Sub-basin 5"
379,1000,59,5200,6200,"Sub-basin 5"
380,100,1,400,500,"Sub-basin 5"
381,1400,489,3000,4400,"Sub-basin 5"
382,600,84,2400,3000,"Sub-basin 5"
383,3400,565,10600,14000,"Sub-basin 5"
384,100,1,1200,1300,"Sub-basin 5"
385,5700,823,18000,23700,"Sub-basin 5"
386,300,8,400,700,"Sub-basin 5"
387,100,2,1400,1500,"Sub-basin 5"
388,10300,4008,10800,21100,"Sub-basin 5"
389,200,11,1200,1400,"Sub-basin 5"
390,700,138,1800,2500,"Sub-basin 5"
391,300,12,1200,1500,"Sub-basin 5"
392,300,28,1800,2100,"Sub-basin 5"
393,10600,3904.67,10700,21300,"Sub-basin 5"
394,3800,837,10700,14500,"Sub-basin 5"
395,700,26,2900,3600,"Sub-basin 5"
396,3100,284,16200,19300,"Sub-basin 5"
397,1900,751,4000,5900,"Sub-basin 5"
398,100,4,200,300,"Sub-basin 5"
399,2300,1212,5200,7500,"Sub-basin 5"
400,1700,605,2400,4100,"Sub-basin 5"
401,700,146,2400,3100,"Sub-basin 5"
402,200,25,1200,1400,"Sub-basin 5"
403,200,2,1400,1600,"Sub-basin 5"
404,100,2,700,800,"Sub-basin 5"
405,600,49,1100,1700,"Sub-basin 5"
406,2100,1701,9100,11200,"Sub-basin 5"
407,2400,1000,5900,8300,"Sub-basin 5"
408,1700,391,4400,6100,"Sub-basin 5"
409,2700,724,7100,9800,"Sub-basin 5"
410,10200,1286,28800,39000,"Sub-basin 5"
411,400,56,1100,1500,"Sub-basin 5"
412,1100,281,4600,5700,"Sub-basin 5"
413,2600,400,5400,8000,"Sub-basin 5"
414,500,45,1500,2000,"Sub-basin 5"
415,600,164,3200,3800,"Sub-basin 5"
416,900,61,3100,4000,"Sub-basin 5"
417,400,10,2000,2400,"Sub-basin 5"
418,400,12,3100,3500,"Sub-basin 5"
419,100,1,0,100,"Sub-basin 5"
420,100,2,1100,1200,"Sub-basin 5"
421,1700,397,4100,5800,"Sub-basin 5"
422,100,3,1700,1800,"Sub-basin 5"
423,1400,115,5500,6900,"Sub-basin 5"
424,900,256,2700,3600,"Sub-basin 5"
425,800,155,3100,3900,"Sub-basin 5"
426,400,11,1500,1900,"Sub-basin 5"
427,100,2,1000,1100,"Sub-basin 5"
428,300,4,1800,2100,"Sub-basin 5"
429,3500,343,13100,16600,"Sub-basin 5"
430,2200,588,2600,4800,"Sub-basin 5"
431,600,102,3200,3800,"Sub-basin 5"
432,2400,551.16,5900,8300,"Sub-basin 5"
433,100,2,1400,1500,"Sub-basin 5"
434,1200,240,4000,5200,"Sub-basin 5"
435,400,19,2000,2400,"Sub-basin 5"
436,100,2,1100,1200,"Sub-basin 5"
437,100,1,1700,1800,"Sub-basin 5"
438,400,20,1500,1900,"Sub-basin 5"
439,18100,7448,15100,33200,"Sub-basin 5"
440,600,75,1800,2400,"Sub-basin 5"
441,200,9,1200,1400,"Sub-basin 5"
442,300,18,1500,1800,"Sub-basin 5"
443,1100,320,2700,3800,"Sub-basin 5"
444,100,2,2200,2300,"Sub-basin 5"
445,1500,177,3300,4800,"Sub-basin 5"
446,6100,1530,12600,18700,"Sub-basin 5"
447,1000,80,5500,6500,"Sub-basin 5"
448,200,6,2400,2600,"Sub-basin 5"
449,100,6,800,900,"Sub-basin 5"
450,900,49,5500,6400,"Sub-basin 5"
451,200,11,1600,1800,"Sub-basin 5"
452,100,6,1800,1900,"Sub-basin 5"
453,100,2,1400,1500,"Sub-basin 5"
454,100,3,1300,1400,"Sub-basin 5"
455,2100,340,7700,9800,"Sub-basin 5"
456,500,52,1900,2400,"Sub-basin 5"
457,500,24,2500,3000,"Sub-basin 5"
458,200,7,1700,1900,"Sub-basin 5"
459,100,1,600,700,"Sub-basin 5"
460,2300,319,9600,11900,"Sub-basin 5"
461,400,44,1400,1800,"Sub-basin 5"
462,700,93,4900,5600,"Sub-basin 5"
463,100,1,1100,1200,"Sub-basin 5"
464,600,80,2100,2700,"Sub-basin 5"
465,1900,744,3400,5300,"Sub-basin 5"
466,400,8,2000,2400,"Sub-basin 5"
467,600,82,2200,2800,"Sub-basin 5"
468,1400,302,1200,2600,"Sub-basin 5"
469,1400,173,4400,5800,"Sub-basin 5"
470,5700,1563,8600,14300,"Sub-basin 5"
471,700,19,4000,4700,"Sub-basin 5"
472,400,13,1900,2300,"Sub-basin 5"
473,100,5,900,1000,"Sub-basin 5"
474,200,4,900,1100,"Sub-basin 5"
475,300,7,1300,1600,"Sub-basin 5"
476,1700,531,2900,4600,"Sub-basin 5"
477,800,101,2300,3100,"Sub-basin 5"
478,17300,9768.84,17100,34400,"Sub-basin 5"
479,900,108,3100,4000,"Sub-basin 5"
480,1400,269,2700,4100,"Sub-basin 5"
481,100,3,500,600,"Sub-basin 5"
482,100,1,300,400,"Sub-basin 5"
483,3000,345,12700,15700,"Sub-basin 5"
484,1100,156,2900,4000,"Sub-basin 5"
485,700,79,8000,8700,"Sub-basin 5"
486,1000,70,2300,3300,"Sub-basin 5"
487,600,143,3100,3700,"Sub-basin 5"
488,600,22,4100,4700,"Sub-basin 5"
489,2900,1202,4900,7800,"Sub-basin 5"
490,4500,945,10600,15100,"Sub-basin 5"
491,2900,373,5500,8400,"Sub-basin 5"
492,600,67,2100,2700,"Sub-basin 5"
493,1100,292,2200,3300,"Sub-basin 5"
494,200,5,800,1000,"Sub-basin 5"
495,500,50,1500,2000,"Sub-basin 5"
496,6000,1741,6600,12600,"Sub-basin 5"
497,200,7,100,300,"Sub-basin 5"
498,800,99,3000,3800,"Sub-basin 5"
499,700,27,4900,5600,"Sub-basin 5"
500,1000,135,3700,4700,"Sub-basin 5"
501,1100,337,2800,3900,"Sub-basin 5"
502,4600,1140,8200,12800,"Sub-basin 5"
503,600,130,2200,2800,"Sub-basin 5"
504,6500,984,23100,29600,"Sub-basin 5"
505,100,1,900,1000,"Sub-basin 5"
506,100,3,200,300,"Sub-basin 5"
507,400,30,3700,4100,"Sub-basin 5"
508,3300,1226,8200,11500,"Sub-basin 5"
509,400,121,1300,1700,"Sub-basin 5"
510,28200,10869,25000,53200,"Sub-basin 5"
511,100,1,0,100,"Sub-basin 5"
512,1200,157,3400,4600,"Sub-basin 5"
513,300,12,1500,1800,"Sub-basin 5"
514,10800,3683,9600,20400,"Sub-basin 5"
515,2800,988,3800,6600,"Sub-basin 5"
516,1800,354,4000,5800,"Sub-basin 5"
517,6900,1853,7500,14400,"Sub-basin 5"
518,500,40,3700,4200,"Sub-basin 5"
519,1900,423,3100,5000,"Sub-basin 5"
520,4800,731,8600,13400,"Sub-basin 5"
521,4900,2048,8000,12900,"Sub-basin 5"
522,2400,372,9100,11500,"Sub-basin 5"
523,100,2,1400,1500,"Sub-basin 5"
524,200,7,1500,1700,"Sub-basin 5"
525,600,39,4000,4600,"Sub-basin 5"
526,1100,131,2700,3800,"Sub-basin 5"
527,200,15,1400,1600,"Sub-basin 5"
528,100,2,1000,1100,"Sub-basin 5"
529,200,6,2200,2400,"Sub-basin 5"
530,1000,53,4700,5700,"Sub-basin 5"
531,200,10,3200,3400,"Sub-basin 5"
532,100,1,1200,1300,"Sub-basin 5"
533,7400,1514,23600,31000,"Sub-basin 5"
534,2700,1362,4500,7200,"Sub-basin 5"
535,2200,951,3700,5900,"Sub-basin 5"
536,1000,276,3100,4100,"Sub-basin 5"
537,24000,9814,24600,48600,"Sub-basin 5"
538,500,15,800,1300,"Sub-basin 5"
539,7000,2053,17100,24100,"Sub-basin 5"
540,200,6,700,900,"Sub-basin 5"
541,900,302,1100,2000,"Sub-basin 5"
542,800,144,2000,2800,"Sub-basin 5"
543,500,34,1400,1900,"Sub-basin 5"
544,25200,7766.67,29300,54500,"Sub-basin 5"
545,300,9,1000,1300,"Sub-basin 5"
546,400,45,3600,4000,"Sub-basin 5"
547,100,2,800,900,"Sub-basin 5"
548,400,14,1800,2200,"Sub-basin 5"
549,1100,161,3900,5000,"Sub-basin 5"
550,4300,830,11400,15700,"Sub-basin 5"
551,200,4,600,800,"Sub-basin 5"
552,600,28,1400,2000,"Sub-basin 5"
553,700,47,2500,3200,"Sub-basin 5"
554,400,42,2200,2600,"Sub-basin 5"
555,400,64,1600,2000,"Sub-basin 5"
556,200,12,1400,1600,"Sub-basin 5"
557,5700,2119,6800,12500,"Sub-basin 5"
558,800,301,2600,3400,"Sub-basin 5"
559,200,5,1300,1500,"Sub-basin 5"
560,1400,81,3800,5200,"Sub-basin 5"
561,3100,466,11000,14100,"Sub-basin 5"
562,700,82,2000,2700,"Sub-basin 5"
563,400,12,1800,2200,"Sub-basin 5"
564,1000,235.34,6100,7100,"Sub-basin 5"
565,400,34,900,1300,"Sub-basin 5"
566,700,147,2300,3000,"Sub-basin 5"
567,200,16,1500,1700,"Sub-basin 5"
568,400,28,2700,3100,"Sub-basin 5"
569,100,8,1400,1500,"Sub-basin 5"
570,100,1,200,300,"Sub-basin 5"
571,100,2,0,100,"Sub-basin 5"
572,400,14,2500,2900,"Sub-basin 5"
573,100,9,500,600,"Sub-basin 5"
574,200,9,1900,2100,"Sub-basin 5"
575,800,156,1600,2400,"Sub-basin 5"
576,100,1,900,1000,"Sub-basin 5"
577,1600,260,8400,10000,"Sub-basin 5"
578,200,12,400,600,"Sub-basin 5"
579,1700,157,6900,8600,"Sub-basin 5"
580,100,2,500,600,"Sub-basin 5"
581,2100,467,10200,12300,"Sub-basin 5"
582,2200,572,7700,9900,"Sub-basin 5"
583,300,9,2300,2600,"Sub-basin 5"
584,1000,190,1700,2700,"Sub-basin 5"
585,500,73,1000,1500,"Sub-basin 5"
586,800,254,1900,2700,"Sub-basin 5"
587,300,10,900,1200,"Sub-basin 5"
588,1400,79,5000,6400,"Sub-basin 5"
589,600,69,2500,3100,"Sub-basin 5"
590,1200,330,4300,5500,"Sub-basin 5"
591,16200,6341,11800,28000,"Sub-basin 5"
592,600,86,3300,3900,"Sub-basin 5"
593,7500,2918,13200,20700,"Sub-basin 5"
594,400,29,3600,4000,"Sub-basin 5"
595,200,4,1400,1600,"Sub-basin 5"
596,1200,150,4800,6000,"Sub-basin 5"
597,3700,491,10000,13700,"Sub-basin 5"
598,100,3,900,1000,"Sub-basin 5"
599,600,47,3000,3600,"Sub-basin 5"
600,300,9,1200,1500,"Sub-basin 5"
601,4400,1388,10600,15000,"Sub-basin 5"
602,200,7,2000,2200,"Sub-basin 5"
603,400,43,2200,2600,"Sub-basin 5"
604,100,1,600,700,"Sub-basin 5"
605,1700,499,1600,3300,"Sub-basin 5"
606,500,26,2100,2600,"Sub-basin 5"
607,8300,1624,15300,23600,"Sub-basin 5"
608,1400,222,7300,8700,"Sub-basin 5"
609,200,7,300,500,"Sub-basin 5"
610,300,11,900,1200,"Sub-basin 5"
611,4800,1824,6400,11200,"Sub-basin 5"
612,1200,98,4600,5800,"Sub-basin 5"
613,400,18,1600,2000,"Sub-basin 5"
614,1100,300,2600,3700,"Sub-basin 5"
615,7500,1935,10200,17700,"Sub-basin 5"
616,900,232,1400,2300,"Sub-basin 5"
617,100,12,800,900,"Sub-basin 5"
618,100,1,1500,1600,"Sub-basin 5"
619,100,8,1600,1700,"Sub-basin 5"
620,3500,456,8000,11500,"Sub-basin 5"
621,3300,367,9500,12800,"Sub-basin 5"
622,1400,91,4300,5700,"Sub-basin 5"
623,4500,741,16700,21200,"Sub-basin 5"
624,600,79,3400,4000,"Sub-basin 5"
625,6300,2257,9000,15300,"Sub-basin 5"
626,3600,867,6200,9800,"Sub-basin 5"
627,800,143,2700,3500,"Sub-basin 5"
628,400,19,2200,2600,"Sub-basin 5"
629,300,9,1200,1500,"Sub-basin 5"
630,200,6,2200,2400,"Sub-basin 5"
631,1400,190,4800,6200,"Sub-basin 5"
632,2500,584,4500,7000,"Sub-basin 5"
633,100,1,500,600,"Sub-basin 5"
634,2400,719,9300,11700,"Sub-basin 5"
635,100,7,0,100,"Sub-basin 5"
636,4300,1261,3900,8200,"Sub-basin 5"
637,5100,1176,7000,12100,"Sub-basin 5"
638,1100,171,2800,3900,"Sub-basin 5"
639,4500,1276,8000,12500,"Sub-basin 5"
640,300,13,1500,1800,"Sub-basin 5"
641,1100,62,5100,6200,"Sub-basin 5"
642,1000,87,6300,7300,"Sub-basin 5"
643,9200,1880,20100,29300,"Sub-basin 5"
644,900,126,6600,7500,"Sub-basin 5"
645,300,18,1200,1500,"Sub-basin 5"
646,7300,2053,12500,19800,"Sub-basin 5"
647,200,8,2600,2800,"Sub-basin 5"
648,1800,153,13800,15600,"Sub-basin 5"
649,1800,233,10500,12300,"Sub-basin 5"
650,100,1,1100,1200,"Sub-basin 5"
651,1900,71,3200,5100,"Sub-basin 5"
652,11700,6171,10000,21700,"Sub-basin 5"
653,600,50,2600,3200,"Sub-basin 5"
654,3700,211,16000,19700,"Sub-basin 5"
655,3400,386,11900,15300,"Sub-basin 5"
656,200,5,2100,2300,"Sub-basin 5"
657,600,28,1700,2300,"Sub-basin 5"
658,2200,303,2800,5000,"Sub-basin 5"
659,200,6,500,700,"Sub-basin 5"
660,600,32,3500,4100,"Sub-basin 5"
661,100,2,1300,1400,"Sub-basin 5"
662,1400,346,4400,5800,"Sub-basin 5"
663,6500,2074,9700,16200,"Sub-basin 5"
664,2200,390,7600,9800,"Sub-basin 5"
665,500,88,2500,3000,"Sub-basin 5"
666,1900,267,3900,5800,"Sub-basin 5"
667,700,17,8500,9200,"Sub-basin 5"
668,100,3,1900,2000,"Sub-basin 5"
669,1400,212,5000,6400,"Sub-basin 5"
670,3400,367,10700,14100,"Sub-basin 5"
671,400,43,2600,3000,"Sub-basin 5"
672,3100,456,10000,13100,"Sub-basin 5"
673,4600,768,14900,19500,"Sub-basin 5"
674,800,144,4200,5000,"Sub-basin 5"
675,400,50,2300,2700,"Sub-basin 5"
676,1700,300,2300,4000,"Sub-basin 5"
677,800,138,3500,4300,"Sub-basin 5"
678,2000,223,9600,11600,"Sub-basin 5"
679,100,5,1800,1900,"Sub-basin 5"
680,200,14,1200,1400,"Sub-basin 5"
681,600,53.5,2300,2900,"Sub-basin 5"
682,6200,1926,10900,17100,"Sub-basin 5"
683,400,31,2100,2500,"Sub-basin 5"
684,6800,2851,10000,16800,"Sub-basin 5"
685,800,42,3600,4400,"Sub-basin 5"
686,900,71,1500,2400,"Sub-basin 5"
687,400,15,2000,2400,"Sub-basin 5"
688,100,1,1500,1600,"Sub-basin 5"
689,600,25,3600,4200,"Sub-basin 5"
690,400,53,1800,2200,"Sub-basin 5"
691,200,4,1900,2100,"Sub-basin 5"
692,2500,646,4200,6700,"Sub-basin 5"
693,500,13,2800,3300,"Sub-basin 5"
694,1200,99,7100,8300,"Sub-basin 5"
695,600,59,2600,3200,"Sub-basin 5"
696,600,66,5000,5600,"Sub-basin 5"
697,1200,58,3600,4800,"Sub-basin 5"
698,2700,1488,4700,7400,"Sub-basin 5"
699,200,8,2000,2200,"Sub-basin 5"
700,600,25,4000,4600,"Sub-basin 5"
701,400,49,2000,2400,"Sub-basin 5"
702,200,2,1200,1400,"Sub-basin 5"
703,100,1,1200,1300,"Sub-basin 5"
704,8700,4825.6189,9300,18000,"Sub-basin 5"
705,2200,213,12700,14900,"Sub-basin 5"
706,100,1,1700,1800,"Sub-basin 5"
707,900,198,2600,3500,"Sub-basin 5"
708,2700,161,8800,11500,"Sub-basin 5"
709,1700,59,4700,6400,"Sub-basin 5"
710,11800,3644,17300,29100,"Sub-basin 5"
711,1300,127,7100,8400,"Sub-basin 5"
712,2900,756,6300,9200,"Sub-basin 5"
713,100,3,1300,1400,"Sub-basin 5"
714,1000,116,4400,5400,"Sub-basin 5"
715,600,56,1600,2200,"Sub-basin 5"
716,3700,1059,10500,14200,"Sub-basin 5"
717,700,69,2800,3500,"Sub-basin 5"
718,2000,374,4400,6400,"Sub-basin 5"
719,4000,1241,6100,10100,"Sub-basin 5"
720,1500,104,6800,8300,"Sub-basin 5"
721,100,1,300,400,"Sub-basin 5"
722,600,77,2400,3000,"Sub-basin 5"
723,3000,245,12300,15300,"Sub-basin 5"
724,600,56,2500,3100,"Sub-basin 5"
725,400,76,1700,2100,"Sub-basin 5"
726,7600,2075,15300,22900,"Sub-basin 5"
727,200,13,1900,2100,"Sub-basin 5"
728,200,6,1600,1800,"Sub-basin 5"
729,100,1,300,400,"Sub-basin 5"
730,4100,1240,7600,11700,"Sub-basin 5"
731,5400,1368.84,6900,12300,"Sub-basin 5"
732,2100,482,3300,5400,"Sub-basin 5"
733,300,36,1800,2100,"Sub-basin 5"
734,300,10,2200,2500,"Sub-basin 5"
735,2400,253,8800,11200,"Sub-basin 5"
736,100,1,1000,1100,"Sub-basin 5"
737,800,116,2000,2800,"Sub-basin 5"
738,1100,315,3000,4100,"Sub-basin 5"
739,1500,282,2200,3700,"Sub-basin 5"
740,600,37,6200,6800,"Sub-basin 5"
741,400,52,2700,3100,"Sub-basin 5"
742,200,2,600,800,"Sub-basin 5"
743,2200,205,5500,7700,"Sub-basin 5"
744,1400,180,5500,6900,"Sub-basin 5"
745,400,11,900,1300,"Sub-basin 5"
746,800,62,3400,4200,"Sub-basin 5"
747,1800,664,3400,5200,"Sub-basin 5"
748,2800,590,6400,9200,"Sub-basin 5"
749,100,2,300,400,"Sub-basin 5"
750,400,120,2000,2400,"Sub-basin 5"
751,100,4,600,700,"Sub-basin 5"
752,1800,234,5200,7000,"Sub-basin 5"
753,100,1,1200,1300,"Sub-basin 5"
754,4800,771,22700,27500,"Sub-basin 5"
755,200,3,3700,3900,"Sub-basin 5"
756,100,1,1600,1700,"Sub-basin 5"
757,100,2,600,700,"Sub-basin 5"
758,100,1,1100,1200,"Sub-basin 5"
759,2600,190,9700,12300,"Sub-basin 5"
760,2900,833,4100,7000,"Sub-basin 5"
761,400,34,1800,2200,"Sub-basin 5"
762,1800,197,4500,6300,"Sub-basin 5"
763,100,2,800,900,"Sub-basin 5"
764,300,6,2400,2700,"Sub-basin 5"
765,2000,296,7500,9500,"Sub-basin 5"
766,2600,410,7700,10300,"Sub-basin 5"
767,4100,1414,7400,11500,"Sub-basin 5"
768,800,70,4000,4800,"Sub-basin 5"
769,100,2,600,700,"Sub-basin 5"
770,200,19,1100,1300,"Sub-basin 5"
771,400,65,2600,3000,"Sub-basin 5"
772,100,3,3000,3100,"Sub-basin 5"
773,300,4,3500,3800,"Sub-basin 5"
774,1500,37,9500,11000,"Sub-basin 5"
775,3500,992,4300,7800,"Sub-basin 5"
776,5100,1443,13000,18100,"Sub-basin 5"
777,900,136,4200,5100,"Sub-basin 5"
778,1800,223,5900,7700,"Sub-basin 5"
779,1500,77,5100,6600,"Sub-basin 5"
780,500,34,2000,2500,"Sub-basin 5"
781,2300,327,8000,10300,"Sub-basin 5"
782,1800,355,6900,8700,"Sub-basin 5"
783,400,13,1800,2200,"Sub-basin 5"
784,100,1,1300,1400,"Sub-basin 5"
785,200,12,2800,3000,"Sub-basin 5"
786,200,3,2300,2500,"Sub-basin 5"
787,400,17,2000,2400,"Sub-basin 5"
788,500,17,3600,4100,"Sub-basin 5"
789,1600,181,4500,6100,"Sub-basin 5"
790,6100,2442,6700,12800,"Sub-basin 5"
791,1200,139,4500,5700,"Sub-basin 5"
792,400,41,1600,2000,"Sub-basin 5"
793,1400,96,6800,8200,"Sub-basin 5"
794,8600,1458,20700,29300,"Sub-basin 5"
795,800,98,3900,4700,"Sub-basin 5"
796,1600,365,3400,5000,"Sub-basin 5"
797,1300,94,7400,8700,"Sub-basin 5"
798,800,29,7200,8000,"Sub-basin 5"
799,100,1,0,100,"Sub-basin 5"
800,200,3,300,500,"Sub-basin 5"
801,5900,1874,13400,19300,"Sub-basin 5"
802,15900,1857,53700,69600,"Sub-basin 5"
803,1700,64,7000,8700,"Sub-basin 5"
804,500,24,2600,3100,"Sub-basin 5"
805,1600,423,1600,3200,"Sub-basin 5"
806,5700,1979,7900,13600,"Sub-basin 5"
807,5700,1763,10600,16300,"Sub-basin 5"
808,400,81,2100,2500,"Sub-basin 5"
809,1300,338,3200,4500,"Sub-basin 5"
810,100,1,700,800,"Sub-basin 5"
811,1700,26,13900,15600,"Sub-basin 5"
812,100,2,1300,1400,"Sub-basin 5"
813,5600,1304,17900,23500,"Sub-basin 5"
814,33000,15725,25900,58900,"Sub-basin 5"
815,4400,2257,5700,10100,"Sub-basin 5"
816,1800,424,3100,4900,"Sub-basin 5"
817,5500,1052,17200,22700,"Sub-basin 5"
818,1400,166,5200,6600,"Sub-basin 5"
819,200,7,2300,2500,"Sub-basin 5"
820,2000,149,6800,8800,"Sub-basin 5"
821,1200,364,1900,3100,"Sub-basin 5"
822,7700,1819,11600,19300,"Sub-basin 5"
823,7800,2603,9000,16800,"Sub-basin 5"
824,900,301,1700,2600,"Sub-basin 5"
825,900,129,2300,3200,"Sub-basin 5"
826,1300,161,7000,8300,"Sub-basin 5"
827,200,6,3300,3500,"Sub-basin 5"
828,400,12,200,600,"Sub-basin 5"
829,700,41,1400,2100,"Sub-basin 5"
830,400,34,2900,3300,"Sub-basin 5"
831,100,1,1300,1400,"Sub-basin 5"
832,800,59,4800,5600,"Sub-basin 5"
833,600,28,3100,3700,"Sub-basin 5"
834,2000,80,8700,10700,"Sub-basin 5"
835,100,2,1800,1900,"Sub-basin 5"
836,100,2,1300,1400,"Sub-basin 5"
837,100,2,1600,1700,"Sub-basin 5"
838,2800,1153,9300,12100,"Sub-basin 5"
839,100,2,400,500,"Sub-basin 5"
840,400,32,1300,1700,"Sub-basin 5"
841,200,7,1800,2000,"Sub-basin 5"
842,100,1,1100,1200,"Sub-basin 5"
843,1000,106,1700,2700,"Sub-basin 5"
844,200,4,1500,1700,"Sub-basin 5"
845,100,3,600,700,"Sub-basin 5"
846,1800,388,4500,6300,"Sub-basin 5"
847,4500,1488,5700,10200,"Sub-basin 5"
848,400,9,1300,1700,"Sub-basin 5"
849,4100,1195,6900,11000,"Sub-basin 5"
850,2900,1034,4800,7700,"Sub-basin 5"
851,6700,549,20600,27300,"Sub-basin 5"
852,400,12,2600,3000,"Sub-basin 5"
853,600,217,2700,3300,"Sub-basin 5"
854,400,37,2000,2400,"Sub-basin 5"
855,200,8,500,700,"Sub-basin 5"
856,400,17,1900,2300,"Sub-basin 5"
857,200,6,1900,2100,"Sub-basin 5"
858,2300,486,4600,6900,"Sub-basin 5"
859,1000,100,1700,2700,"Sub-basin 5"
860,500,39,3800,4300,"Sub-basin 5"
861,200,6,2000,2200,"Sub-basin 5"
862,400,19,2000,2400,"Sub-basin 5"
863,1200,148,4200,5400,"Sub-basin 5"
864,200,25,800,1000,"Sub-basin 5"
865,100,1,900,1000,"Sub-basin 5"
866,700,81,1000,1700,"Sub-basin 5"
867,10200,4396,12900,23100,"Sub-basin 5"
868,100,2,1200,1300,"Sub-basin 5"
869,4200,1025,6200,10400,"Sub-basin 5"
870,12200,4132,22900,35100,"Sub-basin 5"
871,700,36,3200,3900,"Sub-basin 5"
872,700,73,3400,4100,"Sub-basin 5"
873,600,53,4200,4800,"Sub-basin 5"
874,200,2,1900,2100,"Sub-basin 5"
875,600,145,1600,2200,"Sub-basin 5"
876,3800,928,6200,10000,"Sub-basin 5"
877,3300,440,15300,18600,"Sub-basin 5"
878,400,26,2200,2600,"Sub-basin 5"
879,800,193,3400,4200,"Sub-basin 5"
880,5300,203,26400,31700,"Sub-basin 5"
881,600,35,2700,3300,"Sub-basin 5"
882,300,12,2500,2800,"Sub-basin 5"
883,300,7,1400,1700,"Sub-basin 5"
884,500,85,1800,2300,"Sub-basin 5"
885,1000,251,3500,4500,"Sub-basin 5"
886,500,60,1900,2400,"Sub-basin 5"
887,2800,349,19200,22000,"Sub-basin 5"
888,2700,294,10500,13200,"Sub-basin 5"
889,1000,185,4200,5200,"Sub-basin 5"
890,100,1,1900,2000,"Sub-basin 5"
891,5700,2320,9700,15400,"Sub-basin 5"
892,400,48,1700,2100,"Sub-basin 5"
893,200,4,1300,1500,"Sub-basin 5"
894,1100,29,5200,6300,"Sub-basin 5"
895,300,10,1300,1600,"Sub-basin 5"
896,6200,1867,14600,20800,"Sub-basin 5"
897,500,16,1900,2400,"Sub-basin 5"
898,1200,300,3600,4800,"Sub-basin 5"
899,300,14,1100,1400,"Sub-basin 5"
900,1700,533,4500,6200,"Sub-basin 5"
901,2300,768,5500,7800,"Sub-basin 5"
902,100,1,1200,1300,"Sub-basin 5"
903,24900,9993,23400,48300,"Sub-basin 5"
904,1000,103,4900,5900,"Sub-basin 5"
905,3700,1043,11700,15400,"Sub-basin 5"
906,200,3,1200,1400,"Sub-basin 5"
907,900,67,6800,7700,"Sub-basin 5"
908,200,5,2500,2700,"Sub-basin 5"
909,14400,3689,20700,35100,"Sub-basin 5"
910,200,9,600,800,"Sub-basin 5"
911,100,1,800,900,"Sub-basin 5"
912,100,2,1300,1400,"Sub-basin 5"
913,200,4,1900,2100,"Sub-basin 5"
914,8800,2489.67,12300,21100,"Sub-basin 5"
915,400,57,2400,2800,"Sub-basin 5"
916,800,128,2400,3200,"Sub-basin 5"
917,100,2,1800,1900,"Sub-basin 5"
918,500,30,1500,2000,"Sub-basin 5"
919,600,81,3000,3600,"Sub-basin 5"
920,700,13,6400,7100,"Sub-basin 5"
921,100,1,1000,1100,"Sub-basin 5"
922,1600,134,6100,7700,"Sub-basin 5"
923,300,20,1600,1900,"Sub-basin 5"
924,400,40,2400,2800,"Sub-basin 5"
925,400,21,3600,4000,"Sub-basin 5"
926,1200,77,5000,6200,"Sub-basin 5"
927,1000,99,3800,4800,"Sub-basin 5"
928,300,5,1300,1600,"Sub-basin 5"
929,300,16,3400,3700,"Sub-basin 5"
930,800,93,3300,4100,"Sub-basin 5"
931,5500,657,23100,28600,"Sub-basin 5"
932,5800,320,32700,38500,"Sub-basin 5"
933,200,2,1000,1200,"Sub-basin 5"
934,3200,720,6500,9700,"Sub-basin 5"
935,2100,1367,4600,6700,"Sub-basin 5"
936,1300,352,2900,4200,"Sub-basin 5"
937,100,7,700,800,"Sub-basin 5"
938,1100,57,7900,9000,"Sub-basin 5"
939,2200,257,4000,6200,"Sub-basin 5"
940,100,3,1600,1700,"Sub-basin 5"
941,500,42,2800,3300,"Sub-basin 5"
942,100,1,700,800,"Sub-basin 5"
943,400,18,1300,1700,"Sub-basin 5"
944,500,12,5700,6200,"Sub-basin 5"
945,200,4,2400,2600,"Sub-basin 5"
946,100,1,600,700,"Sub-basin 5"
947,100,2,400,500,"Sub-basin 5"
948,100,6,2000,2100,"Sub-basin 5"
949,100,0.33,900,1000,"Sub-basin 5"
950,300,12,1200,1500,"Sub-basin 5"
951,2400,248,5600,8000,"Sub-basin 5"
952,400,31,2300,2700,"Sub-basin 5"
953,200,5,900,1100,"Sub-basin 5"
954,2800,720,5800,8600,"Sub-basin 5"
955,300,21,1200,1500,"Sub-basin 5"
956,100,2,200,300,"Sub-basin 5"
957,200,3,3300,3500,"Sub-basin 5"
958,300,5,3400,3700,"Sub-basin 5"
959,100,2,1100,1200,"Sub-basin 5"
960,600,44,3900,4500,"Sub-basin 5"
961,100,1,3100,3200,"Sub-basin 5"
962,4400,1605,5400,9800,"Sub-basin 5"
963,600,50,1600,2200,"Sub-basin 5"
964,700,92,3000,3700,"Sub-basin 5"
965,600,110,1900,2500,"Sub-basin 5"
966,200,4,800,1000,"Sub-basin 5"
967,100,2,1800,1900,"Sub-basin 5"
968,1300,67,5800,7100,"Sub-basin 5"
969,3600,545,17400,21000,"Sub-basin 5"
970,300,11,3400,3700,"Sub-basin 5"
971,800,29,4700,5500,"Sub-basin 5"
972,2600,390,7400,10000,"Sub-basin 5"
973,400,23,2700,3100,"Sub-basin 5"
974,900,192,1700,2600,"Sub-basin 5"
975,100,3,1400,1500,"Sub-basin 5"
976,100,3,700,800,"Sub-basin 5"
977,400,37,3800,4200,"Sub-basin 5"
978,300,8,5400,5700,"Sub-basin 5"
979,400,52,1700,2100,"Sub-basin 5"
980,300,21,1600,1900,"Sub-basin 5"
981,100,2,500,600,"Sub-basin 5"
982,3100,1526,7000,10100,"Sub-basin 5"
983,300,16,1900,2200,"Sub-basin 5"
984,400,42,2600,3000,"Sub-basin 5"
985,1700,767,3400,5100,"Sub-basin 5"
986,300,16,1600,1900,"Sub-basin 5"
987,2100,276,10400,12500,"Sub-basin 5"
988,100,5,1900,2000,"Sub-basin 5"
989,900,120,5400,6300,"Sub-basin 5"
990,500,45,3700,4200,"Sub-basin 5"
991,400,29,900,1300,"Sub-basin 5"
992,400,34,4300,4700,"Sub-basin 5"
993,400,27,2400,2800,"Sub-basin 5"
994,900,83,2100,3000,"Sub-basin 5"
995,400,29,3500,3900,"Sub-basin 5"
996,600,54,5300,5900,"Sub-basin 5"
997,100,2,1100,1200,"Sub-basin 5"
998,200,2,1100,1300,"Sub-basin 5"
999,100,4,900,1000,"Sub-basin 5"
1000,400,92,900,1300,"Sub-basin 5"
1001,9500,4061,13000,22500,"Sub-basin 5"
1002,200,21,1300,1500,"Sub-basin 5"
1003,1700,143,5200,6900,"Sub-basin 5"
1004,5300,1286,22100,27400,"Sub-basin 5"
1005,100,1,700,800,"Sub-basin 5"
1006,300,15,3800,4100,"Sub-basin 5"
1007,100,2,300,400,"Sub-basin 5"
1008,2100,483,7600,9700,"Sub-basin 5"
1009,1900,1221,5700,7600,"Sub-basin 5"
1010,1000,50,3600,4600,"Sub-basin 5"
1011,200,3,1900,2100,"Sub-basin 5"
1012,100,1,1100,1200,"Sub-basin 5"
1013,100,3,1100,1200,"Sub-basin 5"
1014,400,23,1200,1600,"Sub-basin 5"
1015,200,20,1400,1600,"Sub-basin 5"
1016,100,2,300,400,"Sub-basin 5"
1017,900,75,2100,3000,"Sub-basin 5"
1018,100,1,1000,1100,"Sub-basin 5"
1019,1600,322,3400,5000,"Sub-basin 5"
1020,800,236,2000,2800,"Sub-basin 5"
1021,400,25,3700,4100,"Sub-basin 5"
1022,200,4,1500,1700,"Sub-basin 5"
1023,11500,3106,24200,35700,"Sub-basin 5"
1024,4900,2020,8000,12900,"Sub-basin 5"
1025,1400,366,2300,3700,"Sub-basin 5"
1026,300,17,2100,2400,"Sub-basin 5"
1027,900,224,2600,3500,"Sub-basin 5"
1028,1000,89,4300,5300,"Sub-basin 5"
1029,800,15,6600,7400,"Sub-basin 5"
1030,200,4,1600,1800,"Sub-basin 5"
1031,200,4,1600,1800,"Sub-basin 5"
1032,6800,583,15900,22700,"Sub-basin 5"
1033,3900,1447,5500,9400,"Sub-basin 5"
1034,200,5,1900,2100,"Sub-basin 5"
1035,900,97,3500,4400,"Sub-basin 5"
1036,100,1,1600,1700,"Sub-basin 5"
1037,700,43,3100,3800,"Sub-basin 5"
1038,400,16,1700,2100,"Sub-basin 5"
1039,200,6,400,600,"Sub-basin 5"
1040,1300,109,3100,4400,"Sub-basin 5"
1041,1300,179,6400,7700,"Sub-basin 5"
1042,100,7,1900,2000,"Sub-basin 5"
1043,500,175,1800,2300,"Sub-basin 5"
1044,200,9,2900,3100,"Sub-basin 5"
1045,500,14,3900,4400,"Sub-basin 5"
1046,100,1,2400,2500,"Sub-basin 5"
1047,2100,1073,4900,7000,"Sub-basin 5"
1048,15800,478,68900,84700,"Sub-basin 5"
1049,1700,122,2800,4500,"Sub-basin 5"
1050,100,3,700,800,"Sub-basin 5"
1051,1000,92,4400,5400,"Sub-basin 5"
1052,3400,470,13700,17100,"Sub-basin 5"
1053,900,91,3000,3900,"Sub-basin 5"
1054,100,1,1000,1100,"Sub-basin 5"
1055,200,16,1300,1500,"Sub-basin 5"
1056,1300,147,3500,4800,"Sub-basin 5"
1057,300,4,1800,2100,"Sub-basin 5"
1058,700,64,1400,2100,"Sub-basin 5"
1059,400,24,1200,1600,"Sub-basin 5"
1060,600,31,4300,4900,"Sub-basin 5"
1061,17000,4831.99,30300,47300,"Sub-basin 5"
1062,200,8,2800,3000,"Sub-basin 5"
1063,2900,489,9100,12000,"Sub-basin 5"
1064,800,11,7600,8400,"Sub-basin 5"
1065,200,4,2200,2400,"Sub-basin 5"
1066,100,2,1100,1200,"Sub-basin 5"
1067,100,2,1600,1700,"Sub-basin 5"
1068,100,4,1200,1300,"Sub-basin 5"
1069,600,39,4000,4600,"Sub-basin 5"
1070,400,13,1900,2300,"Sub-basin 5"
1071,200,16,800,1000,"Sub-basin 5"
1072,800,77,7300,8100,"Sub-basin 5"
1073,300,24,1500,1800,"Sub-basin 5"
1074,500,27,1900,2400,"Sub-basin 5"
1075,400,20,2100,2500,"Sub-basin 5"
1076,300,15,2000,2300,"Sub-basin 5"
1077,600,125,2400,3000,"Sub-basin 5"
1078,500,20,4400,4900,"Sub-basin 5"
1079,1000,206,4000,5000,"Sub-basin 5"
1080,800,22,4400,5200,"Sub-basin 5"
1081,600,27,2200,2800,"Sub-basin 5"
1082,3400,358,13700,17100,"Sub-basin 5"
1083,300,9,1400,1700,"Sub-basin 5"
1084,3800,178,16800,20600,"Sub-basin 5"
1085,1500,507,5500,7000,"Sub-basin 5"
1086,3000,523,8300,11300,"Sub-basin 5"
1087,1000,54,1900,2900,"Sub-basin 5"
1088,500,90,3000,3500,"Sub-basin 5"
1089,1600,148,4500,6100,"Sub-basin 5"
1090,200,6,3000,3200,"Sub-basin 5"
1091,300,18,3300,3600,"Sub-basin 5"
1092,500,62,2700,3200,"Sub-basin 5"
1093,300,22,1800,2100,"Sub-basin 5"
1094,1100,49,8300,9400,"Sub-basin 5"
1095,100,3,300,400,"Sub-basin 5"
1096,400,49,700,1100,"Sub-basin 5"
1097,700,77,2000,2700,"Sub-basin 5"
1098,600,98,5700,6300,"Sub-basin 5"
1099,400,15,4300,4700,"Sub-basin 5"
1100,200,2,1400,1600,"Sub-basin 5"
1101,1000,194,2800,3800,"Sub-basin 5"
1102,400,18,2100,2500,"Sub-basin 5"
1103,100,5,900,1000,"Sub-basin 5"
1104,2700,362,12000,14700,"Sub-basin 5"
1105,500,36,1800,2300,"Sub-basin 5"
1106,400,19,1600,2000,"Sub-basin 5"
1107,900,52,3900,4800,"Sub-basin 5"
1108,1000,79,2800,3800,"Sub-basin 5"
1109,300,16,2600,2900,"Sub-basin 5"
1110,600,19,7200,7800,"Sub-basin 5"
1111,100,2,900,1000,"Sub-basin 5"
1112,300,20,2000,2300,"Sub-basin 5"
1113,200,12,1400,1600,"Sub-basin 5"
1114,300,12,3300,3600,"Sub-basin 5"
1115,600,51,2000,2600,"Sub-basin 5"
1116,100,2,500,600,"Sub-basin 5"
1117,100,1,1100,1200,"Sub-basin 5"
1118,1600,316,2000,3600,"Sub-basin 5"
1119,400,105,1300,1700,"Sub-basin 5"
1120,1100,16,14300,15400,"Sub-basin 5"
1121,100,2,1300,1400,"Sub-basin 5"
1122,100,1,1000,1100,"Sub-basin 5"
1123,100,1,2100,2200,"Sub-basin 5"
1124,100,2,1700,1800,"Sub-basin 5"
1125,100,1,500,600,"Sub-basin 5"
1126,200,5,400,600,"Sub-basin 5"
1127,500,17,2300,2800,"Sub-basin 5"
1128,300,13,2200,2500,"Sub-basin 5"
1129,1300,122,4600,5900,"Sub-basin 5"
1130,1900,475,6800,8700,"Sub-basin 5"
1131,500,23,3000,3500,"Sub-basin 5"
1132,1100,301,2400,3500,"Sub-basin 5"
1133,600,22,5000,5600,"Sub-basin 5"
1134,200,12,2400,2600,"Sub-basin 5"
1135,2300,207,6200,8500,"Sub-basin 5"
1136,400,18,4300,4700,"Sub-basin 5"
1137,8800,3423,9600,18400,"Sub-basin 5"
1138,100,3,700,800,"Sub-basin 5"
1139,100,3,1400,1500,"Sub-basin 5"
1140,2100,514,3700,5800,"Sub-basin 5"
1141,200,8,1900,2100,"Sub-basin 5"
1142,100,1,700,800,"Sub-basin 5"
1143,100,2,500,600,"Sub-basin 5"
1144,700,29,1900,2600,"Sub-basin 5"
1145,200,12,1300,1500,"Sub-basin 5"
1146,600,27,2400,3000,"Sub-basin 5"
1147,200,9,500,700,"Sub-basin 5"
1148,300,6,1000,1300,"Sub-basin 5"
1149,300,21,1600,1900,"Sub-basin 5"
1150,400,68,2000,2400,"Sub-basin 5"
1151,900,375,1900,2800,"Sub-basin 5"
1152,100,1,1200,1300,"Sub-basin 5"
1153,1000,92,3800,4800,"Sub-basin 5"
1154,800,59,3300,4100,"Sub-basin 5"
1155,700,76,2800,3500,"Sub-basin 5"
1156,200,8,1900,2100,"Sub-basin 5"
1157,200,10,3200,3400,"Sub-basin 5"
1158,300,6,5400,5700,"Sub-basin 5"
1159,1200,78,10200,11400,"Sub-basin 5"
1160,400,29,3300,3700,"Sub-basin 5"
1161,100,8,1800,1900,"Sub-basin 5"
1162,600,29,5400,6000,"Sub-basin 5"
1163,1500,114,6400,7900,"Sub-basin 5"
1164,500,81,3400,3900,"Sub-basin 5"
1165,100,1,1300,1400,"Sub-basin 5"
1166,1400,57,11800,13200,"Sub-basin 5"
1167,400,21,4500,4900,"Sub-basin 5"
1168,100,4,1800,1900,"Sub-basin 5"
1169,100,1,400,500,"Sub-basin 5"
1170,100,2,500,600,"Sub-basin 5"
1171,100,8,1300,1400,"Sub-basin 5"
1172,1000,70,2100,3100,"Sub-basin 5"
1173,1800,442,7100,8900,"Sub-basin 5"
1174,100,3,900,1000,"Sub-basin 5"
1175,700,66,4200,4900,"Sub-basin 5"
1176,600,98,2700,3300,"Sub-basin 5"
1177,1200,103,6500,7700,"Sub-basin 5"
1178,200,10,1900,2100,"Sub-basin 5"
1179,300,11,3100,3400,"Sub-basin 5"
1180,400,44,3600,4000,"Sub-basin 5"
1181,2600,342,8400,11000,"Sub-basin 5"
1182,500,32,2900,3400,"Sub-basin 5"
1183,100,1,2200,2300,"Sub-basin 5"
1184,100,4,1200,1300,"Sub-basin 5"
1185,100,2,1300,1400,"Sub-basin 5"
1186,100,4,2100,2200,"Sub-basin 5"
1187,200,7,1900,2100,"Sub-basin 5"
1188,400,51,2900,3300,"Sub-basin 5"
1189,400,25,1200,1600,"Sub-basin 5"
1190,600,62,700,1300,"Sub-basin 5"
1191,300,16,1500,1800,"Sub-basin 5"
1192,800,41,3000,3800,"Sub-basin 5"
1193,5500,1845,15400,20900,"Sub-basin 5"
1194,200,10,1400,1600,"Sub-basin 5"
1195,1300,102,4600,5900,"Sub-basin 5"
1196,300,6,5500,5800,"Sub-basin 5"
1197,100,1,1800,1900,"Sub-basin 5"
1198,2600,95,11100,13700,"Sub-basin 5"
1199,100,2,2500,2600,"Sub-basin 5"
1200,300,18,1300,1600,"Sub-basin 5"
1201,200,8,2000,2200,"Sub-basin 5"
1202,1100,101,5900,7000,"Sub-basin 5"
1203,200,10,1800,2000,"Sub-basin 5"
1204,200,7,2800,3000,"Sub-basin 5"
1205,100,5,1100,1200,"Sub-basin 5"
1206,100,1,500,600,"Sub-basin 5"
1207,400,9,2900,3300,"Sub-basin 5"
1208,400,58,800,1200,"Sub-basin 5"
1209,100,4,900,1000,"Sub-basin 5"
1210,200,9,1200,1400,"Sub-basin 5"
1211,800,59,3700,4500,"Sub-basin 5"
1212,700,39,7600,8300,"Sub-basin 5"
1213,800,39,6700,7500,"Sub-basin 5"
1214,600,24,5400,6000,"Sub-basin 5"
1215,200,4,2500,2700,"Sub-basin 5"
1216,100,1,500,600,"Sub-basin 5"
1217,600,15,4700,5300,"Sub-basin 5"
1218,300,16,3800,4100,"Sub-basin 5"
1219,100,1,1100,1200,"Sub-basin 5"
1220,300,7,2700,3000,"Sub-basin 5"
1221,500,9,3600,4100,"Sub-basin 5"
1222,100,2,900,1000,"Sub-basin 5"
1223,300,10,1800,2100,"Sub-basin 5"
1224,100,1,800,900,"Sub-basin 5"
1225,500,44,2300,2800,"Sub-basin 5"
1226,1800,257,9100,10900,"Sub-basin 5"
1227,200,5,2200,2400,"Sub-basin 5"
1228,600,26,4400,5000,"Sub-basin 5"
1229,2700,981,3400,6100,"Sub-basin 5"
1230,100,1,300,400,"Sub-basin 5"
1231,200,4,1000,1200,"Sub-basin 5"
1232,100,1,200,300,"Sub-basin 5"
1233,300,8,3700,4000,"Sub-basin 5"
1234,800,53,4900,5700,"Sub-basin 5"
1235,300,7,3600,3900,"Sub-basin 5"
1236,300,5,3800,4100,"Sub-basin 5"
1237,300,15,3400,3700,"Sub-basin 5"
1238,300,8,1300,1600,"Sub-basin 5"
1239,500,9,3900,4400,"Sub-basin 5"
1240,200,3,1400,1600,"Sub-basin 5"
1241,100,1,1100,1200,"Sub-basin 5"
1242,100,1,1400,1500,"Sub-basin 5"
1243,100,4,1300,1400,"Sub-basin 5"
1244,100,2,300,400,"Sub-basin 5"
1245,500,25,1600,2100,"Sub-basin 5"
1246,200,9,1100,1300,"Sub-basin 5"
1247,700,42,2900,3600,"Sub-basin 5"
1248,200,8,3100,3300,"Sub-basin 5"
1249,500,36,1800,2300,"Sub-basin 5"
1250,1100,115,4100,5200,"Sub-basin 5"
1251,100,2,900,1000,"Sub-basin 5"
1252,2300,387,6100,8400,"Sub-basin 5"
1253,100,4,1200,1300,"Sub-basin 5"
1254,6300,2452.33,8900,15200,"Sub-basin 5"
1255,200,13,2000,2200,"Sub-basin 5"
1256,500,35,2600,3100,"Sub-basin 5"
1257,6100,833,25400,31500,"Sub-basin 5"
1258,9000,3700,24100,33100,"Sub-basin 5"
1259,100,6,1500,1600,"Sub-basin 5"
1260,100,3,1600,1700,"Sub-basin 5"
1261,400,23,2700,3100,"Sub-basin 5"
1262,200,9,1500,1700,"Sub-basin 5"
1263,100,2,1500,1600,"Sub-basin 5"
1264,9300,1595.17,30200,39500,"Sub-basin 5"
1265,400,20,3700,4100,"Sub-basin 5"
1266,400,20,4600,5000,"Sub-basin 5"
1267,500,53,3800,4300,"Sub-basin 5"
1268,1600,641,4000,5600,"Sub-basin 5"
1269,800,37,3100,3900,"Sub-basin 5"
1270,400,41,3900,4300,"Sub-basin 5"
1271,400,15,2800,3200,"Sub-basin 5"
1272,4200,783,13900,18100,"Sub-basin 5"
1273,200,7,1400,1600,"Sub-basin 5"
1274,300,11,2500,2800,"Sub-basin 5"
1275,2000,461,5500,7500,"Sub-basin 5"
1276,200,9,1000,1200,"Sub-basin 5"
1277,700,42,4900,5600,"Sub-basin 5"
1278,400,18,3300,3700,"Sub-basin 5"
1279,6200,743.17,40300,46500,"Sub-basin 5"
1280,300,11,3600,3900,"Sub-basin 5"
1281,300,6,3200,3500,"Sub-basin 5"
1282,2400,201,12800,15200,"Sub-basin 5"
1283,3000,235,17600,20600,"Sub-basin 5"
1284,500,64,2000,2500,"Sub-basin 5"
1285,6200,2626.83,8000,14200,"Sub-basin 5"
1286,200,8,1100,1300,"Sub-basin 5"
1287,1500,206,8700,10200,"Sub-basin 5"
1288,100,2,2000,2100,"Sub-basin 5"
1289,8400,2602.83,29800,38200,"Sub-basin 5"
1290,100,3,1500,1600,"Sub-basin 5"
1291,6000,2503.83,11700,17700,"Sub-basin 5"
1292,700,63,5900,6600,"Sub-basin 5"
1293,400,14,2400,2800,"Sub-basin 5"
1294,100,2,800,900,"Sub-basin 5"
1295,200,8,1500,1700,"Sub-basin 5"
1296,100,1,900,1000,"Sub-basin 5"
1297,100,1,300,400,"Sub-basin 5"
1298,200,3,2200,2400,"Sub-basin 5"
1299,1400,103,7300,8700,"Sub-basin 5"
1300,5600,1965.16,6300,11900,"Sub-basin 5"
1301,2200,662.67,4000,6200,"Sub-basin 5"
1302,100,2,1600,1700,"Sub-basin 5"
1303,700,40,6600,7300,"Sub-basin 5"
1304,2200,395,13400,15600,"Sub-basin 5"
1305,100,1,2100,2200,"Sub-basin 5"
1306,100,1,1100,1200,"Sub-basin 5"
1307,400,8,4000,4400,"Sub-basin 5"
1308,400,20,5200,5600,"Sub-basin 5"
1309,100,2,1500,1600,"Sub-basin 5"
1310,200,29,1400,1600,"Sub-basin 5"
1311,200,5,1600,1800,"Sub-basin 5"
1312,29700,8202.03,40800,70500,"Sub-basin 5"
1313,100,3,1700,1800,"Sub-basin 5"
1314,400,19,2300,2700,"Sub-basin 5"
1315,100,1,500,600,"Sub-basin 5"
1316,100,1,600,700,"Sub-basin 5"
1317,1000,63,3900,4900,"Sub-basin 5"
1318,300,7,2200,2500,"Sub-basin 5"
1319,100,1,1100,1200,"Sub-basin 5"
1320,400,11,1100,1500,"Sub-basin 5"
1321,500,21,2100,2600,"Sub-basin 5"
1322,600,19,5000,5600,"Sub-basin 5"
1323,600,70,3800,4400,"Sub-basin 5"
1324,400,21,4300,4700,"Sub-basin 5"
1325,100,2,300,400,"Sub-basin 5"
1326,200,9,700,900,"Sub-basin 5"
1327,300,19,2800,3100,"Sub-basin 5"
1328,1800,531,12600,14400,"Sub-basin 5"
1329,800,55,6200,7000,"Sub-basin 5"
1330,800,48,5700,6500,"Sub-basin 5"
1331,100,1,1000,1100,"Sub-basin 5"
1332,600,42,1600,2200,"Sub-basin 5"
1333,1500,141,7500,9000,"Sub-basin 5"
1334,400,12,2200,2600,"Sub-basin 5"
1335,3400,689.34,6700,10100,"Sub-basin 5"
1336,300,10,1900,2200,"Sub-basin 5"
1337,200,8,900,1100,"Sub-basin 5"
1338,300,18,1900,2200,"Sub-basin 5"
1339,1000,36,2700,3700,"Sub-basin 5"
1340,200,6,1200,1400,"Sub-basin 5"
1341,1400,79,8200,9600,"Sub-basin 5"
1342,1300,122.34,6000,7300,"Sub-basin 5"
1343,200,4,4400,4600,"Sub-basin 5"
1344,400,17,2700,3100,"Sub-basin 5"
1345,200,9,2400,2600,"Sub-basin 5"
1346,4200,1052.33,8300,12500,"Sub-basin 5"
1347,1100,289,4300,5400,"Sub-basin 5"
1348,200,5,1600,1800,"Sub-basin 5"
1349,200,5,3100,3300,"Sub-basin 5"
1350,900,116,7400,8300,"Sub-basin 5"
1351,200,11,1900,2100,"Sub-basin 5"
1352,500,40,1700,2200,"Sub-basin 5"
1353,300,5,1800,2100,"Sub-basin 5"
1354,7900,1595.33,26300,34200,"Sub-basin 5"
1355,200,4,2500,2700,"Sub-basin 5"
1356,100,0.66,1200,1300,"Sub-basin 5"
1357,6000,1351.83,9200,15200,"Sub-basin 5"
1358,3500,926.33,5000,8500,"Sub-basin 5"
1359,200,7,3800,4000,"Sub-basin 5"
1360,700,55,3200,3900,"Sub-basin 5"
1361,200,9,2400,2600,"Sub-basin 5"
1362,200,4,2400,2600,"Sub-basin 5"
1363,1800,152.67,8000,9800,"Sub-basin 5"
1364,9300,4999.84,11500,20800,"Sub-basin 5"
1365,1100,145,4300,5400,"Sub-basin 5"
1366,200,23,2400,2600,"Sub-basin 5"
1367,200,3,1000,1200,"Sub-basin 5"
1368,8600,1228,18000,26600,"Sub-basin 5"
1369,900,50,1700,2600,"Sub-basin 5"
1370,100,1,1600,1700,"Sub-basin 5"
1371,100,1,1300,1400,"Sub-basin 5"
1372,1200,44,5100,6300,"Sub-basin 5"
1373,900,174,5400,6300,"Sub-basin 5"
1374,300,7,2100,2400,"Sub-basin 5"
1375,2300,710.8,4600,6900,"Sub-basin 5"
1376,300,9.49,1300,1600,"Sub-basin 5"
1377,200,6,1500,1700,"Sub-basin 5"
1378,300,4.33,2900,3200,"Sub-basin 5"
1379,1800,109.33,12700,14500,"Sub-basin 5"
1380,100,3,1700,1800,"Sub-basin 5"
1381,3200,733.01,10100,13300,"Sub-basin 5"
1382,1100,204.83,2500,3600,"Sub-basin 5"
1383,900,119.5,4500,5400,"Sub-basin 5"
1384,200,2,1800,2000,"Sub-basin 5"
1385,1700,187,10100,11800,"Sub-basin 5"
1386,5700,526.32,40300,46000,"Sub-basin 5"
1387,700,17,3700,4400,"Sub-basin 5"
1388,200,4,1200,1400,"Sub-basin 5"
1389,300,4,1000,1300,"Sub-basin 5"
1390,400,45,2700,3100,"Sub-basin 5"
1391,900,51,4900,5800,"Sub-basin 5"
1392,200,5,2300,2500,"Sub-basin 5"
1393,500,15,2600,3100,"Sub-basin 5"
1394,200,12,1300,1500,"Sub-basin 5"
1395,12000,1851,41500,53500,"Sub-basin 5"
1396,100,4,900,1000,"Sub-basin 5"
1397,200,8.66,1500,1700,"Sub-basin 5"
1398,200,3,4100,4300,"Sub-basin 5"
1399,500,22,5800,6300,"Sub-basin 5"
1400,500,15,9200,9700,"Sub-basin 5"
1401,1400,186,2800,4200,"Sub-basin 5"
1402,100,2,2000,2100,"Sub-basin 5"
1403,700,37,7600,8300,"Sub-basin 5"
1404,200,5,2400,2600,"Sub-basin 5"
1405,500,17,3400,3900,"Sub-basin 5"
1406,1000,156,2700,3700,"Sub-basin 5"
1407,500,41,2300,2800,"Sub-basin 5"
1408,100,2,1300,1400,"Sub-basin 5"
1409,4400,1033,6300,10700,"Sub-basin 5"
1410,100,2,600,700,"Sub-basin 5"
1411,200,11,2300,2500,"Sub-basin 5"
1412,900,114,1900,2800,"Sub-basin 5"
1413,1900,204,9600,11500,"Sub-basin 5"
1414,200,2,2400,2600,"Sub-basin 5"
1415,3400,922,6700,10100,"Sub-basin 5"
1416,100,2,300,400,"Sub-basin 5"
1417,400,10,1200,1600,"Sub-basin 5"
1418,900,133,2700,3600,"Sub-basin 5"
1419,100,1,1300,1400,"Sub-basin 5"
1420,100,2,1200,1300,"Sub-basin 5"
1421,300,22,3800,4100,"Sub-basin 5"
1422,300,17,4800,5100,"Sub-basin 5"
1423,2200,344,8200,10400,"Sub-basin 5"
1424,100,5,900,1000,"Sub-basin 5"
1425,100,1,2200,2300,"Sub-basin 5"
1426,100,1,1500,1600,"Sub-basin 5"
1427,900,43,5400,6300,"Sub-basin 5"
1428,300,9,3600,3900,"Sub-basin 5"
1429,700,164,1700,2400,"Sub-basin 5"
1430,600,97,1900,2500,"Sub-basin 5"
1431,100,4,2300,2400,"Sub-basin 5"
1432,600,35,6500,7100,"Sub-basin 5"
1433,100,2,1400,1500,"Sub-basin 5"
1434,800,82,5500,6300,"Sub-basin 5"
1435,200,5,4300,4500,"Sub-basin 5"
1436,1000,109,3700,4700,"Sub-basin 5"
1437,18600,9864,22300,40900,"Sub-basin 5"
1438,400,80,1000,1400,"Sub-basin 5"
1439,100,1,800,900,"Sub-basin 5"
1440,1700,104,7900,9600,"Sub-basin 5"
1441,200,4,2700,2900,"Sub-basin 5"
1442,100,2,1400,1500,"Sub-basin 5"
1443,100,1,800,900,"Sub-basin 5"
1444,100,4,1500,1600,"Sub-basin 5"
1445,100,6,700,800,"Sub-basin 5"
1446,100,5,900,1000,"Sub-basin 5"
1447,700,69,2700,3400,"Sub-basin 5"
1448,500,14,4800,5300,"Sub-basin 5"
1449,400,10,4100,4500,"Sub-basin 5"
1450,600,163,1400,2000,"Sub-basin 5"
1451,11100,4734,15800,26900,"Sub-basin 5"
1452,1500,694,3200,4700,"Sub-basin 5"
1453,300,9,500,800,"Sub-basin 5"
1454,400,17,2500,2900,"Sub-basin 5"
1455,1100,178,7700,8800,"Sub-basin 5"
1456,800,103,4300,5100,"Sub-basin 5"
1457,700,40,6400,7100,"Sub-basin 5"
1458,1500,108,10500,12000,"Sub-basin 5"
1459,2800,316,12300,15100,"Sub-basin 5"
1460,1000,107,3000,4000,"Sub-basin 5"
1461,100,10,800,900,"Sub-basin 5"
1462,300,10,2400,2700,"Sub-basin 5"
1463,200,8,1900,2100,"Sub-basin 5"
1464,600,33,3600,4200,"Sub-basin 5"
1465,400,37,700,1100,"Sub-basin 5"
1466,69200,6764.51,160300,229500,"Sub-basin 5"
1467,100,2,900,1000,"Sub-basin 5"
1468,700,79,1800,2500,"Sub-basin 5"
1469,100,1,500,600,"Sub-basin 5"
1470,600,20,6200,6800,"Sub-basin 5"
1471,100,1,1300,1400,"Sub-basin 5"
1472,500,25,6500,7000,"Sub-basin 5"
1473,100,2,1000,1100,"Sub-basin 5"
1474,2400,158,13800,16200,"Sub-basin 5"
1475,100,2,500,600,"Sub-basin 5"
1476,400,16.16,3900,4300,"Sub-basin 5"
1477,1200,71,9200,10400,"Sub-basin 5"
1478,100,5,1200,1300,"Sub-basin 5"
1479,3500,1757,4300,7800,"Sub-basin 5"
1480,1000,242,2800,3800,"Sub-basin 5"
1481,400,38,700,1100,"Sub-basin 5"
1482,400,20,2400,2800,"Sub-basin 5"
1483,600,31,5200,5800,"Sub-basin 5"
1484,200,2,2100,2300,"Sub-basin 5"
1485,600,61,1600,2200,"Sub-basin 5"
1486,1500,250,4700,6200,"Sub-basin 5"
1487,100,4,1000,1100,"Sub-basin 5"
1488,200,10,1200,1400,"Sub-basin 5"
1489,200,7,3900,4100,"Sub-basin 5"
1490,200,6,1600,1800,"Sub-basin 5"
1491,100,1,2900,3000,"Sub-basin 5"
1492,100,2,1100,1200,"Sub-basin 5"
1493,300,22,1600,1900,"Sub-basin 5"
1494,2900,208,9700,12600,"Sub-basin 5"
1495,300,16,3200,3500,"Sub-basin 5"
1496,4200,475,19000,23200,"Sub-basin 5"
1497,6700,693,29700,36400,"Sub-basin 5"
1498,100,3,1800,1900,"Sub-basin 5"
1499,700,143,3000,3700,"Sub-basin 5"
1500,700,149,2400,3100,"Sub-basin 5"
1501,2200,215,6300,8500,"Sub-basin 5"
1502,900,29,9600,10500,"Sub-basin 5"
1503,700,36,4400,5100,"Sub-basin 5"
1504,100,1,700,800,"Sub-basin 5"
1505,200,27,1100,1300,"Sub-basin 5"
1506,100,1,400,500,"Sub-basin 5"
1507,500,38,4300,4800,"Sub-basin 5"
1508,300,11,3700,4000,"Sub-basin 5"
1509,100,2,1000,1100,"Sub-basin 5"
1510,3900,395,4600,8500,"Sub-basin 5"
1511,1200,131,2400,3600,"Sub-basin 5"
1512,15200,5781.34,14900,30100,"Sub-basin 5"
1513,400,9,1800,2200,"Sub-basin 5"
1514,200,3,2400,2600,"Sub-basin 5"
1515,1600,68,11900,13500,"Sub-basin 5"
1516,500,14,3700,4200,"Sub-basin 5"
1517,200,20,400,600,"Sub-basin 5"
1518,5400,1027,15400,20800,"Sub-basin 5"
1519,100,2,1500,1600,"Sub-basin 5"
1520,400,16,3800,4200,"Sub-basin 5"
1521,3700,324,23500,27200,"Sub-basin 5"
1522,100,3,1500,1600,"Sub-basin 5"
1523,2600,1394,7300,9900,"Sub-basin 5"
1524,100,2,1000,1100,"Sub-basin 5"
1525,4400,1181,18000,22400,"Sub-basin 5"
1526,100,3,1100,1200,"Sub-basin 5"
1527,200,9,1300,1500,"Sub-basin 5"
1528,4700,943,16900,21600,"Sub-basin 5"
1529,200,6,2500,2700,"Sub-basin 5"
1530,100,1,1600,1700,"Sub-basin 5"
1531,6200,2095,13100,19300,"Sub-basin 5"
1532,200,3,2600,2800,"Sub-basin 5"
1533,100,3,1900,2000,"Sub-basin 5"
1534,500,29,5100,5600,"Sub-basin 5"
1535,100,1,1800,1900,"Sub-basin 5"
1536,1200,32,11500,12700,"Sub-basin 5"
1537,1500,208,8200,9700,"Sub-basin 5"
1538,200,6,1500,1700,"Sub-basin 5"
1539,100,3,1900,2000,"Sub-basin 5"
1540,700,28,5000,5700,"Sub-basin 5"
1541,800,39,5300,6100,"Sub-basin 5"
1542,200,5,900,1100,"Sub-basin 5"
1543,1300,331,4100,5400,"Sub-basin 5"
1544,900,186,1500,2400,"Sub-basin 5"
1545,600,109,2800,3400,"Sub-basin 5"
1546,1700,181,6600,8300,"Sub-basin 5"
1547,3800,1073,7400,11200,"Sub-basin 5"
1548,1200,159,2900,4100,"Sub-basin 5"
1549,7300,1303.33,15100,22400,"Sub-basin 5"
1550,100,1,2000,2100,"Sub-basin 5"
1551,300,22,1900,2200,"Sub-basin 5"
1552,100,2,1300,1400,"Sub-basin 5"
1553,100,3,1400,1500,"Sub-basin 5"
1554,3700,1217,6400,10100,"Sub-basin 5"
1555,900,85,2200,3100,"Sub-basin 5"
1556,100,1,700,800,"Sub-basin 5"
1557,1300,116,15000,16300,"Sub-basin 5"
1558,300,9,2500,2800,"Sub-basin 5"
1559,5000,226,23200,28200,"Sub-basin 5"
1560,500,30,3700,4200,"Sub-basin 5"
1561,4000,814,16500,20500,"Sub-basin 5"
1562,200,10,1200,1400,"Sub-basin 5"
1563,800,184,2200,3000,"Sub-basin 5"
1564,200,4,1700,1900,"Sub-basin 5"
1565,500,21,4400,4900,"Sub-basin 5"
1566,800,81,2600,3400,"Sub-basin 5"
1567,1200,92,7300,8500,"Sub-basin 5"
1568,400,24,1500,1900,"Sub-basin 5"
1569,400,53,1400,1800,"Sub-basin 5"
1570,200,9,1500,1700,"Sub-basin 5"
1571,700,97,2300,3000,"Sub-basin 5"
1572,200,4,3900,4100,"Sub-basin 5"
1573,500,16,3900,4400,"Sub-basin 5"
1574,500,24,4700,5200,"Sub-basin 5"
1575,800,35,7100,7900,"Sub-basin 5"
1576,200,3,1500,1700,"Sub-basin 5"
1577,200,11,2100,2300,"Sub-basin 5"
1578,100,3,600,700,"Sub-basin 5"
1579,900,371,5400,6300,"Sub-basin 5"
1580,200,4,1300,1500,"Sub-basin 5"
1581,5200,1633,10600,15800,"Sub-basin 5"
1582,300,6,4200,4500,"Sub-basin 5"
1583,100,2,900,1000,"Sub-basin 5"
1584,600,35,5900,6500,"Sub-basin 5"
1585,200,8,1200,1400,"Sub-basin 5"
1586,100,7,800,900,"Sub-basin 5"
1587,100,2,300,400,"Sub-basin 5"
1588,200,2,1500,1700,"Sub-basin 5"
1589,2600,1014,4400,7000,"Sub-basin 5"
1590,6200,1915.67,9200,15400,"Sub-basin 5"
1591,2700,368,8500,11200,"Sub-basin 5"
1592,1400,200,5600,7000,"Sub-basin 5"
1593,200,3,3000,3200,"Sub-basin 5"
1594,100,1,1800,1900,"Sub-basin 5"
1595,100,4,1100,1200,"Sub-basin 5"
1596,400,19,2300,2700,"Sub-basin 5"
1597,400,26,1700,2100,"Sub-basin 5"
1598,400,26,3400,3800,"Sub-basin 5"
1599,800,111,2900,3700,"Sub-basin 5"
1600,1500,354,3800,5300,"Sub-basin 5"
1601,3300,475,10000,13300,"Sub-basin 5"
1602,100,2,2000,2100,"Sub-basin 5"
1603,100,1,1300,1400,"Sub-basin 5"
1604,2400,1307,7100,9500,"Sub-basin 5"
1605,700,43,3200,3900,"Sub-basin 5"
1606,2700,942,7000,9700,"Sub-basin 5"
1607,200,10,3200,3400,"Sub-basin 5"
1608,1000,76,4100,5100,"Sub-basin 5"
1609,100,2,2800,2900,"Sub-basin 5"
1610,100,3,1700,1800,"Sub-basin 5"
1611,100,1,1000,1100,"Sub-basin 5"
1612,100,3,300,400,"Sub-basin 5"
1613,100,1,1000,1100,"Sub-basin 5"
1614,100,1,1000,1100,"Sub-basin 5"
1615,4300,2036,5900,10200,"Sub-basin 5"
1616,1000,177,4100,5100,"Sub-basin 5"
1617,200,18,1500,1700,"Sub-basin 5"
1618,500,16,3800,4300,"Sub-basin 5"
1619,300,13,1500,1800,"Sub-basin 5"
1620,100,1,1700,1800,"Sub-basin 5"
1621,900,276.83,2900,3800,"Sub-basin 5"
1622,500,17,2800,3300,"Sub-basin 5"
1623,600,42,2400,3000,"Sub-basin 5"
1624,4000,1077,4600,8600,"Sub-basin 5"
1625,600,86,2600,3200,"Sub-basin 5"
1626,300,17,3600,3900,"Sub-basin 5"
1627,1800,182,6200,8000,"Sub-basin 5"
1628,100,3,1600,1700,"Sub-basin 5"
1629,2400,327,9600,12000,"Sub-basin 5"
1630,4400,1260,23800,28200,"Sub-basin 5"
1631,100,1,1400,1500,"Sub-basin 5"
1632,200,7,2800,3000,"Sub-basin 5"
1633,1000,57,7600,8600,"Sub-basin 5"
1634,100,1,1900,2000,"Sub-basin 5"
1635,400,15,800,1200,"Sub-basin 5"
1636,100,2,1600,1700,"Sub-basin 5"
1637,600,45,5700,6300,"Sub-basin 5"
1638,200,25,1600,1800,"Sub-basin 5"
1639,300,17,2900,3200,"Sub-basin 5"
1640,700,18,8000,8700,"Sub-basin 5"
1641,5400,661.83,31200,36600,"Sub-basin 5"
1642,4900,1157,13700,18600,"Sub-basin 5"
1643,100,2,300,400,"Sub-basin 5"
1644,3100,1340,2900,6000,"Sub-basin 5"
1645,600,96,4500,5100,"Sub-basin 5"
1646,1900,308,9400,11300,"Sub-basin 5"
1647,1700,328,5500,7200,"Sub-basin 5"
1648,700,31,5700,6400,"Sub-basin 5"
1649,100,3,1400,1500,"Sub-basin 5"
1650,400,10,3000,3400,"Sub-basin 5"
1651,1100,111,8800,9900,"Sub-basin 5"
1652,100,3,1200,1300,"Sub-basin 5"
1653,400,13,3200,3600,"Sub-basin 5"
1654,1900,119,7100,9000,"Sub-basin 5"
1655,3100,141,21200,24300,"Sub-basin 5"
1656,100,1,1000,1100,"Sub-basin 5"
1657,400,24,4400,4800,"Sub-basin 5"
1658,3400,1352,7000,10400,"Sub-basin 5"
1659,200,9,2700,2900,"Sub-basin 5"
1660,100,2,600,700,"Sub-basin 5"
1661,21000,9046,29100,50100,"Sub-basin 5"
1662,1000,103,3200,4200,"Sub-basin 5"
1663,700,54,3400,4100,"Sub-basin 5"
1664,200,3,2500,2700,"Sub-basin 5"
1665,100,2,1000,1100,"Sub-basin 5"
1666,2800,218,13500,16300,"Sub-basin 5"
1667,500,11,5200,5700,"Sub-basin 5"
1668,1300,47,4700,6000,"Sub-basin 5"
1669,100,3,800,900,"Sub-basin 5"
1670,500,43,2900,3400,"Sub-basin 5"
1671,1000,43,6000,7000,"Sub-basin 5"
1672,600,27,6100,6700,"Sub-basin 5"
1673,2500,255,10600,13100,"Sub-basin 5"
1674,1000,76,3800,4800,"Sub-basin 5"
1675,1800,153,12200,14000,"Sub-basin 5"
1676,200,8,2000,2200,"Sub-basin 5"
1677,900,33,6200,7100,"Sub-basin 5"
1678,100,1,2200,2300,"Sub-basin 5"
1679,100,1,1400,1500,"Sub-basin 5"
1680,100,3,1700,1800,"Sub-basin 5"
1681,200,2,1500,1700,"Sub-basin 5"
1682,3500,634,18000,21500,"Sub-basin 5"
1683,100,1,1700,1800,"Sub-basin 5"
1684,600,80,2200,2800,"Sub-basin 5"
1685,100,4,500,600,"Sub-basin 5"
1686,900,197,2400,3300,"Sub-basin 5"
1687,4300,4068,7100,11400,"Sub-basin 5"
1688,1100,47,7300,8400,"Sub-basin 5"
1689,600,35,4900,5500,"Sub-basin 5"
1690,100,1,1900,2000,"Sub-basin 5"
1691,1500,194,3500,5000,"Sub-basin 5"
1692,4400,1246,11200,15600,"Sub-basin 5"
1693,11800,5374,9500,21300,"Sub-basin 5"
1694,200,2,2400,2600,"Sub-basin 5"
1695,400,37,1700,2100,"Sub-basin 5"
1696,400,21,2900,3300,"Sub-basin 5"
1697,600,29,5400,6000,"Sub-basin 5"
1698,100,5,2200,2300,"Sub-basin 5"
1699,100,1,1400,1500,"Sub-basin 5"
1700,200,3,400,600,"Sub-basin 5"
1701,900,139,3000,3900,"Sub-basin 5"
1702,1800,656,2800,4600,"Sub-basin 5"
1703,400,34,2700,3100,"Sub-basin 5"
1704,200,5,1700,1900,"Sub-basin 5"
1705,100,3,1500,1600,"Sub-basin 5"
1706,700,40,6300,7000,"Sub-basin 5"
1707,100,1,2100,2200,"Sub-basin 5"
1708,700,49,4300,5000,"Sub-basin 5"
1709,1500,294,5500,7000,"Sub-basin 5"
1710,1500,517,2100,3600,"Sub-basin 5"
1711,100,1,1000,1100,"Sub-basin 5"
1712,200,2,2700,2900,"Sub-basin 5"
1713,100,3,1500,1600,"Sub-basin 5"
1714,300,5,300,600,"Sub-basin 5"
1715,300,17,800,1100,"Sub-basin 5"
1716,1200,66,3600,4800,"Sub-basin 5"
1717,100,1,1000,1100,"Sub-basin 5"
1718,1300,107,15500,16800,"Sub-basin 5"
1719,200,25,2700,2900,"Sub-basin 5"
1720,200,14,3000,3200,"Sub-basin 5"
1721,600,32,2600,3200,"Sub-basin 5"
1722,200,6,2200,2400,"Sub-basin 5"
1723,200,3,1800,2000,"Sub-basin 5"
1724,200,4,2900,3100,"Sub-basin 5"
1725,6000,295,26500,32500,"Sub-basin 5"
1726,300,22,2400,2700,"Sub-basin 5"
1727,300,28,2400,2700,"Sub-basin 5"
1728,3500,1239,5800,9300,"Sub-basin 5"
1729,600,35,7800,8400,"Sub-basin 5"
1730,1800,70,7900,9700,"Sub-basin 5"
1731,100,2,900,1000,"Sub-basin 5"
1732,1500,79,5500,7000,"Sub-basin 5"
1733,300,19,1900,2200,"Sub-basin 5"
1734,600,29,4000,4600,"Sub-basin 5"
1735,400,39,2400,2800,"Sub-basin 5"
1736,4100,800,11100,15200,"Sub-basin 5"
1737,700,14.48,5600,6300,"Sub-basin 5"
1738,100,1,1700,1800,"Sub-basin 5"
1739,200,15,2100,2300,"Sub-basin 5"
1740,400,52,2500,2900,"Sub-basin 5"
1741,200,15,2000,2200,"Sub-basin 5"
1742,3800,1066,6200,10000,"Sub-basin 5"
1743,7900,3077,10700,18600,"Sub-basin 5"
1744,200,8,1500,1700,"Sub-basin 5"
1745,100,2,2000,2100,"Sub-basin 5"
1746,300,15,2300,2600,"Sub-basin 5"
1747,100,1,300,400,"Sub-basin 5"
1748,600,85,2600,3200,"Sub-basin 5"
1749,600,47,3600,4200,"Sub-basin 5"
1750,300,6,3100,3400,"Sub-basin 5"
1751,4600,1107,7300,11900,"Sub-basin 5"
1752,900,124,3400,4300,"Sub-basin 5"
1753,500,22,3300,3800,"Sub-basin 5"
1754,200,4,2000,2200,"Sub-basin 5"
1755,2100,492,8800,10900,"Sub-basin 5"
1756,200,4,900,1100,"Sub-basin 5"
1757,500,35,800,1300,"Sub-basin 5"
1758,300,12,100,400,"Sub-basin 5"
1759,100,1,400,500,"Sub-basin 5"
1760,200,17,900,1100,"Sub-basin 5"
1761,100,7,500,600,"Sub-basin 5"
1762,700,22,8800,9500,"Sub-basin 5"
1763,200,32,1300,1500,"Sub-basin 5"
1764,100,12,800,900,"Sub-basin 5"
1765,200,5,600,800,"Sub-basin 5"
1766,200,4,2100,2300,"Sub-basin 5"
1767,400,11,2700,3100,"Sub-basin 5"
1768,100,1,1700,1800,"Sub-basin 5"
1769,200,5,1100,1300,"Sub-basin 5"
1770,300,7,2300,2600,"Sub-basin 5"
1771,400,19,1700,2100,"Sub-basin 5"
1772,100,1,1100,1200,"Sub-basin 5"
1773,1700,195,6900,8600,"Sub-basin 5"
1774,700,15,3100,3800,"Sub-basin 5"
1775,1200,51,8300,9500,"Sub-basin 5"
1776,3100,310,4700,7800,"Sub-basin 5"
1777,100,1,1100,1200,"Sub-basin 5"
1778,600,57,4700,5300,"Sub-basin 5"
1779,100,3,700,800,"Sub-basin 5"
1780,100,1,900,1000,"Sub-basin 5"
1781,16000,3381.33,26900,42900,"Sub-basin 5"
1782,100,1,1400,1500,"Sub-basin 5"
1783,100,1,1600,1700,"Sub-basin 5"
1784,100,1,600,700,"Sub-basin 5"
1785,200,7,1200,1400,"Sub-basin 5"
1786,400,12,2200,2600,"Sub-basin 5"
1787,1000,152,3200,4200,"Sub-basin 5"
1788,5400,1251,9300,14700,"Sub-basin 5"
1789,200,10,3900,4100,"Sub-basin 5"
1790,15100,2587,52100,67200,"Sub-basin 5"
1791,400,20,2600,3000,"Sub-basin 5"
1792,2300,608,3500,5800,"Sub-basin 5"
1793,100,1,0,100,"Sub-basin 5"
1794,400,16,3600,4000,"Sub-basin 5"
1795,200,11,700,900,"Sub-basin 5"
1796,100,2,2800,2900,"Sub-basin 5"
1797,100,3,1600,1700,"Sub-basin 5"
1798,500,24,5300,5800,"Sub-basin 5"
1799,400,15,6400,6800,"Sub-basin 5"
1800,1100,72,11300,12400,"Sub-basin 5"
1801,100,7,1200,1300,"Sub-basin 5"
1802,400,33,3500,3900,"Sub-basin 5"
1803,100,1,900,1000,"Sub-basin 5"
1804,500,96,2100,2600,"Sub-basin 5"
1805,500,22,2100,2600,"Sub-basin 5"
1806,100,1,500,600,"Sub-basin 5"
1807,100,6,2100,2200,"Sub-basin 5"
1808,300,8,4500,4800,"Sub-basin 5"
1809,1100,70,8100,9200,"Sub-basin 5"
1810,300,11,1200,1500,"Sub-basin 5"
1811,1100,63,11700,12800,"Sub-basin 5"
1812,400,14,3500,3900,"Sub-basin 5"
1813,700,105,3100,3800,"Sub-basin 5"
1814,800,36,5100,5900,"Sub-basin 5"
1815,100,2,1000,1100,"Sub-basin 5"
1816,400,37,1700,2100,"Sub-basin 5"
1817,200,7,3400,3600,"Sub-basin 5"
1818,100,2,1100,1200,"Sub-basin 5"
1819,1500,205,8300,9800,"Sub-basin 5"
1820,200,3,800,1000,"Sub-basin 5"
1821,5500,1158,17800,23300,"Sub-basin 5"
1822,100,5,1900,2000,"Sub-basin 5"
1823,400,13,3700,4100,"Sub-basin 5"
1824,100,1,900,1000,"Sub-basin 5"
1825,400,10,2500,2900,"Sub-basin 5"
1826,100,1,1700,1800,"Sub-basin 5"
1827,100,4,600,700,"Sub-basin 5"
1828,300,15,4100,4400,"Sub-basin 5"
1829,300,7,1200,1500,"Sub-basin 5"
1830,200,10,1400,1600,"Sub-basin 5"
1831,100,1,1000,1100,"Sub-basin 5"
1832,300,10,1700,2000,"Sub-basin 5"
1833,1600,348,4200,5800,"Sub-basin 5"
1834,1600,93,7000,8600,"Sub-basin 5"
1835,300,8,4000,4300,"Sub-basin 5"
1836,7000,961,30300,37300,"Sub-basin 5"
1837,400,26,1500,1900,"Sub-basin 5"
1838,500,30,2700,3200,"Sub-basin 5"
1839,3300,904,9000,12300,"Sub-basin 5"
1840,7800,795,30000,37800,"Sub-basin 5"
1841,800,234,2400,3200,"Sub-basin 5"
1842,1400,106,10300,11700,"Sub-basin 5"
1843,200,10,2800,3000,"Sub-basin 5"
1844,7400,2056,26200,33600,"Sub-basin 5"
1845,100,2,2100,2200,"Sub-basin 5"
1846,100,7,1800,1900,"Sub-basin 5"
1847,800,60,9000,9800,"Sub-basin 5"
1848,700,45,7200,7900,"Sub-basin 5"
1849,300,8,1500,1800,"Sub-basin 5"
1850,300,19,4300,4600,"Sub-basin 5"
1851,100,1,1500,1600,"Sub-basin 5"
1852,1600,131,9900,11500,"Sub-basin 5"
1853,3000,1016.5,5600,8600,"Sub-basin 5"
1854,19500,3600,32800,52300,"Sub-basin 5"
1855,100,2,800,900,"Sub-basin 5"
1856,100,1,1500,1600,"Sub-basin 5"
1857,1100,206,3600,4700,"Sub-basin 5"
1858,500,14,3800,4300,"Sub-basin 5"
1859,100,1,900,1000,"Sub-basin 5"
1860,1600,42,19500,21100,"Sub-basin 5"
1861,200,5,1300,1500,"Sub-basin 5"
1862,100,4,1800,1900,"Sub-basin 5"
1863,900,49,10500,11400,"Sub-basin 5"
1864,200,24,1100,1300,"Sub-basin 5"
1865,200,11,1100,1300,"Sub-basin 5"
1866,500,8,7800,8300,"Sub-basin 5"
1867,2800,130,8000,10800,"Sub-basin 5"
1868,800,139,5200,6000,"Sub-basin 5"
1869,2300,168,12400,14700,"Sub-basin 5"
1870,400,21,1900,2300,"Sub-basin 5"
1871,5200,938,14800,20000,"Sub-basin 5"
1872,1400,194,4700,6100,"Sub-basin 5"
1873,30700,14231,26600,57300,"Sub-basin 5"
1874,100,3,1500,1600,"Sub-basin 5"
1875,200,5,2300,2500,"Sub-basin 5"
1876,600,72,1700,2300,"Sub-basin 5"
1877,200,3,1500,1700,"Sub-basin 5"
1878,800,50,5700,6500,"Sub-basin 5"
1879,400,24,3200,3600,"Sub-basin 5"
1880,300,14,2000,2300,"Sub-basin 5"
1881,300,18,2900,3200,"Sub-basin 5"
1882,100,1,800,900,"Sub-basin 5"
1883,300,8,1800,2100,"Sub-basin 5"
1884,200,6,1200,1400,"Sub-basin 5"
1885,100,1,1400,1500,"Sub-basin 5"
1886,100,6,500,600,"Sub-basin 5"
1887,100,2,1100,1200,"Sub-basin 5"
1888,100,2,2100,2200,"Sub-basin 5"
1889,200,2,1500,1700,"Sub-basin 5"
1890,300,92,1600,1900,"Sub-basin 5"
1891,200,5,2000,2200,"Sub-basin 5"
1892,900,38,3400,4300,"Sub-basin 5"
1893,1000,52,6800,7800,"Sub-basin 5"
1894,600,94,2400,3000,"Sub-basin 5"
1895,900,35,8500,9400,"Sub-basin 5"
1896,200,13,1200,1400,"Sub-basin 5"
1897,8100,1816,15200,23300,"Sub-basin 5"
1898,1500,458,3500,5000,"Sub-basin 5"
1899,100,3,1600,1700,"Sub-basin 5"
1900,100,1,1700,1800,"Sub-basin 5"
1901,300,3,3200,3500,"Sub-basin 5"
1902,1900,393.5,3700,5600,"Sub-basin 5"
1903,200,4,2500,2700,"Sub-basin 5"
1904,100,2,100,200,"Sub-basin 5"
1905,500,179,3500,4000,"Sub-basin 5"
1906,400,16,2300,2700,"Sub-basin 5"
1907,1000,102,4200,5200,"Sub-basin 5"
1908,100,1,1400,1500,"Sub-basin 5"
1909,300,13,800,1100,"Sub-basin 5"
1910,3600,227,34000,37600,"Sub-basin 5"
1911,100,1,1400,1500,"Sub-basin 5"
1912,200,9,1900,2100,"Sub-basin 5"
1913,600,30,3600,4200,"Sub-basin 5"
1914,200,9,2900,3100,"Sub-basin 5"
1915,100,3,1600,1700,"Sub-basin 5"
1916,200,2,1700,1900,"Sub-basin 5"
1917,100,1,1300,1400,"Sub-basin 5"
1918,100,3,2400,2500,"Sub-basin 5"
1919,300,6,1800,2100,"Sub-basin 5"
1920,100,1,900,1000,"Sub-basin 5"
1921,600,23,900,1500,"Sub-basin 5"
1922,200,5,800,1000,"Sub-basin 5"
1923,1200,88,4100,5300,"Sub-basin 5"
1924,100,1,1000,1100,"Sub-basin 5"
1925,600,19,2300,2900,"Sub-basin 5"
1926,1300,501,3000,4300,"Sub-basin 5"
1927,5100,1881,9300,14400,"Sub-basin 5"
1928,45700,10919.5,106100,151800,"Sub-basin 5"
1929,100,1,2300,2400,"Sub-basin 5"
1930,500,26,6600,7100,"Sub-basin 5"
1931,4000,618,8600,12600,"Sub-basin 5"
1932,1400,74,6700,8100,"Sub-basin 5"
1933,400,9,4300,4700,"Sub-basin 5"
1934,100,4,2300,2400,"Sub-basin 5"
1935,100,3,900,1000,"Sub-basin 5"
1936,200,10,900,1100,"Sub-basin 5"
1937,100,3,1100,1200,"Sub-basin 5"
1938,200,4,1100,1300,"Sub-basin 5"
1939,100,3,500,600,"Sub-basin 5"
1940,200,5,1500,1700,"Sub-basin 5"
1941,600,26,1000,1600,"Sub-basin 5"
1942,100,1,700,800,"Sub-basin 5"
1943,1300,74,6100,7400,"Sub-basin 5"
1944,200,4,700,900,"Sub-basin 5"
1945,100,1,300,400,"Sub-basin 5"
1946,100,2,1600,1700,"Sub-basin 5"
1947,3100,226,12100,15200,"Sub-basin 5"
1948,3400,1076,5800,9200,"Sub-basin 5"
1949,100,7,800,900,"Sub-basin 5"
1950,100,2,1600,1700,"Sub-basin 5"
1951,500,20,5000,5500,"Sub-basin 5"
1952,1000,164,4100,5100,"Sub-basin 5"
1953,2600,298,13900,16500,"Sub-basin 5"
1954,200,13,1400,1600,"Sub-basin 5"
1955,500,23,2700,3200,"Sub-basin 5"
1956,15400,4386,31400,46800,"Sub-basin 5"
1957,600,16,2400,3000,"Sub-basin 5"
1958,200,5,600,800,"Sub-basin 5"
1959,1900,91,10600,12500,"Sub-basin 5"
1960,100,1,1300,1400,"Sub-basin 5"
1961,400,24,3600,4000,"Sub-basin 5"
1962,400,33,1500,1900,"Sub-basin 5"
1963,300,11,2600,2900,"Sub-basin 5"
1964,800,19,2400,3200,"Sub-basin 5"
1965,1000,75,6600,7600,"Sub-basin 5"
1966,800,37,7700,8500,"Sub-basin 5"
1967,1100,78,3800,4900,"Sub-basin 5"
1968,400,25,2500,2900,"Sub-basin 5"
1969,400,17,2000,2400,"Sub-basin 5"
1970,900,134,3600,4500,"Sub-basin 5"
1971,100,1,1700,1800,"Sub-basin 5"
1972,100,1,1700,1800,"Sub-basin 5"
1973,1200,118,11400,12600,"Sub-basin 5"
1974,700,57,5000,5700,"Sub-basin 5"
1975,3200,365,17700,20900,"Sub-basin 5"
1976,100,1,1800,1900,"Sub-basin 5"
1977,1200,203,3400,4600,"Sub-basin 5"
1978,2800,238,21500,24300,"Sub-basin 5"
1979,100,1,500,600,"Sub-basin 5"
1980,19800,7569,27900,47700,"Sub-basin 5"
1981,800,77,2600,3400,"Sub-basin 5"
1982,300,8,2700,3000,"Sub-basin 5"
1983,1900,100,8200,10100,"Sub-basin 5"
1984,500,21,8900,9400,"Sub-basin 5"
1985,600,15,6800,7400,"Sub-basin 5"
1986,700,22,5900,6600,"Sub-basin 5"
1987,1300,173,4800,6100,"Sub-basin 5"
1988,100,3,2200,2300,"Sub-basin 5"
1989,600,39,3200,3800,"Sub-basin 5"
1990,100,2,100,200,"Sub-basin 5"
1991,100,3,1000,1100,"Sub-basin 5"
1992,200,4,100,300,"Sub-basin 5"
1993,500,18,2700,3200,"Sub-basin 5"
1994,1600,121,10800,12400,"Sub-basin 5"
1995,1800,148,15700,17500,"Sub-basin 5"
1996,3700,1212.99,7600,11300,"Sub-basin 5"
1997,300,15,3900,4200,"Sub-basin 5"
1998,500,46,2800,3300,"Sub-basin 5"
1999,300,5,3100,3400,"Sub-basin 5"
2000,800,47,8900,9700,"Sub-basin 5"
2001,200,10,2600,2800,"Sub-basin 5"
2002,1700,272,3400,5100,"Sub-basin 5"
2003,200,3,1900,2100,"Sub-basin 5"
2004,100,1,1000,1100,"Sub-basin 5"
2005,100,2,1700,1800,"Sub-basin 5"
2006,200,5,2500,2700,"Sub-basin 5"
2007,600,52,3700,4300,"Sub-basin 5"
2008,1100,64,3900,5000,"Sub-basin 5"
2009,200,2,1000,1200,"Sub-basin 5"
2010,800,298,3600,4400,"Sub-basin 5"
2011,8600,3490,12400,21000,"Sub-basin 5"
2012,400,52,1700,2100,"Sub-basin 5"
2013,100,4,700,800,"Sub-basin 5"
2014,100,1,1500,1600,"Sub-basin 5"
2015,400,6,2800,3200,"Sub-basin 5"
2016,700,31,3600,4300,"Sub-basin 5"
2017,800,53,4000,4800,"Sub-basin 5"
2018,200,13,1100,1300,"Sub-basin 5"
2019,300,4,1700,2000,"Sub-basin 5"
2020,400,8,4000,4400,"Sub-basin 5"
2021,300,20,1200,1500,"Sub-basin 5"
2022,100,2,200,300,"Sub-basin 5"
2023,1900,393,4700,6600,"Sub-basin 5"
2024,200,4,1900,2100,"Sub-basin 5"
2025,100,4,800,900,"Sub-basin 5"
2026,800,85,6400,7200,"Sub-basin 5"
2027,200,4,3300,3500,"Sub-basin 5"
2028,100,3,700,800,"Sub-basin 5"
2029,100,2,1300,1400,"Sub-basin 5"
2030,900,71,2500,3400,"Sub-basin 5"
2031,100,4,2100,2200,"Sub-basin 5"
2032,100,1,1200,1300,"Sub-basin 5"
2033,500,105,700,1200,"Sub-basin 5"
2034,3900,501,10900,14800,"Sub-basin 5"
2035,300,20,600,900,"Sub-basin 5"
2036,100,1,300,400,"Sub-basin 5"
2037,1200,28,5900,7100,"Sub-basin 5"
2038,300,15,1900,2200,"Sub-basin 5"
2039,4700,976,13200,17900,"Sub-basin 5"
2040,700,27,3300,4000,"Sub-basin 5"
2041,200,3,1200,1400,"Sub-basin 5"
2042,3200,758,8800,12000,"Sub-basin 5"
2043,1600,238,11200,12800,"Sub-basin 5"
2044,400,21,4600,5000,"Sub-basin 5"
2045,100,1,1300,1400,"Sub-basin 5"
2046,300,6,3100,3400,"Sub-basin 5"
2047,2000,223,8000,10000,"Sub-basin 5"
2048,800,99,9000,9800,"Sub-basin 5"
2049,200,4,1900,2100,"Sub-basin 5"
2050,4000,934,5300,9300,"Sub-basin 5"
2051,2700,180,29100,31800,"Sub-basin 5"
2052,400,14,6000,6400,"Sub-basin 5"
2053,900,56,2900,3800,"Sub-basin 5"
2054,700,24,8200,8900,"Sub-basin 5"
2055,300,12,900,1200,"Sub-basin 5"
2056,2900,217,29500,32400,"Sub-basin 5"
2057,100,3,1300,1400,"Sub-basin 5"
2058,300,8,4200,4500,"Sub-basin 5"
2059,100,5,1100,1200,"Sub-basin 5"
2060,1700,83,3600,5300,"Sub-basin 5"
2061,100,1,1200,1300,"Sub-basin 5"
2062,200,5,2000,2200,"Sub-basin 5"
2063,200,3,2700,2900,"Sub-basin 5"
2064,200,20,2400,2600,"Sub-basin 5"
2065,100,2,1500,1600,"Sub-basin 5"
2066,600,23,4700,5300,"Sub-basin 5"
2067,300,10,3600,3900,"Sub-basin 5"
2068,1100,86,12700,13800,"Sub-basin 5"
2069,200,9,3200,3400,"Sub-basin 5"
2070,10000,4801,12900,22900,"Sub-basin 5"
2071,1100,196,1600,2700,"Sub-basin 5"
2072,300,9,1800,2100,"Sub-basin 5"
2073,100,3,1900,2000,"Sub-basin 5"
2074,100,1,900,1000,"Sub-basin 5"
2075,200,3,2900,3100,"Sub-basin 5"
2076,300,12,2700,3000,"Sub-basin 5"
2077,100,1,1200,1300,"Sub-basin 5"
2078,900,48,11400,12300,"Sub-basin 5"
2079,200,8,3700,3900,"Sub-basin 5"
2080,100,2,2600,2700,"Sub-basin 5"
2081,400,17,4800,5200,"Sub-basin 5"
2082,500,19,4800,5300,"Sub-basin 5"
2083,400,19,1900,2300,"Sub-basin 5"
2084,700,31,5100,5800,"Sub-basin 5"
2085,200,12,1200,1400,"Sub-basin 5"
2086,900,143,3400,4300,"Sub-basin 5"
2087,1800,123,10600,12400,"Sub-basin 5"
2088,300,8,4300,4600,"Sub-basin 5"
2089,700,62,4100,4800,"Sub-basin 5"
2090,100,2,2200,2300,"Sub-basin 5"
2091,800,35,4800,5600,"Sub-basin 5"
2092,100,2,800,900,"Sub-basin 5"
2093,2700,546,9000,11700,"Sub-basin 5"
2094,200,7,2500,2700,"Sub-basin 5"
2095,1500,677,2200,3700,"Sub-basin 5"
2096,200,2,500,700,"Sub-basin 5"
2097,300,7,4100,4400,"Sub-basin 5"
2098,300,28,3200,3500,"Sub-basin 5"
2099,2300,236,9500,11800,"Sub-basin 5"
2100,400,44,1800,2200,"Sub-basin 5"
2101,1700,171,14700,16400,"Sub-basin 5"
2102,100,3,1100,1200,"Sub-basin 5"
2103,800,94,4500,5300,"Sub-basin 5"
2104,3800,472,15000,18800,"Sub-basin 5"
2105,200,7,3400,3600,"Sub-basin 5"
2106,700,45,2600,3300,"Sub-basin 5"
2107,100,1,800,900,"Sub-basin 5"
2108,200,8,1200,1400,"Sub-basin 5"
2109,2300,123,6100,8400,"Sub-basin 5"
2110,900,35,3500,4400,"Sub-basin 5"
2111,100,1,2700,2800,"Sub-basin 5"
2112,100,103.3963,1000,1100,"Sub-basin 5"
2113,400,14,4200,4600,"Sub-basin 5"
2114,100,5,1300,1400,"Sub-basin 5"
2115,400,23,4600,5000,"Sub-basin 5"
2116,6200,643,36100,42300,"Sub-basin 5"
2117,200,6,2900,3100,"Sub-basin 5"
2118,1900,340,2800,4700,"Sub-basin 5"
2119,1700,194,6400,8100,"Sub-basin 5"
2120,4100,1429.34,7400,11500,"Sub-basin 5"
2121,1800,374,10200,12000,"Sub-basin 5"
2122,400,32,2300,2700,"Sub-basin 5"
2123,100,1,900,1000,"Sub-basin 5"
2124,400,48,2700,3100,"Sub-basin 5"
2125,400,23,3600,4000,"Sub-basin 5"
2126,1300,94,8800,10100,"Sub-basin 5"
2127,6200,1808,16500,22700,"Sub-basin 5"
2128,500,27,2200,2700,"Sub-basin 5"
2129,100,3,800,900,"Sub-basin 5"
2130,100,1,1600,1700,"Sub-basin 5"
2131,100,1,1400,1500,"Sub-basin 5"
2132,100,1,2000,2100,"Sub-basin 5"
2133,400,12,1600,2000,"Sub-basin 5"
2134,800,42,3800,4600,"Sub-basin 5"
2135,2100,523,6300,8400,"Sub-basin 5"
2136,200,8,2300,2500,"Sub-basin 5"
2137,500,56,2200,2700,"Sub-basin 5"
2138,100,4,900,1000,"Sub-basin 5"
2139,800,77,4700,5500,"Sub-basin 5"
2140,100,1,2500,2600,"Sub-basin 5"
2141,100,3,1800,1900,"Sub-basin 5"
2142,300,14,3500,3800,"Sub-basin 5"
2143,800,39,2600,3400,"Sub-basin 5"
2144,100,5,800,900,"Sub-basin 5"
2145,200,5,600,800,"Sub-basin 5"
2146,8200,3700,8700,16900,"Sub-basin 5"
2147,600,66,7000,7600,"Sub-basin 5"
2148,100,3,900,1000,"Sub-basin 5"
2149,200,9,2200,2400,"Sub-basin 5"
2150,200,3,2900,3100,"Sub-basin 5"
2151,100,3,1400,1500,"Sub-basin 5"
2152,7500,2136,27300,34800,"Sub-basin 5"
2153,2400,728,7400,9800,"Sub-basin 5"
2154,100,5,1400,1500,"Sub-basin 5"
2155,400,22,3800,4200,"Sub-basin 5"
2156,800,53,9300,10100,"Sub-basin 5"
2157,300,13,2100,2400,"Sub-basin 5"
2158,400,17,2600,3000,"Sub-basin 5"
2159,12300,368,36200,48500,"Sub-basin 5"
2160,1500,665,3500,5000,"Sub-basin 5"
2161,100,4,700,800,"Sub-basin 5"
2162,700,31,9300,10000,"Sub-basin 5"
2163,100,2,1600,1700,"Sub-basin 5"
2164,100,1,2400,2500,"Sub-basin 5"
2165,300,18,3200,3500,"Sub-basin 5"
2166,500,92,3100,3600,"Sub-basin 5"
2167,100,3,900,1000,"Sub-basin 5"
2168,100,1,1300,1400,"Sub-basin 5"
2169,100,4,2500,2600,"Sub-basin 5"
2170,400,28,4900,5300,"Sub-basin 5"
2171,3000,1428,7700,10700,"Sub-basin 5"
2172,2100,556,4500,6600,"Sub-basin 5"
2173,300,8,2900,3200,"Sub-basin 5"
2174,800,95,5000,5800,"Sub-basin 5"
2175,1900,310,7300,9200,"Sub-basin 5"
2176,1100,58,5400,6500,"Sub-basin 5"
2177,200,5,3000,3200,"Sub-basin 5"
2178,100,2,700,800,"Sub-basin 5"
2179,200,15,1400,1600,"Sub-basin 5"
2180,3600,1800,5100,8700,"Sub-basin 5"
2181,1200,61,3500,4700,"Sub-basin 5"
2182,700,69.33,3200,3900,"Sub-basin 5"
2183,100,2,700,800,"Sub-basin 5"
2184,400,26,2200,2600,"Sub-basin 5"
2185,10200,1614,41600,51800,"Sub-basin 5"
2186,1100,43,6000,7100,"Sub-basin 5"
2187,600,17,5000,5600,"Sub-basin 5"
2188,100,3,1000,1100,"Sub-basin 5"
2189,800,172,3900,4700,"Sub-basin 5"
2190,900,57,3700,4600,"Sub-basin 5"
2191,100,7,1400,1500,"Sub-basin 5"
2192,200,5,1400,1600,"Sub-basin 5"
2193,3800,1266,6500,10300,"Sub-basin 5"
2194,100,1,2200,2300,"Sub-basin 5"
2195,100,1,1200,1300,"Sub-basin 5"
2196,100,3,1400,1500,"Sub-basin 5"
2197,1700,104,20500,22200,"Sub-basin 5"
2198,100,1,1200,1300,"Sub-basin 5"
2199,1400,155,4300,5700,"Sub-basin 5"
2200,1700,72,7900,9600,"Sub-basin 5"
2201,17300,736,44300,61600,"Sub-basin 5"
2202,7200,1198,21300,28500,"Sub-basin 5"
2203,1400,267,5200,6600,"Sub-basin 5"
2204,1200,70,10300,11500,"Sub-basin 5"
2205,1800,156,8400,10200,"Sub-basin 5"
2206,6400,2080,11100,17500,"Sub-basin 5"
2207,100,3,900,1000,"Sub-basin 5"
2208,1500,78,9600,11100,"Sub-basin 5"
2209,7300,959,30000,37300,"Sub-basin 5"
2210,1500,573,3000,4500,"Sub-basin 5"
2211,200,10,4400,4600,"Sub-basin 5"
2212,1900,229,7700,9600,"Sub-basin 5"
2213,200,2,2400,2600,"Sub-basin 5"
2214,600,65.5,2300,2900,"Sub-basin 5"
2215,500,26,2700,3200,"Sub-basin 5"
2216,600,32,1300,1900,"Sub-basin 5"
2217,6600,1043,23000,29600,"Sub-basin 5"
2218,4000,1640,10000,14000,"Sub-basin 5"
2219,100,3,1500,1600,"Sub-basin 5"
2220,200,8,3600,3800,"Sub-basin 5"
2221,100,2,1300,1400,"Sub-basin 5"
2222,200,8,2200,2400,"Sub-basin 5"
2223,100,1,1100,1200,"Sub-basin 5"
2224,800,29,7100,7900,"Sub-basin 5"
2225,100,5,3300,3400,"Sub-basin 5"
2226,2800,791,13500,16300,"Sub-basin 5"
2227,800,33,9600,10400,"Sub-basin 5"
2228,100,2,1100,1200,"Sub-basin 5"
2229,100,3,1000,1100,"Sub-basin 5"
2230,400,19,2600,3000,"Sub-basin 5"
2231,1800,113,9300,11100,"Sub-basin 5"
2232,400,12,3500,3900,"Sub-basin 5"
2233,300,13,2500,2800,"Sub-basin 5"
2234,1500,143,4900,6400,"Sub-basin 5"
2235,1300,164,5000,6300,"Sub-basin 5"
2236,1200,55,5800,7000,"Sub-basin 5"
2237,1100,73,5600,6700,"Sub-basin 5"
2238,200,3,1300,1500,"Sub-basin 5"
2239,200,14,1200,1400,"Sub-basin 5"
2240,200,15,1300,1500,"Sub-basin 5"
2241,32400,13263,26600,59000,"Sub-basin 5"
2242,200,11,2800,3000,"Sub-basin 5"
2243,1000,187,1700,2700,"Sub-basin 5"
2244,4900,358,13700,18600,"Sub-basin 5"
2245,100,1,300,400,"Sub-basin 5"
2246,100,140.3382,1500,1600,"Sub-basin 5"
2247,700,26,6500,7200,"Sub-basin 5"
2248,100,3,1500,1600,"Sub-basin 5"
2249,3100,725,7200,10300,"Sub-basin 5"
2250,100,8,1300,1400,"Sub-basin 5"
2251,2400,472,6600,9000,"Sub-basin 5"
2252,200,2,1800,2000,"Sub-basin 5"
2253,3600,1469,7300,10900,"Sub-basin 5"
2254,100,1,1600,1700,"Sub-basin 5"
2255,1400,163,4900,6300,"Sub-basin 5"
2256,300,12,3100,3400,"Sub-basin 5"
2257,3100,1183,6500,9600,"Sub-basin 5"
2258,600,104,2300,2900,"Sub-basin 5"
2259,100,2,1600,1700,"Sub-basin 5"
2260,300,12,1800,2100,"Sub-basin 5"
2261,1700,185,3100,4800,"Sub-basin 5"
2262,100,1,2700,2800,"Sub-basin 5"
2263,400,13,3700,4100,"Sub-basin 5"
2264,300,17,3700,4000,"Sub-basin 5"
2265,100,1,1500,1600,"Sub-basin 5"
2266,100,1,800,900,"Sub-basin 5"
2267,100,2,2900,3000,"Sub-basin 5"
2268,200,7,2200,2400,"Sub-basin 5"
2269,4300,306,32600,36900,"Sub-basin 5"
2270,100,6,1000,1100,"Sub-basin 5"
2271,3400,255,14200,17600,"Sub-basin 5"
2272,1500,80,9300,10800,"Sub-basin 5"
2273,2900,497,7500,10400,"Sub-basin 5"
2274,1400,122,4200,5600,"Sub-basin 5"
2275,100,2,800,900,"Sub-basin 5"
2276,300,16,1400,1700,"Sub-basin 5"
2277,800,77,5600,6400,"Sub-basin 5"
2278,900,218,2700,3600,"Sub-basin 5"
2279,100,1,1300,1400,"Sub-basin 5"
2280,1100,99,4000,5100,"Sub-basin 5"
2281,600,100,3000,3600,"Sub-basin 5"
2282,100,1,800,900,"Sub-basin 5"
2283,300,16,2400,2700,"Sub-basin 5"
2284,300,13,2000,2300,"Sub-basin 5"
2285,100,1,200,300,"Sub-basin 5"
2286,100,1,800,900,"Sub-basin 5"
2287,200,11,2700,2900,"Sub-basin 5"
2288,900,127,3800,4700,"Sub-basin 5"
2289,500,50,2700,3200,"Sub-basin 5"
2290,100,7,500,600,"Sub-basin 5"
2291,1400,159,7900,9300,"Sub-basin 5"
2292,100,1,1300,1400,"Sub-basin 5"
2293,3700,205,29100,32800,"Sub-basin 5"
2294,200,3,1500,1700,"Sub-basin 5"
2295,500,59,2200,2700,"Sub-basin 5"
2296,1100,131,3400,4500,"Sub-basin 5"
2297,400,24,4800,5200,"Sub-basin 5"
2298,1100,34,8600,9700,"Sub-basin 5"
2299,400,41,1400,1800,"Sub-basin 5"
2300,1100,81,7800,8900,"Sub-basin 5"
2301,400,27,3900,4300,"Sub-basin 5"
2302,1800,328,4400,6200,"Sub-basin 5"
2303,100,2,1600,1700,"Sub-basin 5"
2304,100,3,1500,1600,"Sub-basin 5"
2305,34300,6541,101400,135700,"Sub-basin 5"
2306,200,13,1600,1800,"Sub-basin 5"
2307,100,2,1300,1400,"Sub-basin 5"
2308,600,21,3900,4500,"Sub-basin 5"
2309,100,3,2000,2100,"Sub-basin 5"
2310,100,1,900,1000,"Sub-basin 5"
2311,900,182,1400,2300,"Sub-basin 5"
2312,400,49,2400,2800,"Sub-basin 5"
2313,2900,378,18200,21100,"Sub-basin 5"
2314,1200,92,7600,8800,"Sub-basin 5"
2315,6100,788,37200,43300,"Sub-basin 5"
2316,100,1,900,1000,"Sub-basin 5"
2317,200,3,1300,1500,"Sub-basin 5"
2318,13500,5120,17100,30600,"Sub-basin 5"
2319,100,1,600,700,"Sub-basin 5"
2320,1100,75,10800,11900,"Sub-basin 5"
2321,800,28,6200,7000,"Sub-basin 5"
2322,2500,223,14500,17000,"Sub-basin 5"
2323,100,3,2900,3000,"Sub-basin 5"
2324,900,64,5700,6600,"Sub-basin 5"
2325,600,26,5800,6400,"Sub-basin 5"
2326,100,2,800,900,"Sub-basin 5"
2327,200,15,1300,1500,"Sub-basin 5"
2328,300,24,2300,2600,"Sub-basin 5"
2329,400,12,900,1300,"Sub-basin 5"
2330,4600,1492.5,6800,11400,"Sub-basin 5"
2331,100,2,1700,1800,"Sub-basin 5"
2332,16000,9403.408,15400,31400,"Sub-basin 5"
2333,900,50,4000,4900,"Sub-basin 5"
2334,200,6,1700,1900,"Sub-basin 5"
2335,200,4,1700,1900,"Sub-basin 5"
2336,200,11,1000,1200,"Sub-basin 5"
2337,1000,72,4200,5200,"Sub-basin 5"
2338,3300,229.5,15900,19200,"Sub-basin 5"
2339,400,35,4100,4500,"Sub-basin 5"
2340,400,14,3400,3800,"Sub-basin 5"
2341,100,5,2600,2700,"Sub-basin 5"
2342,100,2,2600,2700,"Sub-basin 5"
2343,400,17,2100,2500,"Sub-basin 5"
2344,200,4,2700,2900,"Sub-basin 5"
2345,400,39,1400,1800,"Sub-basin 5"
2346,100,1,1700,1800,"Sub-basin 5"
2347,1000,27,7800,8800,"Sub-basin 5"
2348,300,10,2800,3100,"Sub-basin 5"
2349,2100,719,3200,5300,"Sub-basin 5"
2350,10900,4507,14200,25100,"Sub-basin 5"
2351,200,13,1700,1900,"Sub-basin 5"
2352,700,74,1200,1900,"Sub-basin 5"
2353,300,14,7700,8000,"Sub-basin 5"
2354,200,12,1300,1500,"Sub-basin 5"
2355,6500,2710,14500,21000,"Sub-basin 5"
2356,2500,546,6400,8900,"Sub-basin 5"
2357,300,12,2500,2800,"Sub-basin 5"
2358,100,2,300,400,"Sub-basin 5"
2359,100,2,500,600,"Sub-basin 5"
2360,100,1,1400,1500,"Sub-basin 5"
2361,100,3,900,1000,"Sub-basin 5"
2362,100,1,1100,1200,"Sub-basin 5"
2363,3200,902,9300,12500,"Sub-basin 5"
2364,15100,10434,15200,30300,"Sub-basin 5"
2365,100,2,300,400,"Sub-basin 5"
2366,500,49,1700,2200,"Sub-basin 5"
2367,100,5,900,1000,"Sub-basin 5"
2368,500,20,5400,5900,"Sub-basin 5"
2369,4500,1635,8700,13200,"Sub-basin 5"
2370,400,16,2500,2900,"Sub-basin 5"
2371,400,55,1300,1700,"Sub-basin 5"
2372,200,10,3100,3300,"Sub-basin 5"
2373,100,2,900,1000,"Sub-basin 5"
2374,300,7,2700,3000,"Sub-basin 5"
2375,600,51,1200,1800,"Sub-basin 5"
2376,100,1,800,900,"Sub-basin 5"
2377,8300,3035,17300,25600,"Sub-basin 5"
2378,1200,74,3100,4300,"Sub-basin 5"
2379,200,4,1000,1200,"Sub-basin 5"
2380,500,31,3000,3500,"Sub-basin 5"
2381,500,18,2400,2900,"Sub-basin 5"
2382,18700,4960,41500,60200,"Sub-basin 5"
2383,200,10,1700,1900,"Sub-basin 5"
2384,600,66,2400,3000,"Sub-basin 5"
2385,200,3,800,1000,"Sub-basin 5"
2386,900,41,6400,7300,"Sub-basin 5"
2387,100,4,900,1000,"Sub-basin 5"
2388,200,7,1700,1900,"Sub-basin 5"
2389,800,33,4900,5700,"Sub-basin 5"
2390,100,1,1300,1400,"Sub-basin 5"
2391,200,7,800,1000,"Sub-basin 5"
2392,100,1,700,800,"Sub-basin 5"
2393,2000,395,3800,5800,"Sub-basin 5"
2394,100,2,1200,1300,"Sub-basin 5"
2395,400,46,4600,5000,"Sub-basin 5"
2396,1000,73,8200,9200,"Sub-basin 5"
2397,3400,203,15900,19300,"Sub-basin 5"
2398,800,90,2900,3700,"Sub-basin 5"
2399,100,1,400,500,"Sub-basin 5"
2400,100,2,1300,1400,"Sub-basin 5"
2401,400,31,3100,3500,"Sub-basin 5"
2402,400,14,5000,5400,"Sub-basin 5"
2403,100,1,1300,1400,"Sub-basin 5"
2404,100,3,1000,1100,"Sub-basin 5"
2405,500,19,4900,5400,"Sub-basin 5"
2406,100,1,500,600,"Sub-basin 5"
2407,200,6,3900,4100,"Sub-basin 5"
2408,400,24,4400,4800,"Sub-basin 5"
2409,300,6,3300,3600,"Sub-basin 5"
2410,1600,144,7600,9200,"Sub-basin 5"
2411,1400,205,3000,4400,"Sub-basin 5"
2412,200,2,3400,3600,"Sub-basin 5"
2413,45500,11651,73000,118500,"Sub-basin 5"
2414,1900,852,2500,4400,"Sub-basin 5"
2415,100,6,1000,1100,"Sub-basin 5"
2416,200,13,1500,1700,"Sub-basin 5"
2417,2100,174,8500,10600,"Sub-basin 5"
2418,100,1,900,1000,"Sub-basin 5"
2419,100,1,2400,2500,"Sub-basin 5"
2420,200,8,3200,3400,"Sub-basin 5"
2421,100,2,800,900,"Sub-basin 5"
2422,1400,75,11700,13100,"Sub-basin 5"
2423,34100,1191,80600,114700,"Sub-basin 5"
2424,1000,18,3000,4000,"Sub-basin 5"
2425,200,14,2600,2800,"Sub-basin 5"
2426,300,12,2600,2900,"Sub-basin 5"
2427,800,90,4000,4800,"Sub-basin 5"
2428,900,138,2700,3600,"Sub-basin 5"
2429,2800,431,7800,10600,"Sub-basin 5"
2430,300,5,2400,2700,"Sub-basin 5"
2431,5000,915,17100,22100,"Sub-basin 5"
2432,600,20,4200,4800,"Sub-basin 5"
2433,200,6,4100,4300,"Sub-basin 5"
2434,500,16,3800,4300,"Sub-basin 5"
2435,100,3,1400,1500,"Sub-basin 5"
2436,100,3,1100,1200,"Sub-basin 5"
2437,200,7,2700,2900,"Sub-basin 5"
2438,200,7,1700,1900,"Sub-basin 5"
2439,400,6,2800,3200,"Sub-basin 5"
2440,7900,2979,13900,21800,"Sub-basin 5"
2441,400,13,3600,4000,"Sub-basin 5"
2442,200,5,1600,1800,"Sub-basin 5"
2443,600,49,1700,2300,"Sub-basin 5"
2444,1800,213,5400,7200,"Sub-basin 5"
2445,800,106,2500,3300,"Sub-basin 5"
2446,100,1,700,800,"Sub-basin 5"
2447,200,3,3100,3300,"Sub-basin 5"
2448,200,6,400,600,"Sub-basin 5"
2449,100,2,1000,1100,"Sub-basin 5"
2450,1000,210,2900,3900,"Sub-basin 5"
2451,600,38,3100,3700,"Sub-basin 5"
2452,2800,666,12500,15300,"Sub-basin 5"
2453,2200,145,11700,13900,"Sub-basin 5"
2454,500,25,6400,6900,"Sub-basin 5"
2455,400,13,3500,3900,"Sub-basin 5"
2456,200,18,1300,1500,"Sub-basin 5"
2457,100,3,1700,1800,"Sub-basin 5"
2458,900,163,3700,4600,"Sub-basin 5"
2459,400,18,1500,1900,"Sub-basin 5"
2460,1100,110,4500,5600,"Sub-basin 5"
2461,100,1,900,1000,"Sub-basin 5"
2462,100,1,700,800,"Sub-basin 5"
2463,1700,79,9700,11400,"Sub-basin 5"
2464,200,8,800,1000,"Sub-basin 5"
2465,100,7,1000,1100,"Sub-basin 5"
2466,200,5,1100,1300,"Sub-basin 5"
2467,3700,1800,11100,14800,"Sub-basin 5"
2468,200,4,2800,3000,"Sub-basin 5"
2469,100,1,600,700,"Sub-basin 5"
2470,2400,826,4300,6700,"Sub-basin 5"
2471,2000,324,6700,8700,"Sub-basin 5"
2472,4800,702,28600,33400,"Sub-basin 5"
2473,600,39,3600,4200,"Sub-basin 5"
2474,100,3,300,400,"Sub-basin 5"
2475,6300,1037,22100,28400,"Sub-basin 5"
2476,700,43,4800,5500,"Sub-basin 5"
2477,600,129,1500,2100,"Sub-basin 5"
2478,1500,262,3300,4800,"Sub-basin 5"
2479,100,1,1200,1300,"Sub-basin 5"
2480,300,6,6700,7000,"Sub-basin 5"
2481,13500,7914,14400,27900,"Sub-basin 5"
2482,3000,1154.17,4900,7900,"Sub-basin 5"
2483,1300,32,6100,7400,"Sub-basin 5"
2484,200,8,1400,1600,"Sub-basin 5"
2485,16700,8906,19000,35700,"Sub-basin 5"
2486,100,5,700,800,"Sub-basin 5"
2487,400,28,1900,2300,"Sub-basin 5"
2488,500,33,3300,3800,"Sub-basin 5"
2489,100,3,2400,2500,"Sub-basin 5"
2490,8900,3175,7400,16300,"Sub-basin 5"
2491,400,32,1600,2000,"Sub-basin 5"
2492,100,3,1000,1100,"Sub-basin 5"
2493,500,21,1400,1900,"Sub-basin 5"
2494,100,2,1500,1600,"Sub-basin 5"
2495,200,7,2400,2600,"Sub-basin 5"
2496,100,4,1300,1400,"Sub-basin 5"
2497,100,3,1100,1200,"Sub-basin 5"
2498,1200,122,10100,11300,"Sub-basin 5"
2499,100,7,1300,1400,"Sub-basin 5"
2500,300,7,2300,2600,"Sub-basin 5"
2501,1600,397,6900,8500,"Sub-basin 5"
2502,200,3,3400,3600,"Sub-basin 5"
2503,400,20,4500,4900,"Sub-basin 5"
2504,100,2,500,600,"Sub-basin 5"
2505,400,35,2800,3200,"Sub-basin 5"
2506,400,11,2600,3000,"Sub-basin 5"
2507,200,5,2300,2500,"Sub-basin 5"
2508,200,6,2900,3100,"Sub-basin 5"
2509,800,18,6900,7700,"Sub-basin 5"
2510,3200,444,9400,12600,"Sub-basin 5"
2511,200,11,2100,2300,"Sub-basin 5"
2512,200,7,2000,2200,"Sub-basin 5"
2513,300,11,2900,3200,"Sub-basin 5"
2514,100,1,900,1000,"Sub-basin 5"
2515,400,13,4700,5100,"Sub-basin 5"
2516,100,1,1400,1500,"Sub-basin 5"
2517,500,55,2000,2500,"Sub-basin 5"
2518,100,1,1400,1500,"Sub-basin 5"
2519,600,17,7300,7900,"Sub-basin 5"
2520,3100,1030,6800,9900,"Sub-basin 5"
2521,500,37,1600,2100,"Sub-basin 5"
2522,1200,122,1900,3100,"Sub-basin 5"
2523,4600,657,26300,30900,"Sub-basin 5"
2524,800,45,4300,5100,"Sub-basin 5"
2525,700,42,7100,7800,"Sub-basin 5"
2526,100,4,1300,1400,"Sub-basin 5"
2527,100,1,2100,2200,"Sub-basin 5"
2528,200,2,2100,2300,"Sub-basin 5"
2529,400,80,1800,2200,"Sub-basin 5"
2530,200,12,900,1100,"Sub-basin 5"
2531,100,2,1000,1100,"Sub-basin 5"
2532,300,12,3600,3900,"Sub-basin 5"
2533,1200,245,4200,5400,"Sub-basin 5"
2534,300,40,2200,2500,"Sub-basin 5"
2535,100,3,1200,1300,"Sub-basin 5"
2536,1800,98,8400,10200,"Sub-basin 5"
2537,100,3,1200,1300,"Sub-basin 5"
2538,1700,84,9200,10900,"Sub-basin 5"
2539,2300,434,9500,11800,"Sub-basin 5"
2540,148700,103031.49,93200,241900,"Sub-basin 5"
2541,100,1,1000,1100,"Sub-basin 5"
2542,600,78,4400,5000,"Sub-basin 5"
2543,3300,696,6200,9500,"Sub-basin 5"
2544,5700,2985,9000,14700,"Sub-basin 5"
2545,400,21,1200,1600,"Sub-basin 5"
2546,4500,549,25600,30100,"Sub-basin 5"
2547,100,2,800,900,"Sub-basin 5"
2548,900,36,5100,6000,"Sub-basin 5"
2549,100,1,1300,1400,"Sub-basin 5"
2550,400,10,8300,8700,"Sub-basin 5"
2551,5500,238,27500,33000,"Sub-basin 5"
2552,1300,30,8200,9500,"Sub-basin 5"
2553,200,7,2500,2700,"Sub-basin 5"
2554,600,290,3700,4300,"Sub-basin 5"
2555,200,4,1800,2000,"Sub-basin 5"
2556,200,21,1500,1700,"Sub-basin 5"
2557,25200,14933,19600,44800,"Sub-basin 5"
2558,10100,4495,9900,20000,"Sub-basin 5"
2559,100,1,900,1000,"Sub-basin 5"
2560,1300,84,5500,6800,"Sub-basin 5"
2561,4800,1739,22100,26900,"Sub-basin 5"
2562,200,11,1700,1900,"Sub-basin 5"
2563,100,3,700,800,"Sub-basin 5"
2564,500,17,2500,3000,"Sub-basin 5"
2565,100,3,2500,2600,"Sub-basin 5"
2566,1200,439,2500,3700,"Sub-basin 5"
2567,8000,1680,23700,31700,"Sub-basin 5"
2568,100,2,1300,1400,"Sub-basin 5"
2569,400,27,4000,4400,"Sub-basin 5"
2570,1100,79,4300,5400,"Sub-basin 5"
2571,100,1,2200,2300,"Sub-basin 5"
2572,200,2,1000,1200,"Sub-basin 5"
2573,100,4,600,700,"Sub-basin 5"
2574,300,13,1700,2000,"Sub-basin 5"
2575,500,100,2800,3300,"Sub-basin 5"
2576,300,7,200,500,"Sub-basin 5"
2577,10800,7288.722,11500,22300,"Sub-basin 5"
2578,200,6,400,600,"Sub-basin 5"
2579,400,10,2000,2400,"Sub-basin 5"
2580,3800,445,14900,18700,"Sub-basin 5"
2581,900,100,3000,3900,"Sub-basin 5"
2582,100,2,1500,1600,"Sub-basin 5"
2583,100,3,1500,1600,"Sub-basin 5"
2584,200,4,4600,4800,"Sub-basin 5"
2585,300,8,5800,6100,"Sub-basin 5"
2586,1400,40,15800,17200,"Sub-basin 5"
2587,400,10,3200,3600,"Sub-basin 5"
2588,600,100,1800,2400,"Sub-basin 5"
2589,400,27,6500,6900,"Sub-basin 5"
2590,1000,184,3100,4100,"Sub-basin 5"
2591,1200,167,5200,6400,"Sub-basin 5"
2592,1800,243,3700,5500,"Sub-basin 5"
2593,300,18,1400,1700,"Sub-basin 5"
2594,100,5,1100,1200,"Sub-basin 5"
2595,200,4,1800,2000,"Sub-basin 5"
2596,600,22,3600,4200,"Sub-basin 5"
2597,400,23,5700,6100,"Sub-basin 5"
2598,7800,2055,14000,21800,"Sub-basin 5"
2599,100,1,900,1000,"Sub-basin 5"
2600,3100,1276.83,11200,14300,"Sub-basin 5"
2601,600,127,2200,2800,"Sub-basin 5"
2602,5100,2162,6200,11300,"Sub-basin 5"
2603,15900,9708.186,15300,31200,"Sub-basin 5"
2604,400,51,900,1300,"Sub-basin 5"
2605,1000,68,8600,9600,"Sub-basin 5"
2606,3400,1614,4700,8100,"Sub-basin 5"
2607,100,2,700,800,"Sub-basin 5"
2608,500,23,1700,2200,"Sub-basin 5"
2609,6700,2216,10300,17000,"Sub-basin 5"
2610,300,24,1100,1400,"Sub-basin 5"
2611,9500,2813.66,13300,22800,"Sub-basin 5"
2612,600,13,6600,7200,"Sub-basin 5"
2613,800,346,3400,4200,"Sub-basin 5"
2614,100,2,600,700,"Sub-basin 5"
2615,2700,443,6700,9400,"Sub-basin 5"
2616,100,4,1000,1100,"Sub-basin 5"
2617,700,38,5800,6500,"Sub-basin 5"
2618,1400,148,3400,4800,"Sub-basin 5"
2619,2300,752,6600,8900,"Sub-basin 5"
2620,1700,109,5500,7200,"Sub-basin 5"
2621,2000,219,6300,8300,"Sub-basin 5"
2622,500,60,2200,2700,"Sub-basin 5"
2623,300,23,1600,1900,"Sub-basin 5"
2624,100,2,1300,1400,"Sub-basin 5"
2625,100,1,1100,1200,"Sub-basin 5"
2626,500,20,2800,3300,"Sub-basin 5"
2627,100,3,1700,1800,"Sub-basin 5"
2628,300,9,2700,3000,"Sub-basin 5"
2629,18800,1092,34600,53400,"Sub-basin 5"
2630,3100,418,10000,13100,"Sub-basin 5"
2631,2100,744,6000,8100,"Sub-basin 5"
2632,400,37,1200,1600,"Sub-basin 5"
2633,100,5,500,600,"Sub-basin 5"
2634,200,13,1100,1300,"Sub-basin 5"
2635,200,7,2200,2400,"Sub-basin 5"
2636,400,15,2200,2600,"Sub-basin 5"
2637,400,57,1700,2100,"Sub-basin 5"
2638,900,246,5000,5900,"Sub-basin 5"
2639,800,152,2800,3600,"Sub-basin 5"
2640,4800,758,16500,21300,"Sub-basin 5"
2641,200,9,800,1000,"Sub-basin 5"
2642,1900,109,7700,9600,"Sub-basin 5"
2643,1600,199,7900,9500,"Sub-basin 5"
2644,600,23,6600,7200,"Sub-basin 5"
2645,800,51,4300,5100,"Sub-basin 5"
2646,100,2,1800,1900,"Sub-basin 5"
2647,100,4,1700,1800,"Sub-basin 5"
2648,5700,1481,12800,18500,"Sub-basin 5"
2649,3400,971.83,9600,13000,"Sub-basin 5"
2650,100,1,900,1000,"Sub-basin 5"
2651,2100,824,12100,14200,"Sub-basin 5"
2652,7000,2107,17800,24800,"Sub-basin 5"
2653,4000,1028,12400,16400,"Sub-basin 5"
2654,100,1,2000,2100,"Sub-basin 5"
2655,300,14,3300,3600,"Sub-basin 5"
2656,400,19,2900,3300,"Sub-basin 5"
2657,1500,151,11400,12900,"Sub-basin 5"
2658,300,36,100,400,"Sub-basin 5"
2659,400,16,4600,5000,"Sub-basin 5"
2660,3800,541,8900,12700,"Sub-basin 5"
2661,100,1,1500,1600,"Sub-basin 5"
2662,500,85,2500,3000,"Sub-basin 5"
2663,100,1,1400,1500,"Sub-basin 5"
2664,200,3,800,1000,"Sub-basin 5"
2665,200,15,2400,2600,"Sub-basin 5"
2666,200,3,2500,2700,"Sub-basin 5"
2667,100,4,400,500,"Sub-basin 5"
2668,2400,507,4700,7100,"Sub-basin 5"
2669,500,14,4900,5400,"Sub-basin 5"
2670,100,1,2500,2600,"Sub-basin 5"
2671,400,10,1600,2000,"Sub-basin 5"
2672,300,16,800,1100,"Sub-basin 5"
2673,100,14,800,900,"Sub-basin 5"
2674,700,21,9000,9700,"Sub-basin 5"
2675,400,9,5400,5800,"Sub-basin 5"
2676,1600,209,6200,7800,"Sub-basin 5"
2677,200,8,300,500,"Sub-basin 5"
2678,200,10,1700,1900,"Sub-basin 5"
2679,4500,1753,7000,11500,"Sub-basin 5"
2680,100,2,900,1000,"Sub-basin 5"
2681,400,24,2900,3300,"Sub-basin 5"
2682,700,42,5100,5800,"Sub-basin 5"
2683,100,3,500,600,"Sub-basin 5"
2684,400,23,4500,4900,"Sub-basin 5"
2685,200,3,1000,1200,"Sub-basin 5"
2686,1700,210,8500,10200,"Sub-basin 5"
2687,100,1,1500,1600,"Sub-basin 5"
2688,1000,60,8500,9500,"Sub-basin 5"
2689,1100,354,2800,3900,"Sub-basin 5"
2690,35500,13493.66,41900,77400,"Sub-basin 5"
2691,1400,110,5400,6800,"Sub-basin 5"
2692,1200,96,4100,5300,"Sub-basin 5"
2693,400,9,2500,2900,"Sub-basin 5"
2694,900,23,6000,6900,"Sub-basin 5"
2695,1700,394,6400,8100,"Sub-basin 5"
2696,1900,556,3800,5700,"Sub-basin 5"
2697,200,5,1000,1200,"Sub-basin 5"
2698,100,1,500,600,"Sub-basin 5"
2699,5000,1107.67,14500,19500,"Sub-basin 5"
2700,100,2,1800,1900,"Sub-basin 5"
2701,800,88,5400,6200,"Sub-basin 5"
2702,400,29,1900,2300,"Sub-basin 5"
2703,100,3,1500,1600,"Sub-basin 5"
2704,900,35,7500,8400,"Sub-basin 5"
2705,100,3,900,1000,"Sub-basin 5"
2706,1000,148,7300,8300,"Sub-basin 5"
2707,300,13,4100,4400,"Sub-basin 5"
2708,300,12,2700,3000,"Sub-basin 5"
2709,700,52,2700,3400,"Sub-basin 5"
2710,100,2,1300,1400,"Sub-basin 5"
2711,1000,211,1400,2400,"Sub-basin 5"
2712,3600,1217,6600,10200,"Sub-basin 5"
2713,100,3,1500,1600,"Sub-basin 5"
2714,100,1,1200,1300,"Sub-basin 5"
2715,800,32,7500,8300,"Sub-basin 5"
2716,700,16,4200,4900,"Sub-basin 5"
2717,4400,1622,5800,10200,"Sub-basin 5"
2718,100,6,700,800,"Sub-basin 5"
2719,17000,5962.51,30100,47100,"Sub-basin 5"
2720,600,58,4800,5400,"Sub-basin 5"
2721,200,23,3700,3900,"Sub-basin 5"
2722,2500,353,8600,11100,"Sub-basin 5"
2723,100,1,1300,1400,"Sub-basin 5"
2724,900,32,7100,8000,"Sub-basin 5"
2725,400,34,2400,2800,"Sub-basin 5"
2726,100,1,2100,2200,"Sub-basin 5"
2727,800,46,3800,4600,"Sub-basin 5"
2728,2100,328,8200,10300,"Sub-basin 5"
2729,11200,3921,14900,26100,"Sub-basin 5"
2730,200,10,1600,1800,"Sub-basin 5"
2731,100,2,1100,1200,"Sub-basin 5"
2732,100,1,1000,1100,"Sub-basin 5"
2733,3100,788,6900,10000,"Sub-basin 5"
2734,100,1,600,700,"Sub-basin 5"
2735,300,3,4500,4800,"Sub-basin 5"
2736,4000,1049,6800,10800,"Sub-basin 5"
2737,100,1,1800,1900,"Sub-basin 5"
2738,3800,1146,5500,9300,"Sub-basin 5"
2739,2600,762,4300,6900,"Sub-basin 5"
2740,700,141,1700,2400,"Sub-basin 5"
2741,300,6,2900,3200,"Sub-basin 5"
2742,100,2,1600,1700,"Sub-basin 5"
2743,100,5,300,400,"Sub-basin 5"
2744,1300,84,15000,16300,"Sub-basin 5"
2745,900,112,5400,6300,"Sub-basin 5"
2746,100,2,1300,1400,"Sub-basin 5"
2747,900,77,6200,7100,"Sub-basin 5"
2748,300,9,5300,5600,"Sub-basin 5"
2749,800,16,5100,5900,"Sub-basin 5"
2750,3200,245,18100,21300,"Sub-basin 5"
2751,600,60,6000,6600,"Sub-basin 5"
2752,7000,2117.67,19600,26600,"Sub-basin 5"
2753,1800,250,5000,6800,"Sub-basin 5"
2754,13000,2864,48500,61500,"Sub-basin 5"
2755,17500,3974,62600,80100,"Sub-basin 5"
2756,500,83,5100,5600,"Sub-basin 5"
2757,100,1,1100,1200,"Sub-basin 5"
2758,200,7,1700,1900,"Sub-basin 5"
2759,3300,724,16500,19800,"Sub-basin 5"
2760,200,11,500,700,"Sub-basin 5"
2761,1300,323,6100,7400,"Sub-basin 5"
2762,300,14,3400,3700,"Sub-basin 5"
2763,1100,91,5800,6900,"Sub-basin 5"
2764,1100,55,7900,9000,"Sub-basin 5"
2765,100,2,1000,1100,"Sub-basin 5"
2766,500,71,5100,5600,"Sub-basin 5"
2767,100,1,1000,1100,"Sub-basin 5"
2768,2000,222,17000,19000,"Sub-basin 5"
2769,200,4,1400,1600,"Sub-basin 5"
2770,200,6,2700,2900,"Sub-basin 5"
2771,1600,296,2900,4500,"Sub-basin 5"
2772,500,32,2200,2700,"Sub-basin 5"
2773,100,1,1900,2000,"Sub-basin 5"
2774,2200,691,3800,6000,"Sub-basin 5"
2775,17600,3422.5,57200,74800,"Sub-basin 5"
2776,1600,443,7200,8800,"Sub-basin 5"
2777,200,4,200,400,"Sub-basin 5"
2778,200,7,1300,1500,"Sub-basin 5"
2779,500,14,2100,2600,"Sub-basin 5"
2780,100,1,600,700,"Sub-basin 5"
2781,100,2,1800,1900,"Sub-basin 5"
2782,200,5,1500,1700,"Sub-basin 5"
2783,600,23,3600,4200,"Sub-basin 5"
2784,1200,82,9400,10600,"Sub-basin 5"
2785,400,23,2800,3200,"Sub-basin 5"
2786,500,47,3100,3600,"Sub-basin 5"
2787,100,1,600,700,"Sub-basin 5"
2788,200,2,1200,1400,"Sub-basin 5"
2789,700,12,5300,6000,"Sub-basin 5"
2790,1000,27,4800,5800,"Sub-basin 5"
2791,100,1,500,600,"Sub-basin 5"
2792,2000,187,5500,7500,"Sub-basin 5"
2793,100,1,1900,2000,"Sub-basin 5"
2794,200,4,2800,3000,"Sub-basin 5"
2795,600,13,4800,5400,"Sub-basin 5"
2796,100,2,100,200,"Sub-basin 5"
2797,1100,72,6800,7900,"Sub-basin 5"
2798,500,31,2800,3300,"Sub-basin 5"
2799,1500,97,5700,7200,"Sub-basin 5"
2800,1000,333,1800,2800,"Sub-basin 5"
2801,100,1,2300,2400,"Sub-basin 5"
2802,300,4,2200,2500,"Sub-basin 5"
2803,400,6,2000,2400,"Sub-basin 5"
2804,200,8,1800,2000,"Sub-basin 5"
2805,400,17,1700,2100,"Sub-basin 5"
2806,1000,152,3700,4700,"Sub-basin 5"
2807,900,30,9900,10800,"Sub-basin 5"
2808,200,9,1300,1500,"Sub-basin 5"
2809,100,1,1400,1500,"Sub-basin 5"
2810,3000,565,9200,12200,"Sub-basin 5"
2811,300,13,900,1200,"Sub-basin 5"
2812,1800,158,4000,5800,"Sub-basin 5"
2813,200,4,1900,2100,"Sub-basin 5"
2814,900,194,4800,5700,"Sub-basin 5"
2815,3400,524.83,19400,22800,"Sub-basin 5"
2816,5000,2316.16,4900,9900,"Sub-basin 5"
2817,600,48,2600,3200,"Sub-basin 5"
2818,800,59,200,1000,"Sub-basin 5"
2819,500,18,2100,2600,"Sub-basin 5"
2820,200,7,3100,3300,"Sub-basin 5"
2821,500,13,2600,3100,"Sub-basin 5"
2822,600,148,2900,3500,"Sub-basin 5"
2823,1200,110,3900,5100,"Sub-basin 5"
2824,400,35.83,2300,2700,"Sub-basin 5"
2825,900,282,2200,3100,"Sub-basin 5"
2826,16800,5678,37100,53900,"Sub-basin 5"
2827,100,2,1400,1500,"Sub-basin 5"
2828,1400,111,6900,8300,"Sub-basin 5"
2829,1900,74,12400,14300,"Sub-basin 5"
2830,200,3,600,800,"Sub-basin 5"
2831,200,4,2200,2400,"Sub-basin 5"
2832,100,2,1600,1700,"Sub-basin 5"
2833,500,53,2300,2800,"Sub-basin 5"
2834,200,4,2500,2700,"Sub-basin 5"
2835,400,9,2800,3200,"Sub-basin 5"
2836,4900,1125.67,14200,19100,"Sub-basin 5"
2837,200,12,3700,3900,"Sub-basin 5"
2838,500,62,1800,2300,"Sub-basin 5"
2839,4500,1291,7400,11900,"Sub-basin 5"
2840,100,1,1100,1200,"Sub-basin 5"
2841,100,1,2000,2100,"Sub-basin 5"
2842,100,309,1700,1800,"Sub-basin 5"
2843,1800,76,14200,16000,"Sub-basin 5"
2844,600,54,7200,7800,"Sub-basin 5"
2845,300,12,2900,3200,"Sub-basin 5"
2846,1200,58,11700,12900,"Sub-basin 5"
2847,1200,57.5,9600,10800,"Sub-basin 5"
2848,100,2,1500,1600,"Sub-basin 5"
2849,2500,282.17,26900,29400,"Sub-basin 5"
2850,1500,491,4200,5700,"Sub-basin 5"
2851,500,6,2200,2700,"Sub-basin 5"
2852,400,39,1600,2000,"Sub-basin 5"
2853,2000,343,6300,8300,"Sub-basin 5"
2854,1100,188,3600,4700,"Sub-basin 5"
2855,1300,242,3000,4300,"Sub-basin 5"
2856,400,5,6900,7300,"Sub-basin 5"
2857,100,1,2000,2100,"Sub-basin 5"
2858,100,6,500,600,"Sub-basin 5"
2859,100,2,900,1000,"Sub-basin 5"
2860,100,3,1400,1500,"Sub-basin 5"
2861,100,4,1000,1100,"Sub-basin 5"
2862,5100,3060.34,9600,14700,"Sub-basin 5"
2863,200,2,600,800,"Sub-basin 5"
2864,100,2,1100,1200,"Sub-basin 5"
2865,100,2,1000,1100,"Sub-basin 5"
2866,400,14,2400,2800,"Sub-basin 5"
2867,200,1.49,500,700,"Sub-basin 5"
2868,6600,1942.33,20800,27400,"Sub-basin 5"
2869,300,10.5,900,1200,"Sub-basin 5"
2870,1000,34.5,5000,6000,"Sub-basin 5"
2871,3700,688.17,11100,14800,"Sub-basin 5"
2872,700,110.33,5600,6300,"Sub-basin 5"
2873,100,1,1700,1800,"Sub-basin 5"
2874,100,0.34,1700,1800,"Sub-basin 5"
2875,300,4,3900,4200,"Sub-basin 5"
2876,1800,50,5600,7400,"Sub-basin 5"
2877,100,1,1300,1400,"Sub-basin 5"
2878,1500,559.84,3300,4800,"Sub-basin 5"
2879,2300,1120,5500,7800,"Sub-basin 5"
2880,200,3.34,1800,2000,"Sub-basin 5"
2881,8600,2280.67,24800,33400,"Sub-basin 5"
2882,200,4,2600,2800,"Sub-basin 5"
2883,100,1,1200,1300,"Sub-basin 5"
2884,400,17,3300,3700,"Sub-basin 5"
2885,100,1,1400,1500,"Sub-basin 5"
2886,300,24,3400,3700,"Sub-basin 5"
2887,200,17,3500,3700,"Sub-basin 5"
2888,1000,195.3,3200,4200,"Sub-basin 5"
2889,1700,194,4100,5800,"Sub-basin 5"
2890,200,3,1000,1200,"Sub-basin 5"
2891,100,2,2200,2300,"Sub-basin 5"
2892,2000,465,10500,12500,"Sub-basin 5"
2893,700,136,2400,3100,"Sub-basin 5"
2894,5400,2356,11200,16600,"Sub-basin 5"
2895,100,3,1300,1400,"Sub-basin 5"
2896,3400,1383,3000,6400,"Sub-basin 5"
2897,3600,1851,3700,7300,"Sub-basin 5"
2898,100,5,900,1000,"Sub-basin 5"
2899,200,2,4500,4700,"Sub-basin 5"
2900,100,4,1500,1600,"Sub-basin 5"
2901,1200,40,9400,10600,"Sub-basin 5"
2902,100,1,1000,1100,"Sub-basin 5"
2903,700,29,12500,13200,"Sub-basin 5"
2904,400,15,3100,3500,"Sub-basin 5"
2905,100,3,900,1000,"Sub-basin 5"
2906,500,27,4400,4900,"Sub-basin 5"
2907,300,8,4100,4400,"Sub-basin 5"
2908,400,32,2900,3300,"Sub-basin 5"
2909,6600,3261,15900,22500,"Sub-basin 5"
2910,100,1,300,400,"Sub-basin 5"
2911,700,87,500,1200,"Sub-basin 5"
2912,100,1,1400,1500,"Sub-basin 5"
2913,100,3,1100,1200,"Sub-basin 5"
2914,100,1,1000,1100,"Sub-basin 5"
2915,900,94,3900,4800,"Sub-basin 5"
2916,200,10,2800,3000,"Sub-basin 5"
2917,400,40,3100,3500,"Sub-basin 5"
2918,100,3,1600,1700,"Sub-basin 5"
2919,100,2,2400,2500,"Sub-basin 5"
2920,100,3,1100,1200,"Sub-basin 5"
2921,600,52,3900,4500,"Sub-basin 5"
2922,800,17,4800,5600,"Sub-basin 5"
2923,100,4,400,500,"Sub-basin 5"
2924,2200,339,7400,9600,"Sub-basin 5"
2925,300,5,2200,2500,"Sub-basin 5"
2926,800,64.5,2300,3100,"Sub-basin 5"
2927,2700,635,7600,10300,"Sub-basin 5"
2928,12100,2038.67,31700,43800,"Sub-basin 5"
2929,400,19,1200,1600,"Sub-basin 5"
2930,200,5,1500,1700,"Sub-basin 5"
2931,500,34,2300,2800,"Sub-basin 5"
2932,1000,46,5400,6400,"Sub-basin 5"
2933,500,9,7800,8300,"Sub-basin 5"
2934,1000,112,9200,10200,"Sub-basin 5"
2935,400,16,4300,4700,"Sub-basin 5"
2936,200,3,2400,2600,"Sub-basin 5"
2937,500,18,2800,3300,"Sub-basin 5"
2938,200,4,1500,1700,"Sub-basin 5"
2939,2900,686,8500,11400,"Sub-basin 5"
2940,1700,103,5900,7600,"Sub-basin 5"
2941,100,2,1000,1100,"Sub-basin 5"
2942,400,25,700,1100,"Sub-basin 5"
2943,900,103,3000,3900,"Sub-basin 5"
2944,300,12,2900,3200,"Sub-basin 5"
2945,100,1,1100,1200,"Sub-basin 5"
2946,100,2,1900,2000,"Sub-basin 5"
2947,1600,566,3600,5200,"Sub-basin 5"
2948,4000,277,14100,18100,"Sub-basin 5"
2949,400,16,1800,2200,"Sub-basin 5"
2950,1000,108,3400,4400,"Sub-basin 5"
2951,900,54,2700,3600,"Sub-basin 5"
2952,9800,4684,6700,16500,"Sub-basin 5"
2953,200,8,2800,3000,"Sub-basin 5"
2954,300,7,2900,3200,"Sub-basin 5"
2955,100,1,900,1000,"Sub-basin 5"
2956,1300,218,3800,5100,"Sub-basin 5"
2957,800,83,6700,7500,"Sub-basin 5"
2958,2400,517,5900,8300,"Sub-basin 5"
2959,7000,1567,17200,24200,"Sub-basin 5"
2960,100,2,200,300,"Sub-basin 5"
2961,600,25,3700,4300,"Sub-basin 5"
2962,300,6,3800,4100,"Sub-basin 5"
2963,400,7,4600,5000,"Sub-basin 5"
2964,600,46,2200,2800,"Sub-basin 5"
2965,600,95,2300,2900,"Sub-basin 5"
2966,600,43,4300,4900,"Sub-basin 5"
2967,8400,2015,20700,29100,"Sub-basin 5"
2968,100,3,1900,2000,"Sub-basin 5"
2969,200,47,2800,3000,"Sub-basin 5"
2970,300,4,7000,7300,"Sub-basin 5"
2971,300,6,4100,4400,"Sub-basin 5"
2972,200,10,100,300,"Sub-basin 5"
2973,100,5,1000,1100,"Sub-basin 5"
2974,400,9,2100,2500,"Sub-basin 5"
2975,100,1,1200,1300,"Sub-basin 5"
2976,300,10,2000,2300,"Sub-basin 5"
2977,600,53,2200,2800,"Sub-basin 5"
2978,500,33,6100,6600,"Sub-basin 5"
2979,1100,234,9100,10200,"Sub-basin 5"
2980,400,16,2600,3000,"Sub-basin 5"
2981,7200,2976,8100,15300,"Sub-basin 5"
2982,900,175,2600,3500,"Sub-basin 5"
2983,6000,1698,11500,17500,"Sub-basin 5"
2984,100,3,1600,1700,"Sub-basin 5"
2985,900,205,1000,1900,"Sub-basin 5"
2986,500,45,1900,2400,"Sub-basin 5"
2987,4300,624,9300,13600,"Sub-basin 5"
2988,500,33,1400,1900,"Sub-basin 5"
2989,200,7,1200,1400,"Sub-basin 5"
2990,1900,250,5000,6900,"Sub-basin 5"
2991,300,6,1400,1700,"Sub-basin 5"
2992,200,5,1400,1600,"Sub-basin 5"
2993,400,18,5000,5400,"Sub-basin 5"
2994,800,46,3200,4000,"Sub-basin 5"
2995,800,99,1800,2600,"Sub-basin 5"
2996,100,8,1100,1200,"Sub-basin 5"
2997,300,18,2100,2400,"Sub-basin 5"
2998,300,7,1000,1300,"Sub-basin 5"
2999,100,3,700,800,"Sub-basin 5"
3000,300,10,2300,2600,"Sub-basin 5"
3001,600,22,4700,5300,"Sub-basin 5"
3002,400,36,5600,6000,"Sub-basin 5"
3003,200,2,3400,3600,"Sub-basin 5"
3004,500,73,2900,3400,"Sub-basin 5"
3005,1700,150,8600,10300,"Sub-basin 5"
3006,1100,154,4100,5200,"Sub-basin 5"
3007,1300,67,8100,9400,"Sub-basin 5"
3008,4600,1547.98,7200,11800,"Sub-basin 5"
3009,100,1,600,700,"Sub-basin 5"
3010,400,23,3400,3800,"Sub-basin 5"
3011,1000,131,6400,7400,"Sub-basin 5"
3012,100,1,1100,1200,"Sub-basin 5"
3013,2300,839,6000,8300,"Sub-basin 5"
3014,100,5,600,700,"Sub-basin 5"
3015,100,2,2000,2100,"Sub-basin 5"
3016,100,2,900,1000,"Sub-basin 5"
3017,600,413,5800,6400,"Sub-basin 5"
3018,200,5,4200,4400,"Sub-basin 5"
3019,200,4,3700,3900,"Sub-basin 5"
3020,300,15,3300,3600,"Sub-basin 5"
3021,400,17,6200,6600,"Sub-basin 5"
3022,400,28,7100,7500,"Sub-basin 5"
3023,15200,5212,19800,35000,"Sub-basin 5"
3024,300,24,1800,2100,"Sub-basin 5"
3025,100,1,1100,1200,"Sub-basin 5"
3026,400,6,2400,2800,"Sub-basin 5"
3027,29400,10235,42600,72000,"Sub-basin 5"
3028,1000,87,4000,5000,"Sub-basin 5"
3029,100,1,200,300,"Sub-basin 5"
3030,500,42,1800,2300,"Sub-basin 5"
3031,600,39,1800,2400,"Sub-basin 5"
3032,500,19,3000,3500,"Sub-basin 5"
3033,900,42,6700,7600,"Sub-basin 5"
3034,100,2,2400,2500,"Sub-basin 5"
3035,1100,60,13500,14600,"Sub-basin 5"
3036,3100,479,19400,22500,"Sub-basin 5"
3037,100,1,800,900,"Sub-basin 5"
3038,200,3,1400,1600,"Sub-basin 5"
3039,1600,114,8300,9900,"Sub-basin 5"
3040,1200,191,2900,4100,"Sub-basin 5"
3041,800,46,800,1600,"Sub-basin 5"
3042,3300,491,9700,13000,"Sub-basin 5"
3043,14200,8606.7356,14500,29200,"Sub-basin 5"
3044,100,1,900,1000,"Sub-basin 5"
3045,600,18,8400,9000,"Sub-basin 5"
3046,800,75,4600,5400,"Sub-basin 5"
3047,200,8,7300,7500,"Sub-basin 5"
3048,1000,54,13900,14900,"Sub-basin 5"
3049,300,23,3200,3500,"Sub-basin 5"
3050,100,1,1600,1700,"Sub-basin 5"
3051,100,1,1500,1600,"Sub-basin 5"
3052,1200,126,5800,7000,"Sub-basin 5"
3053,300,14,2900,3200,"Sub-basin 5"
3054,500,19,2500,3000,"Sub-basin 5"
3055,200,10,1200,1400,"Sub-basin 5"
3056,400,18,2800,3200,"Sub-basin 5"
3057,400,41,600,1000,"Sub-basin 5"
3058,300,9,4400,4700,"Sub-basin 5"
3059,400,14,3100,3500,"Sub-basin 5"
3060,1100,87,10700,11800,"Sub-basin 5"
3061,1000,52,11100,12100,"Sub-basin 5"
3062,200,8,5800,6000,"Sub-basin 5"
3063,400,21.5,6500,6900,"Sub-basin 5"
3064,200,23,3300,3500,"Sub-basin 5"
3065,200,5,3700,3900,"Sub-basin 5"
3066,900,222,1400,2300,"Sub-basin 5"
3067,300,9,1600,1900,"Sub-basin 5"
3068,2300,274,6100,8400,"Sub-basin 5"
3069,1000,86,10300,11300,"Sub-basin 5"
3070,100,9,700,800,"Sub-basin 5"
3071,9100,4803,9300,18400,"Sub-basin 5"
3072,600,116,1900,2500,"Sub-basin 5"
3073,400,16,3400,3800,"Sub-basin 5"
3074,300,5,4200,4500,"Sub-basin 5"
3075,400,15,5600,6000,"Sub-basin 5"
3076,2700,334,10600,13300,"Sub-basin 5"
3077,2900,353,9400,12300,"Sub-basin 5"
3078,3300,550,8800,12100,"Sub-basin 5"
3079,100,1,1400,1500,"Sub-basin 5"
3080,400,15,700,1100,"Sub-basin 5"
3081,5500,2440,4900,10400,"Sub-basin 5"
3082,400,22,4500,4900,"Sub-basin 5"
3083,300,11,3100,3400,"Sub-basin 5"
3084,200,10,2800,3000,"Sub-basin 5"
3085,300,11,2600,2900,"Sub-basin 5"
3086,2200,233,24800,27000,"Sub-basin 5"
3087,200,10,4300,4500,"Sub-basin 5"
3088,800,47,8400,9200,"Sub-basin 5"
3089,100,2,1800,1900,"Sub-basin 5"
3090,300,15,4300,4600,"Sub-basin 5"
3091,100,2,1700,1800,"Sub-basin 5"
3092,100,1,1900,2000,"Sub-basin 5"
3093,2200,362,5700,7900,"Sub-basin 5"
3094,100,8,1100,1200,"Sub-basin 5"
3095,400,41,1500,1900,"Sub-basin 5"
3096,200,7,2600,2800,"Sub-basin 5"
3097,100,2,1400,1500,"Sub-basin 5"
3098,4000,655.66,28000,32000,"Sub-basin 5"
3099,200,17,2200,2400,"Sub-basin 5"
3100,100,1,1200,1300,"Sub-basin 5"
3101,100,1,1900,2000,"Sub-basin 5"
3102,400,52,1800,2200,"Sub-basin 5"
3103,200,9,900,1100,"Sub-basin 5"
3104,600,20,5200,5800,"Sub-basin 5"
3105,500,19,6400,6900,"Sub-basin 5"
3106,900,48,5900,6800,"Sub-basin 5"
3107,4400,460,18600,23000,"Sub-basin 5"
3108,200,2,3300,3500,"Sub-basin 5"
3109,700,137,8500,9200,"Sub-basin 5"
3110,1000,80,4100,5100,"Sub-basin 5"
3111,200,9,1900,2100,"Sub-basin 5"
3112,200,14,3700,3900,"Sub-basin 5"
3113,2200,205,8000,10200,"Sub-basin 5"
3114,1900,223,4900,6800,"Sub-basin 5"
3115,100,2,1400,1500,"Sub-basin 5"
3116,1500,108,2900,4400,"Sub-basin 5"
3117,900,47,4100,5000,"Sub-basin 5"
3118,500,12,3900,4400,"Sub-basin 5"
3119,1500,96,6500,8000,"Sub-basin 5"
3120,200,5,2800,3000,"Sub-basin 5"
3121,2900,1062,3600,6500,"Sub-basin 5"
3122,4200,802,20800,25000,"Sub-basin 5"
3123,200,7,1000,1200,"Sub-basin 5"
3124,100,1,1100,1200,"Sub-basin 5"
3125,200,7,1200,1400,"Sub-basin 5"
3126,200,26,1000,1200,"Sub-basin 5"
3127,100,2,500,600,"Sub-basin 5"
3128,5000,943,11400,16400,"Sub-basin 5"
3129,500,21,4600,5100,"Sub-basin 5"
3130,200,9,3400,3600,"Sub-basin 5"
3131,900,45,20900,21800,"Sub-basin 5"
3132,100,1,3000,3100,"Sub-basin 5"
3133,1300,87,8900,10200,"Sub-basin 5"
3134,200,6,2600,2800,"Sub-basin 5"
3135,100,1,800,900,"Sub-basin 5"
3136,1000,65,3100,4100,"Sub-basin 5"
3137,2400,256,6300,8700,"Sub-basin 5"
3138,1900,147,7800,9700,"Sub-basin 5"
3139,300,16,2200,2500,"Sub-basin 5"
3140,8200,3002,6400,14600,"Sub-basin 5"
3141,300,22,2000,2300,"Sub-basin 5"
3142,300,15,6100,6400,"Sub-basin 5"
3143,600,32,9700,10300,"Sub-basin 5"
3144,800,44,2900,3700,"Sub-basin 5"
3145,3200,262,8900,12100,"Sub-basin 5"
3146,400,24,4500,4900,"Sub-basin 5"
3147,300,10,3900,4200,"Sub-basin 5"
3148,6900,1345,17800,24700,"Sub-basin 5"
3149,3100,1467,5700,8800,"Sub-basin 5"
3150,1400,69,23200,24600,"Sub-basin 5"
3151,300,15,6800,7100,"Sub-basin 5"
3152,200,9,3900,4100,"Sub-basin 5"
3153,3300,325,23300,26600,"Sub-basin 5"
3154,2500,425,5400,7900,"Sub-basin 5"
3155,600,60,3000,3600,"Sub-basin 5"
3156,1000,176,4300,5300,"Sub-basin 5"
3157,2200,197,20200,22400,"Sub-basin 5"
3158,200,11,3300,3500,"Sub-basin 5"
3159,600,130,1100,1700,"Sub-basin 5"
3160,3600,371,11100,14700,"Sub-basin 5"
3161,1000,87,5500,6500,"Sub-basin 5"
3162,300,31,2400,2700,"Sub-basin 5"
3163,900,67,3800,4700,"Sub-basin 5"
3164,400,46,3500,3900,"Sub-basin 5"
3165,500,61,3300,3800,"Sub-basin 5"
3166,1500,86,19700,21200,"Sub-basin 5"
3167,2900,344,40100,43000,"Sub-basin 5"
3168,100,3,2300,2400,"Sub-basin 5"
3169,300,4,2500,2800,"Sub-basin 5"
3170,2400,366,12400,14800,"Sub-basin 5"
3171,1300,177,6000,7300,"Sub-basin 5"
3172,1100,87,4300,5400,"Sub-basin 5"
3173,500,98.5,3400,3900,"Sub-basin 5"
3174,300,16,5200,5500,"Sub-basin 5"
3175,100,2,2700,2800,"Sub-basin 5"
3176,100,3,2800,2900,"Sub-basin 5"
3177,200,4,6100,6300,"Sub-basin 5"
3178,1900,244,6100,8000,"Sub-basin 5"
3179,12600,4178,31600,44200,"Sub-basin 5"
3180,1300,174,12000,13300,"Sub-basin 5"
3181,100,2,800,900,"Sub-basin 5"
3182,600,67,2600,3200,"Sub-basin 5"
3183,500,29,3800,4300,"Sub-basin 5"
3184,100,2,1100,1200,"Sub-basin 5"
3185,100,2,1000,1100,"Sub-basin 5"
3186,400,24,5800,6200,"Sub-basin 5"
3187,1400,59,9300,10700,"Sub-basin 5"
3188,200,4,3900,4100,"Sub-basin 5"
3189,500,20,4500,5000,"Sub-basin 5"
3190,6300,1190,14500,20800,"Sub-basin 5"
3191,3800,1887,5500,9300,"Sub-basin 5"
3192,21400,5903.99,50000,71400,"Sub-basin 5"
3193,26000,7360,43400,69400,"Sub-basin 5"
3194,1400,155,14600,16000,"Sub-basin 5"
3195,100,3,2600,2700,"Sub-basin 5"
3196,1400,159,12800,14200,"Sub-basin 5"
3197,200,25,1900,2100,"Sub-basin 5"
3198,300,10,3100,3400,"Sub-basin 5"
3199,400,24,1900,2300,"Sub-basin 5"
3200,7000,4342,10200,17200,"Sub-basin 5"
3201,200,7,2400,2600,"Sub-basin 5"
3202,1300,133.08,6000,7300,"Sub-basin 5"
3203,1600,204,3500,5100,"Sub-basin 5"
3204,200,4,1200,1400,"Sub-basin 5"
3205,100,4,1300,1400,"Sub-basin 5"
3206,2900,935,9700,12600,"Sub-basin 5"
3207,100,1,3300,3400,"Sub-basin 5"
3208,200,4,3800,4000,"Sub-basin 5"
3209,200,10,2900,3100,"Sub-basin 5"
3210,200,3,1400,1600,"Sub-basin 5"
3211,1800,254,5900,7700,"Sub-basin 5"
3212,400,10,2700,3100,"Sub-basin 5"
3213,400,58,2000,2400,"Sub-basin 5"
3214,1600,189,4400,6000,"Sub-basin 5"
3215,1500,64,2300,3800,"Sub-basin 5"
3216,1800,467,7000,8800,"Sub-basin 5"
3217,100,1,1500,1600,"Sub-basin 5"
3218,100,1,1400,1500,"Sub-basin 5"
3219,200,4,3300,3500,"Sub-basin 5"
3220,100,4,1800,1900,"Sub-basin 5"
3221,800,40,7100,7900,"Sub-basin 5"
3222,100,1,2200,2300,"Sub-basin 5"
3223,100,2,1700,1800,"Sub-basin 5"
3224,100,1,600,700,"Sub-basin 5"
3225,100,3,1300,1400,"Sub-basin 5"
3226,100,1,1200,1300,"Sub-basin 5"
3227,2300,314,8400,10700,"Sub-basin 5"
3228,1100,269,2100,3200,"Sub-basin 5"
3229,500,36,1700,2200,"Sub-basin 5"
3230,7900,1274,40600,48500,"Sub-basin 5"
3231,200,4,2900,3100,"Sub-basin 5"
3232,400,53,1300,1700,"Sub-basin 5"
3233,100,1,1900,2000,"Sub-basin 5"
3234,100,3,1600,1700,"Sub-basin 5"
3235,300,27,2600,2900,"Sub-basin 5"
3236,1700,529,4200,5900,"Sub-basin 5"
3237,400,9,2200,2600,"Sub-basin 5"
3238,100,4,700,800,"Sub-basin 5"
3239,100,3,2100,2200,"Sub-basin 5"
3240,900,76,9500,10400,"Sub-basin 5"
3241,900,117,11900,12800,"Sub-basin 5"
3242,700,55,6300,7000,"Sub-basin 5"
3243,1000,120,10400,11400,"Sub-basin 5"
3244,1500,283,2700,4200,"Sub-basin 5"
3245,1700,166,6000,7700,"Sub-basin 5"
3246,400,12,3500,3900,"Sub-basin 5"
3247,100,2,2500,2600,"Sub-basin 5"
3248,700,53,6100,6800,"Sub-basin 5"
3249,800,47,9500,10300,"Sub-basin 5"
3250,100,1,2500,2600,"Sub-basin 5"
3251,500,22,4200,4700,"Sub-basin 5"
3252,600,29,8700,9300,"Sub-basin 5"
3253,1000,83,5400,6400,"Sub-basin 5"
3254,200,9,4700,4900,"Sub-basin 5"
3255,1000,169,6900,7900,"Sub-basin 5"
3256,1400,72,18800,20200,"Sub-basin 5"
3257,100,1,1300,1400,"Sub-basin 5"
3258,100,1,2600,2700,"Sub-basin 5"
3259,200,14,700,900,"Sub-basin 5"
3260,700,27,1600,2300,"Sub-basin 5"
3261,7200,1445,17000,24200,"Sub-basin 5"
3262,4500,1359,5500,10000,"Sub-basin 5"
3263,7400,4513,7200,14600,"Sub-basin 5"
3264,200,3,2800,3000,"Sub-basin 5"
3265,100,1,800,900,"Sub-basin 5"
3266,1500,278,5400,6900,"Sub-basin 5"
3267,200,6,2500,2700,"Sub-basin 5"
3268,100,0.17,1100,1200,"Sub-basin 5"
3269,200,3,1300,1500,"Sub-basin 5"
3270,200,9,1400,1600,"Sub-basin 5"
3271,1300,86,4000,5300,"Sub-basin 5"
3272,17400,5063,27600,45000,"Sub-basin 5"
3273,1000,155,1500,2500,"Sub-basin 5"
3274,100,4,400,500,"Sub-basin 5"
3275,300,15,4700,5000,"Sub-basin 5"
3276,200,9,4600,4800,"Sub-basin 5"
3277,300,9,2800,3100,"Sub-basin 5"
3278,300,6,3100,3400,"Sub-basin 5"
3279,100,2,2800,2900,"Sub-basin 5"
3280,300,10,3200,3500,"Sub-basin 5"
3281,1900,470,6500,8400,"Sub-basin 5"
3282,1800,227,12300,14100,"Sub-basin 5"
3283,700,55,4500,5200,"Sub-basin 5"
3284,700,98,3300,4000,"Sub-basin 5"
3285,10200,2900,15900,26100,"Sub-basin 5"
3286,600,103,1400,2000,"Sub-basin 5"
3287,100,1,1500,1600,"Sub-basin 5"
3288,400,28,6700,7100,"Sub-basin 5"
3289,100,2,300,400,"Sub-basin 5"
3290,600,47,3400,4000,"Sub-basin 5"
3291,700,36,3100,3800,"Sub-basin 5"
3292,200,6,2200,2400,"Sub-basin 5"
3293,100,5,1300,1400,"Sub-basin 5"
3294,100,1,1700,1800,"Sub-basin 5"
3295,300,14,3100,3400,"Sub-basin 5"
3296,100,4,1200,1300,"Sub-basin 5"
3297,3100,766,5600,8700,"Sub-basin 5"
3298,500,32,1300,1800,"Sub-basin 5"
3299,11200,2315,39200,50400,"Sub-basin 5"
3300,1200,176,4500,5700,"Sub-basin 5"
3301,400,44,3900,4300,"Sub-basin 5"
3302,1500,240,4800,6300,"Sub-basin 5"
3303,7400,1281,16800,24200,"Sub-basin 5"
3304,1400,528,6500,7900,"Sub-basin 5"
3305,400,17,5300,5700,"Sub-basin 5"
3306,1000,110,5800,6800,"Sub-basin 5"
3307,200,5,2000,2200,"Sub-basin 5"
3308,600,42,5100,5700,"Sub-basin 5"
3309,100,4,700,800,"Sub-basin 5"
3310,41800,18540.83,42200,84000,"Sub-basin 5"
3311,400,34,1900,2300,"Sub-basin 5"
3312,400,17,900,1300,"Sub-basin 5"
3313,1400,147,12100,13500,"Sub-basin 5"
3314,1600,46.0156,10300,11900,"Sub-basin 5"
3315,1400,93,6800,8200,"Sub-basin 5"
3316,8400,3603,14200,22600,"Sub-basin 5"
3317,100,1,500,600,"Sub-basin 5"
3318,200,8,1600,1800,"Sub-basin 5"
3319,100,3,900,1000,"Sub-basin 5"
3320,400,12,1200,1600,"Sub-basin 5"
3321,200,7,2800,3000,"Sub-basin 5"
3322,100,2,1300,1400,"Sub-basin 5"
3323,1500,99.0182,11000,12500,"Sub-basin 5"
3324,600,28,6400,7000,"Sub-basin 5"
3325,600,24,6100,6700,"Sub-basin 5"
3326,4800,831,12500,17300,"Sub-basin 5"
3327,200,5,800,1000,"Sub-basin 5"
3328,700,64,2700,3400,"Sub-basin 5"
3329,500,29,3000,3500,"Sub-basin 5"
3330,200,5,1300,1500,"Sub-basin 5"
3331,200,23,2200,2400,"Sub-basin 5"
3332,300,13,4000,4300,"Sub-basin 5"
3333,1700,195,5000,6700,"Sub-basin 5"
3334,100,4,1000,1100,"Sub-basin 5"
3335,100,2,1300,1400,"Sub-basin 5"
3336,2000,118,9000,11000,"Sub-basin 5"
3337,3400,568.84,7900,11300,"Sub-basin 5"
3338,1400,165,9000,10400,"Sub-basin 5"
3339,24700,4880,101400,126100,"Sub-basin 5"
3340,300,6,1600,1900,"Sub-basin 5"
3341,600,75,3400,4000,"Sub-basin 5"
3342,200,2,2300,2500,"Sub-basin 5"
3343,1000,116,6500,7500,"Sub-basin 5"
3344,1900,663,3900,5800,"Sub-basin 5"
3345,400,20,4800,5200,"Sub-basin 5"
3346,500,16,7400,7900,"Sub-basin 5"
3347,1700,435,6500,8200,"Sub-basin 5"
3348,100,2,2300,2400,"Sub-basin 5"
3349,2800,334,12600,15400,"Sub-basin 5"
3350,100,3,700,800,"Sub-basin 5"
3351,13900,4123,20400,34300,"Sub-basin 5"
3352,1800,267,6900,8700,"Sub-basin 5"
3353,400,15,3000,3400,"Sub-basin 5"
3354,600,59,4800,5400,"Sub-basin 5"
3355,100,1,1800,1900,"Sub-basin 5"
3356,3000,1749,5500,8500,"Sub-basin 5"
3357,100,1,1000,1100,"Sub-basin 5"
3358,100,1,2500,2600,"Sub-basin 5"
3359,500,41,3800,4300,"Sub-basin 5"
3360,1100,185,3500,4600,"Sub-basin 5"
3361,800,57,5400,6200,"Sub-basin 5"
3362,100,2,1200,1300,"Sub-basin 5"
3363,4000,1341,8300,12300,"Sub-basin 5"
3364,300,22,2000,2300,"Sub-basin 5"
3365,1200,120,4200,5400,"Sub-basin 5"
3366,1700,193,4300,6000,"Sub-basin 5"
3367,700,36,1500,2200,"Sub-basin 5"
3368,700,115,600,1300,"Sub-basin 5"
3369,600,24,2300,2900,"Sub-basin 5"
3370,100,1,800,900,"Sub-basin 5"
3371,1600,168,7100,8700,"Sub-basin 5"
3372,700,131,2700,3400,"Sub-basin 5"
3373,1200,147,3800,5000,"Sub-basin 5"
3374,200,9,5200,5400,"Sub-basin 5"
3375,200,7,4400,4600,"Sub-basin 5"
3376,100,1,1900,2000,"Sub-basin 5"
3377,100,1,2700,2800,"Sub-basin 5"
3378,100,2,2500,2600,"Sub-basin 5"
3379,300,3,3000,3300,"Sub-basin 5"
3380,1900,677,3000,4900,"Sub-basin 5"
3381,100,1,1200,1300,"Sub-basin 5"
3382,100,2,700,800,"Sub-basin 5"
3383,100,4,2700,2800,"Sub-basin 5"
3384,100,1,1500,1600,"Sub-basin 5"
3385,200,5,1800,2000,"Sub-basin 5"
3386,400,34,5300,5700,"Sub-basin 5"
3387,1100,87,5800,6900,"Sub-basin 5"
3388,1800,181,7100,8900,"Sub-basin 5"
3389,600,46,3800,4400,"Sub-basin 5"
3390,100,1,1300,1400,"Sub-basin 5"
3391,900,57,3300,4200,"Sub-basin 5"
3392,800,66,2000,2800,"Sub-basin 5"
3393,400,9,200,600,"Sub-basin 5"
3394,100,5.0004,1700,1800,"Sub-basin 5"
3395,100,3.0003,1800,1900,"Sub-basin 5"
3396,1500,163,6700,8200,"Sub-basin 5"
3397,200,6,1300,1500,"Sub-basin 5"
3398,1900,270,8700,10600,"Sub-basin 5"
3399,12000,4847,15200,27200,"Sub-basin 5"
3400,4800,334.0805,37100,41900,"Sub-basin 5"
3401,100,1.0005,1200,1300,"Sub-basin 5"
3402,100,1.0004,2100,2200,"Sub-basin 5"
3403,200,4.0006,3000,3200,"Sub-basin 5"
3404,5400,476.1914,34100,39500,"Sub-basin 5"
3405,3800,692,28200,32000,"Sub-basin 5"
3406,300,5,4300,4600,"Sub-basin 5"
3407,200,3,3700,3900,"Sub-basin 5"
3408,1300,293,2500,3800,"Sub-basin 5"
3409,9300,484,43000,52300,"Sub-basin 5"
3410,200,3,2500,2700,"Sub-basin 5"
3411,1100,37,8600,9700,"Sub-basin 5"
3412,6800,1271,13400,20200,"Sub-basin 5"
3413,300,21,1900,2200,"Sub-basin 5"
3414,100,2.0006,1800,1900,"Sub-basin 5"
3415,800,70.0068,7500,8300,"Sub-basin 5"
3416,500,27,5600,6100,"Sub-basin 5"
3417,400,21.0015,2800,3200,"Sub-basin 5"
3418,200,3,2200,2400,"Sub-basin 5"
3419,100,2,2300,2400,"Sub-basin 5"
3420,3000,645,8400,11400,"Sub-basin 5"
3421,300,8,2200,2500,"Sub-basin 5"
3422,300,10,1800,2100,"Sub-basin 5"
3423,27600,10899,28800,56400,"Sub-basin 5"
3424,200,6,1000,1200,"Sub-basin 5"
3425,200,2,1200,1400,"Sub-basin 5"
3426,1300,190,2700,4000,"Sub-basin 5"
3427,1400,274,2900,4300,"Sub-basin 5"
3428,1600,417,2600,4200,"Sub-basin 5"
3429,200,6.0011,4000,4200,"Sub-basin 5"
3430,1600,92.0228,13300,14900,"Sub-basin 5"
3431,1300,25.0078,16900,18200,"Sub-basin 5"
3432,200,3,1400,1600,"Sub-basin 5"
3433,300,4,4800,5100,"Sub-basin 5"
3434,100,2,1100,1200,"Sub-basin 5"
3435,200,3,2100,2300,"Sub-basin 5"
3436,4700,1478,8800,13500,"Sub-basin 5"
3437,10200,3275,11300,21500,"Sub-basin 5"
3438,400,35,1700,2100,"Sub-basin 5"
3439,300,12,3600,3900,"Sub-basin 5"
3440,300,12.0015,3400,3700,"Sub-basin 5"
3441,600,18.005,6900,7500,"Sub-basin 5"
3442,1500,379,1800,3300,"Sub-basin 5"
3443,100,2,1200,1300,"Sub-basin 5"
3444,400,16,5000,5400,"Sub-basin 5"
3445,600,12,4200,4800,"Sub-basin 5"
3446,100,2,1400,1500,"Sub-basin 5"
3447,400,21,2400,2800,"Sub-basin 5"
3448,500,17.0041,5600,6100,"Sub-basin 5"
3449,2600,243.5,9700,12300,"Sub-basin 5"
3450,300,8,2000,2300,"Sub-basin 5"
3451,100,1,100,200,"Sub-basin 5"
3452,300,6,1900,2200,"Sub-basin 5"
3453,800,130,1700,2500,"Sub-basin 5"
3454,1200,28.012,12900,14100,"Sub-basin 5"
3455,100,1.0002,2600,2700,"Sub-basin 5"
3456,1500,285,5000,6500,"Sub-basin 5"
3457,900,117,3500,4400,"Sub-basin 5"
3458,500,22,3000,3500,"Sub-basin 5"
3459,100,1,300,400,"Sub-basin 5"
3460,100,20,300,400,"Sub-basin 5"
3461,200,9,800,1000,"Sub-basin 5"
3462,200,8,300,500,"Sub-basin 5"
3463,100,2,300,400,"Sub-basin 5"
3464,300,4,700,1000,"Sub-basin 5"
3465,700,39,4200,4900,"Sub-basin 5"
3466,100,3.0005,1400,1500,"Sub-basin 5"
3467,100,1,700,800,"Sub-basin 5"
3468,200,5,900,1100,"Sub-basin 5"
3469,800,85,5500,6300,"Sub-basin 5"
3470,400,25,1500,1900,"Sub-basin 5"
3471,5900,1692,19500,25400,"Sub-basin 5"
3472,13700,3586,30900,44600,"Sub-basin 5"
3473,100,6,1500,1600,"Sub-basin 5"
3474,800,341,3200,4000,"Sub-basin 5"
3475,100,18,500,600,"Sub-basin 5"
3476,200,7,500,700,"Sub-basin 5"
3477,100,2,700,800,"Sub-basin 5"
3478,1000,84,3800,4800,"Sub-basin 5"
3479,200,8,1200,1400,"Sub-basin 5"
3480,4600,1782,17000,21600,"Sub-basin 5"
3481,400,14,1600,2000,"Sub-basin 5"
3482,900,58,2300,3200,"Sub-basin 5"
3483,300,11.0015,5300,5600,"Sub-basin 5"
3484,2900,1271,5200,8100,"Sub-basin 5"
3485,400,15,800,1200,"Sub-basin 5"
3486,4400,752,9000,13400,"Sub-basin 5"
3487,4400,1224,5400,9800,"Sub-basin 5"
3488,500,48,1400,1900,"Sub-basin 5"
3489,200,10,2200,2400,"Sub-basin 5"
3490,2600,309,7200,9800,"Sub-basin 5"
3491,100,1.0003,900,1000,"Sub-basin 5"
3492,500,15.0085,6200,6700,"Sub-basin 5"
3493,100,1.0024,1600,1700,"Sub-basin 5"
3494,100,1,700,800,"Sub-basin 5"
3495,800,63,4400,5200,"Sub-basin 5"
3496,1100,140,6000,7100,"Sub-basin 5"
3497,2000,247,4500,6500,"Sub-basin 5"
3498,500,13,1900,2400,"Sub-basin 5"
3499,100,1,500,600,"Sub-basin 5"
3500,600,58,400,1000,"Sub-basin 5"
3501,2100,396,5200,7300,"Sub-basin 5"
3502,600,30,4200,4800,"Sub-basin 5"
3503,100,1,900,1000,"Sub-basin 5"
3504,200,5.0011,3000,3200,"Sub-basin 5"
3505,300,5,2900,3200,"Sub-basin 5"
3506,1000,60,4900,5900,"Sub-basin 5"
3507,500,22,4000,4500,"Sub-basin 5"
3508,100,2,2500,2600,"Sub-basin 5"
3509,900,79,3000,3900,"Sub-basin 5"
3510,6800,1337,9600,16400,"Sub-basin 5"
3511,1200,54,6300,7500,"Sub-basin 5"
3512,300,6.0014,3600,3900,"Sub-basin 5"
3513,300,5.001,1700,2000,"Sub-basin 5"
3514,1200,95,6100,7300,"Sub-basin 5"
3515,800,84,6500,7300,"Sub-basin 5"
3516,100,1,1900,2000,"Sub-basin 5"
3517,5200,560,19200,24400,"Sub-basin 5"
3518,200,6,1000,1200,"Sub-basin 5"
3519,100,5,1000,1100,"Sub-basin 5"
3520,100,1,1100,1200,"Sub-basin 5"
3521,600,32,3600,4200,"Sub-basin 5"
3522,100,2,400,500,"Sub-basin 5"
3523,3300,1209,8700,12000,"Sub-basin 5"
3524,1700,81.66,12000,13700,"Sub-basin 5"
3525,100,2,1300,1400,"Sub-basin 5"
3526,700,90,3700,4400,"Sub-basin 5"
3527,500,26,3500,4000,"Sub-basin 5"
3528,800,26,3500,4300,"Sub-basin 5"
3529,500,27,1800,2300,"Sub-basin 5"
3530,300,8,1900,2200,"Sub-basin 5"
3531,100,2,2300,2400,"Sub-basin 5"
3532,900,212,2400,3300,"Sub-basin 5"
3533,200,10,300,500,"Sub-basin 5"
3534,1000,144,6200,7200,"Sub-basin 5"
3535,400,23,3200,3600,"Sub-basin 5"
3536,900,41,6200,7100,"Sub-basin 5"
3537,200,7,2700,2900,"Sub-basin 5"
3538,700,65,5500,6200,"Sub-basin 5"
3539,100,1,1200,1300,"Sub-basin 5"
3540,100,3,500,600,"Sub-basin 5"
3541,100,2,0,100,"Sub-basin 5"
3542,400,39,1800,2200,"Sub-basin 5"
3543,600,99,400,1000,"Sub-basin 5"
3544,100,2.0005,1200,1300,"Sub-basin 5"
3545,200,23,2400,2600,"Sub-basin 5"
3546,200,3,2600,2800,"Sub-basin 5"
3547,400,36,1400,1800,"Sub-basin 5"
3548,6200,805,24400,30600,"Sub-basin 5"
3549,2200,173,17100,19300,"Sub-basin 5"
3550,300,270,2700,3000,"Sub-basin 5"
3551,3300,1254,2600,5900,"Sub-basin 5"
3552,200,3,900,1100,"Sub-basin 5"
3553,200,2,900,1100,"Sub-basin 5"
3554,200,3,300,500,"Sub-basin 5"
3555,300,12,700,1000,"Sub-basin 5"
3556,100,3,100,200,"Sub-basin 5"
3557,500,74,2800,3300,"Sub-basin 5"
3558,200,13,1000,1200,"Sub-basin 5"
3559,200,9,500,700,"Sub-basin 5"
3560,100,4,1000,1100,"Sub-basin 5"
3561,700,90,3400,4100,"Sub-basin 5"
3562,100,3,400,500,"Sub-basin 5"
3563,600,56,1900,2500,"Sub-basin 5"
3564,2900,593,11400,14300,"Sub-basin 5"
3565,100,2,700,800,"Sub-basin 5"
3566,1600,455,4100,5700,"Sub-basin 5"
3567,1300,82,2100,3400,"Sub-basin 5"
3568,100,1,900,1000,"Sub-basin 5"
3569,2100,545,4100,6200,"Sub-basin 5"
3570,100,1,1000,1100,"Sub-basin 5"
3571,100,4,1000,1100,"Sub-basin 5"
3572,100,1,1000,1100,"Sub-basin 5"
3573,400,37,400,800,"Sub-basin 5"
3574,10000,1686,17700,27700,"Sub-basin 5"
3575,7300,2377,10300,17600,"Sub-basin 5"
3576,2300,65.0334,27000,29300,"Sub-basin 5"
3577,700,81,2600,3300,"Sub-basin 5"
3578,1400,179,9800,11200,"Sub-basin 5"
3579,1000,121,6000,7000,"Sub-basin 5"
3580,200,3,2200,2400,"Sub-basin 5"
3581,200,4,2700,2900,"Sub-basin 5"
3582,900,85,7100,8000,"Sub-basin 5"
3583,1500,409,3400,4900,"Sub-basin 5"
3584,300,23,100,400,"Sub-basin 5"
3585,100,1,1200,1300,"Sub-basin 5"
3586,100,1,1800,1900,"Sub-basin 5"
3587,200,2,1900,2100,"Sub-basin 5"
3588,2900,369,8100,11000,"Sub-basin 5"
3589,800,42,5900,6700,"Sub-basin 5"
3590,100,2,1100,1200,"Sub-basin 5"
3591,400,23,3200,3600,"Sub-basin 5"
3592,100,3,300,400,"Sub-basin 5"
3593,600,150,3800,4400,"Sub-basin 5"
3594,100,6,1200,1300,"Sub-basin 5"
3595,1800,173,3200,5000,"Sub-basin 5"
3596,1200,79,16400,17600,"Sub-basin 5"
3597,600,51,2900,3500,"Sub-basin 5"
3598,300,13,2700,3000,"Sub-basin 5"
3599,100,2,1700,1800,"Sub-basin 5"
3600,400,22,800,1200,"Sub-basin 5"
3601,1800,306,16400,18200,"Sub-basin 5"
3602,5700,1786,11000,16700,"Sub-basin 5"
3603,17000,10221.84,11800,28800,"Sub-basin 5"
3604,200,37,700,900,"Sub-basin 5"
3605,300,9,1500,1800,"Sub-basin 5"
3606,1500,138,3700,5200,"Sub-basin 5"
3607,1100,130,7100,8200,"Sub-basin 5"
3608,200,13,2500,2700,"Sub-basin 5"
3609,900,70,7800,8700,"Sub-basin 5"
3610,3100,284,13700,16800,"Sub-basin 5"
3611,1100,249,1900,3000,"Sub-basin 5"
3612,8200,4329.2404,4600,12800,"Sub-basin 5"
3613,100,4,800,900,"Sub-basin 5"
3614,400,10.17,2600,3000,"Sub-basin 5"
3615,500,42,2700,3200,"Sub-basin 5"
3616,200,7,1900,2100,"Sub-basin 5"
3617,700,39,3100,3800,"Sub-basin 5"
3618,800,148,2100,2900,"Sub-basin 5"
3619,800,54,2900,3700,"Sub-basin 5"
3620,400,19,2100,2500,"Sub-basin 5"
3621,400,36,2800,3200,"Sub-basin 5"
3622,700,52,3300,4000,"Sub-basin 5"
3623,400,21,3600,4000,"Sub-basin 5"
3624,800,36,8600,9400,"Sub-basin 5"
3625,100,3,700,800,"Sub-basin 5"
3626,1700,154,2400,4100,"Sub-basin 5"
3627,400,25,1300,1700,"Sub-basin 5"
3628,2900,374.17,10500,13400,"Sub-basin 5"
3629,6300,476,21100,27400,"Sub-basin 5"
3630,200,12,1600,1800,"Sub-basin 5"
3631,200,4,3000,3200,"Sub-basin 5"
3632,100,1,700,800,"Sub-basin 5"
3633,2100,176,21900,24000,"Sub-basin 5"
3634,400,27,4200,4600,"Sub-basin 5"
3635,500,31,3200,3700,"Sub-basin 5"
3636,2200,846,3200,5400,"Sub-basin 5"
3637,8400,1475,14400,22800,"Sub-basin 5"
3638,200,9,1200,1400,"Sub-basin 5"
3639,1600,271,4200,5800,"Sub-basin 5"
3640,200,18,1200,1400,"Sub-basin 5"
3641,100,4,1400,1500,"Sub-basin 5"
3642,100,1,1400,1500,"Sub-basin 5"
3643,2100,86,18300,20400,"Sub-basin 5"
3644,400,16,5800,6200,"Sub-basin 5"
3645,100,1,1500,1600,"Sub-basin 5"
3646,2200,449,4000,6200,"Sub-basin 5"
3647,200,10,2100,2300,"Sub-basin 5"
3648,100,1,1300,1400,"Sub-basin 5"
3649,600,143,4200,4800,"Sub-basin 5"
3650,100,1,700,800,"Sub-basin 5"
3651,800,137,1800,2600,"Sub-basin 5"
3652,400,33,3300,3700,"Sub-basin 5"
3653,400,54,3600,4000,"Sub-basin 5"
3654,2100,168,6800,8900,"Sub-basin 5"
3655,11500,2100,57800,69300,"Sub-basin 5"
3656,3100,882,6500,9600,"Sub-basin 5"
3657,1100,77,10700,11800,"Sub-basin 5"
3658,4200,208,35100,39300,"Sub-basin 5"
3659,100,2,700,800,"Sub-basin 5"
3660,200,2,700,900,"Sub-basin 5"
3661,4400,617,23800,28200,"Sub-basin 5"
3662,700,59,3700,4400,"Sub-basin 5"
3663,200,5,1300,1500,"Sub-basin 5"
3664,16600,5617,23000,39600,"Sub-basin 5"
3665,1200,214,2100,3300,"Sub-basin 5"
3666,700,62,5000,5700,"Sub-basin 5"
3667,1400,134.33,5200,6600,"Sub-basin 5"
3668,300,15,1400,1700,"Sub-basin 5"
3669,1800,320,8900,10700,"Sub-basin 5"
3670,100,1,1100,1200,"Sub-basin 5"
3671,300,13.0037,2400,2700,"Sub-basin 5"
3672,1500,119,8000,9500,"Sub-basin 5"
3673,200,25,1500,1700,"Sub-basin 5"
3674,200,6,2500,2700,"Sub-basin 5"
3675,1500,149,5900,7400,"Sub-basin 5"
3676,1600,76,6800,8400,"Sub-basin 5"
3677,3900,587,11500,15400,"Sub-basin 5"
3678,1100,73,4600,5700,"Sub-basin 5"
3679,300,16,1900,2200,"Sub-basin 5"
3680,100,1,1300,1400,"Sub-basin 5"
3681,1200,67,2900,4100,"Sub-basin 5"
3682,200,7,1000,1200,"Sub-basin 5"
3683,4800,1785,14300,19100,"Sub-basin 5"
3684,100,1,600,700,"Sub-basin 5"
3685,1100,110,5000,6100,"Sub-basin 5"
3686,3100,232,11800,14900,"Sub-basin 5"
3687,200,9,800,1000,"Sub-basin 5"
3688,1200,104,8300,9500,"Sub-basin 5"
3689,500,62,1300,1800,"Sub-basin 5"
3690,4900,980,21500,26400,"Sub-basin 5"
3691,500,33,700,1200,"Sub-basin 5"
3692,700,49,4200,4900,"Sub-basin 5"
3693,400,24,3200,3600,"Sub-basin 5"
3694,400,33,2600,3000,"Sub-basin 5"
3695,2600,235,10100,12700,"Sub-basin 5"
3696,100,3,700,800,"Sub-basin 5"
3697,600,55,600,1200,"Sub-basin 5"
3698,400,17,2200,2600,"Sub-basin 5"
3699,1000,127,5800,6800,"Sub-basin 5"
3700,100,2,600,700,"Sub-basin 5"
3701,800,146,10500,11300,"Sub-basin 5"
3702,5200,1306,23500,28700,"Sub-basin 5"
3703,100,1,1000,1100,"Sub-basin 5"
3704,100,2.0009,1000,1100,"Sub-basin 5"
3705,200,3,1000,1200,"Sub-basin 5"
3706,12400,4506,14600,27000,"Sub-basin 5"
3707,400,14.0015,3300,3700,"Sub-basin 5"
3708,1600,280.28,4000,5600,"Sub-basin 5"
3709,9100,3721,11300,20400,"Sub-basin 5"
3710,2500,673,4400,6900,"Sub-basin 5"
3711,700,187,2200,2900,"Sub-basin 5"
3712,3400,326,11300,14700,"Sub-basin 5"
3713,100,1,200,300,"Sub-basin 5"
3714,2900,268,10900,13800,"Sub-basin 5"
3715,2900,343,15800,18700,"Sub-basin 5"
3716,100,2,1000,1100,"Sub-basin 5"
3717,5600,2323,8800,14400,"Sub-basin 5"
3718,6600,2079,8500,15100,"Sub-basin 5"
3719,300,43,2000,2300,"Sub-basin 5"
3720,200,8.0012,3600,3800,"Sub-basin 5"
3721,1200,181,8400,9600,"Sub-basin 5"
3722,500,35,3700,4200,"Sub-basin 5"
3723,1000,59,2800,3800,"Sub-basin 5"
3724,600,131,1400,2000,"Sub-basin 5"
3725,700,61,3200,3900,"Sub-basin 5"
3726,600,29,4100,4700,"Sub-basin 5"
3727,1600,382,3000,4600,"Sub-basin 5"
3728,1300,87,5900,7200,"Sub-basin 5"
3729,1100,68,2600,3700,"Sub-basin 5"
3730,1700,152,5500,7200,"Sub-basin 5"
3731,2300,227,9100,11400,"Sub-basin 5"
3732,3100,186.0181,26500,29600,"Sub-basin 5"
3733,100,2,300,400,"Sub-basin 5"
3734,200,8,2500,2700,"Sub-basin 5"
3735,1200,215,2900,4100,"Sub-basin 5"
3736,5400,1716,7900,13300,"Sub-basin 5"
3737,400,21.0019,6900,7300,"Sub-basin 5"
3738,3200,919,6600,9800,"Sub-basin 5"
3739,2800,1345,6600,9400,"Sub-basin 5"
3740,1000,60.0059,7800,8800,"Sub-basin 5"
3741,100,1,1300,1400,"Sub-basin 5"
3742,400,23,2700,3100,"Sub-basin 5"
3743,600,88,2800,3400,"Sub-basin 5"
3744,1200,152,3400,4600,"Sub-basin 5"
3745,500,84,3000,3500,"Sub-basin 5"
3746,1400,160,10900,12300,"Sub-basin 5"
3747,3000,273,10800,13800,"Sub-basin 5"
3748,200,7,1700,1900,"Sub-basin 5"
3749,400,30,300,700,"Sub-basin 5"
3750,200,8,500,700,"Sub-basin 5"
3751,300,15,700,1000,"Sub-basin 5"
3752,900,154,1300,2200,"Sub-basin 5"
3753,10000,2466,13700,23700,"Sub-basin 5"
3754,100,6,1300,1400,"Sub-basin 5"
3755,100,8,1800,1900,"Sub-basin 5"
3756,100,5,1100,1200,"Sub-basin 5"
3757,400,42,5400,5800,"Sub-basin 5"
3758,300,5,2600,2900,"Sub-basin 5"
3759,100,5,800,900,"Sub-basin 5"
3760,400,34,900,1300,"Sub-basin 5"
3761,100,1,300,400,"Sub-basin 5"
3762,100,9,900,1000,"Sub-basin 5"
3763,1000,56,6800,7800,"Sub-basin 5"
3764,1300,88,9100,10400,"Sub-basin 5"
3765,100,1,900,1000,"Sub-basin 5"
3766,900,68,3800,4700,"Sub-basin 5"
3767,1100,74,8900,10000,"Sub-basin 5"
3768,400,26,1700,2100,"Sub-basin 5"
3769,400,18,800,1200,"Sub-basin 5"
3770,1600,325.5,4300,5900,"Sub-basin 5"
3771,1500,120,4300,5800,"Sub-basin 5"
3772,100,5,400,500,"Sub-basin 5"
3773,100,2,1200,1300,"Sub-basin 5"
3774,1000,64,5100,6100,"Sub-basin 5"
3775,500,24,2100,2600,"Sub-basin 5"
3776,400,35,1700,2100,"Sub-basin 5"
3777,1400,210,4600,6000,"Sub-basin 5"
3778,100,1,1800,1900,"Sub-basin 5"
3779,800,102,2800,3600,"Sub-basin 5"
3780,3800,861,8300,12100,"Sub-basin 5"
3781,3700,1896,2300,6000,"Sub-basin 5"
3782,1200,85,6600,7800,"Sub-basin 5"
3783,200,5,400,600,"Sub-basin 5"
3784,600,27,4700,5300,"Sub-basin 5"
3785,200,15,700,900,"Sub-basin 5"
3786,200,3,500,700,"Sub-basin 5"
3787,200,3,1400,1600,"Sub-basin 5"
3788,100,1.0012,800,900,"Sub-basin 5"
3789,100,1,900,1000,"Sub-basin 5"
3790,2000,397,6800,8800,"Sub-basin 5"
3791,500,58,1200,1700,"Sub-basin 5"
3792,100,1,2100,2200,"Sub-basin 5"
3793,100,5,1800,1900,"Sub-basin 5"
3794,5000,566.33,24600,29600,"Sub-basin 5"
3795,1800,386,3700,5500,"Sub-basin 5"
3796,3100,356,8800,11900,"Sub-basin 5"
3797,2000,250,4800,6800,"Sub-basin 5"
3798,1000,55,5200,6200,"Sub-basin 5"
3799,900,163,3900,4800,"Sub-basin 5"
3800,300,11,500,800,"Sub-basin 5"
3801,100,3,1700,1800,"Sub-basin 5"
3802,100,3,600,700,"Sub-basin 5"
3803,400,11.0018,3800,4200,"Sub-basin 5"
3804,100,1,900,1000,"Sub-basin 5"
3805,200,2,1600,1800,"Sub-basin 5"
3806,300,10,1400,1700,"Sub-basin 5"
3807,900,57,7600,8500,"Sub-basin 5"
3808,2900,674,3300,6200,"Sub-basin 5"
3809,900,149,3700,4600,"Sub-basin 5"
3810,300,4,700,1000,"Sub-basin 5"
3811,300,20,2200,2500,"Sub-basin 5"
3812,100,3,1300,1400,"Sub-basin 5"
3813,300,12,2400,2700,"Sub-basin 5"
3814,5100,3075,7200,12300,"Sub-basin 5"
3815,100,2,1100,1200,"Sub-basin 5"
3816,300,21,2200,2500,"Sub-basin 5"
3817,1600,102,24900,26500,"Sub-basin 5"
3818,100,9,900,1000,"Sub-basin 5"
3819,300,12,0,300,"Sub-basin 5"
3820,4300,485,13700,18000,"Sub-basin 5"
3821,100,2,500,600,"Sub-basin 5"
3822,1000,99,6000,7000,"Sub-basin 5"
3823,600,23,2400,3000,"Sub-basin 5"
3824,200,4,2600,2800,"Sub-basin 5"
3825,100,2,2300,2400,"Sub-basin 5"
3826,100,5,1500,1600,"Sub-basin 5"
3827,600,93,2600,3200,"Sub-basin 5"
3828,2100,446,6100,8200,"Sub-basin 5"
3829,500,20,3100,3600,"Sub-basin 5"
3830,2000,303,8700,10700,"Sub-basin 5"
3831,100,5,1000,1100,"Sub-basin 5"
3832,1100,122,8100,9200,"Sub-basin 5"
3833,29600,14539.66,47200,76800,"Sub-basin 5"
3834,400,9,4900,5300,"Sub-basin 5"
3835,1700,202,5000,6700,"Sub-basin 5"
3836,400,32.84,2300,2700,"Sub-basin 5"
3837,7400,2304.51,11500,18900,"Sub-basin 5"
3838,100,2,900,1000,"Sub-basin 5"
3839,100,1,900,1000,"Sub-basin 5"
3840,500,22,2000,2500,"Sub-basin 5"
3841,2200,962,9700,11900,"Sub-basin 5"
3842,200,7,2200,2400,"Sub-basin 5"
3843,100,2,1900,2000,"Sub-basin 5"
3844,200,7.0007,3000,3200,"Sub-basin 5"
3845,100,4,1000,1100,"Sub-basin 5"
3846,5500,964,11000,16500,"Sub-basin 5"
3847,400,39,1900,2300,"Sub-basin 5"
3848,8100,1182.84,34500,42600,"Sub-basin 5"
3849,1100,269,2600,3700,"Sub-basin 5"
3850,1300,77,4900,6200,"Sub-basin 5"
3851,700,46,5500,6200,"Sub-basin 5"
3852,300,20,2600,2900,"Sub-basin 5"
3853,800,150,2200,3000,"Sub-basin 5"
3854,3400,1037,7400,10800,"Sub-basin 5"
3855,2200,184,7800,10000,"Sub-basin 5"
3856,200,12,1100,1300,"Sub-basin 5"
3857,3600,1356,15100,18700,"Sub-basin 5"
3858,500,19,4700,5200,"Sub-basin 5"
3859,200,10,3800,4000,"Sub-basin 5"
3860,400,9,2100,2500,"Sub-basin 5"
3861,100,11,1200,1300,"Sub-basin 5"
3862,4700,1312,6400,11100,"Sub-basin 5"
3863,500,17,4100,4600,"Sub-basin 5"
3864,2300,445,5300,7600,"Sub-basin 5"
3865,100,1,1000,1100,"Sub-basin 5"
3866,2600,584,7100,9700,"Sub-basin 5"
3867,500,45,4500,5000,"Sub-basin 5"
3868,100,1,1100,1200,"Sub-basin 5"
3869,200,2,3500,3700,"Sub-basin 5"
3870,400,12,3200,3600,"Sub-basin 5"
3871,800,30,8400,9200,"Sub-basin 5"
3872,100,2,600,700,"Sub-basin 5"
3873,800,128,2600,3400,"Sub-basin 5"
3874,9200,3378.68,32500,41700,"Sub-basin 5"
3875,5400,544.01,24300,29700,"Sub-basin 5"
3876,100,1,500,600,"Sub-basin 5"
3877,100,3,1100,1200,"Sub-basin 5"
3878,1100,118,7500,8600,"Sub-basin 5"
3879,300,50,1200,1500,"Sub-basin 5"
3880,1800,118,7500,9300,"Sub-basin 5"
3881,700,172.5,2500,3200,"Sub-basin 5"
3882,200,7,4400,4600,"Sub-basin 5"
3883,400,20,3200,3600,"Sub-basin 5"
3884,200,4,1700,1900,"Sub-basin 5"
3885,1200,339.34,7200,8400,"Sub-basin 5"
3886,1000,418,6900,7900,"Sub-basin 5"
3887,100,3,900,1000,"Sub-basin 5"
3888,3300,820,6700,10000,"Sub-basin 5"
3889,700,22,10200,10900,"Sub-basin 5"
3890,2100,401,7100,9200,"Sub-basin 5"
3891,600,29,6300,6900,"Sub-basin 5"
3892,500,26,6200,6700,"Sub-basin 5"
3893,1300,97,11300,12600,"Sub-basin 5"
3894,1600,405,3200,4800,"Sub-basin 5"
3895,600,83,1900,2500,"Sub-basin 5"
3896,500,51,500,1000,"Sub-basin 5"
3897,100,1,900,1000,"Sub-basin 5"
3898,100,2.0002,2000,2100,"Sub-basin 5"
3899,100,1,2200,2300,"Sub-basin 5"
3900,700,60.17,2500,3200,"Sub-basin 5"
3901,2800,500,10300,13100,"Sub-basin 5"
3902,2600,1062.83,7200,9800,"Sub-basin 5"
3903,100,2,600,700,"Sub-basin 5"
3904,700,123,2800,3500,"Sub-basin 5"
3905,300,12,1600,1900,"Sub-basin 5"
3906,4400,798.16,12400,16800,"Sub-basin 5"
3907,1700,146,13000,14700,"Sub-basin 5"
3908,100,2,500,600,"Sub-basin 5"
3909,1300,57,12700,14000,"Sub-basin 5"
3910,1000,66.33,5400,6400,"Sub-basin 5"
3911,1100,266,5000,6100,"Sub-basin 5"
3912,27900,1723.2103,200700,228600,"Sub-basin 5"
3913,500,14,2700,3200,"Sub-basin 5"
3914,3900,488,28500,32400,"Sub-basin 5"
3915,600,59,5000,5600,"Sub-basin 5"
3916,2000,499,2700,4700,"Sub-basin 5"
3917,100,2,1000,1100,"Sub-basin 5"
3918,400,15,2100,2500,"Sub-basin 5"
3919,1400,110,8100,9500,"Sub-basin 5"
3920,100,2,1100,1200,"Sub-basin 5"
3921,100,1,1400,1500,"Sub-basin 5"
3922,800,34,3300,4100,"Sub-basin 5"
3923,20700,10041.34,45200,65900,"Sub-basin 5"
3924,1000,22.0075,13000,14000,"Sub-basin 5"
3925,100,3,300,400,"Sub-basin 5"
3926,600,25,1800,2400,"Sub-basin 5"
3927,100,2,1200,1300,"Sub-basin 5"
3928,100,2,1800,1900,"Sub-basin 5"
3929,2700,267.09,5800,8500,"Sub-basin 5"
3930,300,9,1800,2100,"Sub-basin 5"
3931,100,1,700,800,"Sub-basin 5"
3932,400,10,4200,4600,"Sub-basin 5"
3933,600,32,7700,8300,"Sub-basin 5"
3934,1400,83,5000,6400,"Sub-basin 5"
3935,400,49,4800,5200,"Sub-basin 5"
3936,100,2,2000,2100,"Sub-basin 5"
3937,100,1,1000,1100,"Sub-basin 5"
3938,600,30,1600,2200,"Sub-basin 5"
3939,10700,2963.66,25000,35700,"Sub-basin 5"
3940,100,1,2600,2700,"Sub-basin 5"
3941,200,3,1400,1600,"Sub-basin 5"
3942,500,21,2700,3200,"Sub-basin 5"
3943,600,103,2800,3400,"Sub-basin 5"
3944,100,2,1500,1600,"Sub-basin 5"
3945,100,1,700,800,"Sub-basin 5"
3946,200,6,3600,3800,"Sub-basin 5"
3947,3100,549,24100,27200,"Sub-basin 5"
3948,700,85,5300,6000,"Sub-basin 5"
3949,800,58,3800,4600,"Sub-basin 5"
3950,100,2,2000,2100,"Sub-basin 5"
3951,100,7,1500,1600,"Sub-basin 5"
3952,1100,186,4100,5200,"Sub-basin 5"
3953,100,2,1400,1500,"Sub-basin 5"
3954,200,2,2300,2500,"Sub-basin 5"
3955,800,39.17,1300,2100,"Sub-basin 5"
3956,2300,224.17,8500,10800,"Sub-basin 5"
3957,700,28.33,3600,4300,"Sub-basin 5"
3958,100,1,800,900,"Sub-basin 5"
3959,2200,156.17,12800,15000,"Sub-basin 5"
3960,300,12,1200,1500,"Sub-basin 5"
3961,600,39.98,4400,5000,"Sub-basin 5"
3962,1400,48,22000,23400,"Sub-basin 5"
3963,3900,341,26300,30200,"Sub-basin 5"
3964,3900,304.33,19100,23000,"Sub-basin 5"
3965,400,25,1700,2100,"Sub-basin 5"
3966,400,10,3300,3700,"Sub-basin 5"
3967,800,50.17,9400,10200,"Sub-basin 5"
3968,300,9.17,4100,4400,"Sub-basin 5"
3969,1200,53.47,6700,7900,"Sub-basin 5"
3970,500,35,2000,2500,"Sub-basin 5"
3971,500,74.35,1600,2100,"Sub-basin 5"
3972,1800,189,5300,7100,"Sub-basin 5"
3973,100,1,2500,2600,"Sub-basin 5"
3974,1200,89,5300,6500,"Sub-basin 5"
3975,1000,56,5800,6800,"Sub-basin 5"
3976,200,7,2100,2300,"Sub-basin 5"
3977,100,2.34,1400,1500,"Sub-basin 5"
3978,800,42.83,4500,5300,"Sub-basin 5"
3979,100,2,1800,1900,"Sub-basin 5"
3980,100,2,1000,1100,"Sub-basin 5"
3981,500,10,2900,3400,"Sub-basin 5"
3982,3000,369,18100,21100,"Sub-basin 5"
3983,2200,121,19100,21300,"Sub-basin 5"
3984,9700,3014,16600,26300,"Sub-basin 5"
3985,10000,4884,11600,21600,"Sub-basin 5"
3986,1100,66,11500,12600,"Sub-basin 5"
3987,100,1,700,800,"Sub-basin 5"
3988,200,5,3200,3400,"Sub-basin 5"
3989,600,22,6500,7100,"Sub-basin 5"
3990,300,16,3200,3500,"Sub-basin 5"
3991,800,130,2400,3200,"Sub-basin 5"
3992,5800,784.67,28100,33900,"Sub-basin 5"
3993,200,4,1300,1500,"Sub-basin 5"
3994,600,52,7300,7900,"Sub-basin 5"
3995,900,57,3900,4800,"Sub-basin 5"
3996,400,11,1600,2000,"Sub-basin 5"
3997,300,14,2600,2900,"Sub-basin 5"
3998,100,4,1400,1500,"Sub-basin 5"
3999,400,21,2800,3200,"Sub-basin 5"
4000,100,7,500,600,"Sub-basin 5"
4001,200,8,3000,3200,"Sub-basin 5"
4002,200,5,2000,2200,"Sub-basin 5"
4003,100,4,1600,1700,"Sub-basin 5"
4004,500,10,5000,5500,"Sub-basin 5"
4005,300,23,4400,4700,"Sub-basin 5"
4006,900,41,14500,15400,"Sub-basin 5"
4007,1700,70,20700,22400,"Sub-basin 5"
4008,400,39,3600,4000,"Sub-basin 5"
4009,5600,1589,16900,22500,"Sub-basin 5"
4010,500,28,4000,4500,"Sub-basin 5"
4011,2400,287,7600,10000,"Sub-basin 5"
4012,900,33,9900,10800,"Sub-basin 5"
4013,2400,337,5600,8000,"Sub-basin 5"
4014,300,9,2700,3000,"Sub-basin 5"
4015,100,2,1800,1900,"Sub-basin 5"
4016,600,68,2900,3500,"Sub-basin 5"
4017,900,95,5700,6600,"Sub-basin 5"
4018,1400,101,8000,9400,"Sub-basin 5"
4019,1300,93,6700,8000,"Sub-basin 5"
4020,200,4,3500,3700,"Sub-basin 5"
4021,1800,117,12500,14300,"Sub-basin 5"
4022,1100,44,5400,6500,"Sub-basin 5"
4023,3400,207,14300,17700,"Sub-basin 5"
4024,2000,361,7800,9800,"Sub-basin 5"
4025,2100,322,8200,10300,"Sub-basin 5"
4026,600,13,9900,10500,"Sub-basin 5"
4027,300,4,4800,5100,"Sub-basin 5"
4028,500,18,5800,6300,"Sub-basin 5"
4029,600,30,2900,3500,"Sub-basin 5"
4030,500,30,3500,4000,"Sub-basin 5"
4031,100,1,1900,2000,"Sub-basin 5"
4032,300,15,1000,1300,"Sub-basin 5"
4033,400,16,800,1200,"Sub-basin 5"
4034,100,3,1400,1500,"Sub-basin 5"
4035,100,1.0005,2100,2200,"Sub-basin 5"
4036,100,1,800,900,"Sub-basin 5"
4037,100,7,1600,1700,"Sub-basin 5"
4038,400,14,2100,2500,"Sub-basin 5"
4039,100,5,2400,2500,"Sub-basin 5"
4040,700,67,3900,4600,"Sub-basin 5"
4041,600,26,3600,4200,"Sub-basin 5"
4042,800,37,2900,3700,"Sub-basin 5"
4043,1800,201,7200,9000,"Sub-basin 5"
4044,200,3,3700,3900,"Sub-basin 5"
4045,100,1,2500,2600,"Sub-basin 5"
4046,500,25,2200,2700,"Sub-basin 5"
4047,700,20,3600,4300,"Sub-basin 5"
4048,100,2,2400,2500,"Sub-basin 5"
4049,100,1,1700,1800,"Sub-basin 5"
4050,4400,882,12300,16700,"Sub-basin 5"
4051,4400,1684,7200,11600,"Sub-basin 5"
4052,100,3,700,800,"Sub-basin 5"
4053,200,3.0008,2900,3100,"Sub-basin 5"
4054,900,97,4500,5400,"Sub-basin 5"
4055,100,1,1800,1900,"Sub-basin 5"
4056,500,14,5200,5700,"Sub-basin 5"
4057,100,2,1500,1600,"Sub-basin 5"
4058,200,35,1900,2100,"Sub-basin 5"
4059,100,1,1700,1800,"Sub-basin 5"
4060,200,6,1900,2100,"Sub-basin 5"
4061,600,11.002,9400,10000,"Sub-basin 5"
4062,100,6,500,600,"Sub-basin 5"
4063,100,1,1300,1400,"Sub-basin 5"
4064,400,8,6700,7100,"Sub-basin 5"
4065,100,1,1300,1400,"Sub-basin 5"
4066,400,20,2700,3100,"Sub-basin 5"
4067,100,2,300,400,"Sub-basin 5"
4068,5700,2537,14500,20200,"Sub-basin 5"
4069,500,18,4600,5100,"Sub-basin 5"
4070,600,46,4900,5500,"Sub-basin 5"
4071,100,1,1300,1400,"Sub-basin 5"
4072,300,4,3100,3400,"Sub-basin 5"
4073,900,37,4500,5400,"Sub-basin 5"
4074,400,13,4900,5300,"Sub-basin 5"
4075,2800,210,18800,21600,"Sub-basin 5"
4076,700,38,8300,9000,"Sub-basin 5"
4077,200,2,2500,2700,"Sub-basin 5"
4078,100,4,1800,1900,"Sub-basin 5"
4079,600,55.98,2800,3400,"Sub-basin 5"
4080,500,44,3000,3500,"Sub-basin 5"
4081,600,33,2700,3300,"Sub-basin 5"
4082,200,4,2400,2600,"Sub-basin 5"
4083,1200,117,4600,5800,"Sub-basin 5"
4084,800,71,3000,3800,"Sub-basin 5"
4085,1500,147,4800,6300,"Sub-basin 5"
4086,1000,109,5100,6100,"Sub-basin 5"
4087,400,20,5000,5400,"Sub-basin 5"
4088,700,22,7000,7700,"Sub-basin 5"
4089,1500,65,16500,18000,"Sub-basin 5"
4090,400,7,5400,5800,"Sub-basin 5"
4091,600,27,4600,5200,"Sub-basin 5"
4092,700,83,6400,7100,"Sub-basin 5"
4093,5500,2223,7900,13400,"Sub-basin 5"
4094,500,15,4100,4600,"Sub-basin 5"
4095,100,2.0003,1600,1700,"Sub-basin 5"
4096,4000,641,23500,27500,"Sub-basin 5"
4097,200,5,4600,4800,"Sub-basin 5"
4098,900,128,2700,3600,"Sub-basin 5"
4099,400,35,2700,3100,"Sub-basin 5"
4100,700,26,5600,6300,"Sub-basin 5"
4101,200,12,3500,3700,"Sub-basin 5"
4102,1000,71,3400,4400,"Sub-basin 5"
4103,200,60,0,200,"Sub-basin 5"
4104,500,25,2300,2800,"Sub-basin 5"
4105,2200,878,9800,12000,"Sub-basin 5"
4106,200,4,6000,6200,"Sub-basin 5"
4107,200,7,6000,6200,"Sub-basin 5"
4108,300,11,2600,2900,"Sub-basin 5"
4109,1000,61,5200,6200,"Sub-basin 5"
4110,400,37,3500,3900,"Sub-basin 5"
4111,1100,93,8900,10000,"Sub-basin 5"
4112,100,3,900,1000,"Sub-basin 5"
4113,100,3,1900,2000,"Sub-basin 5"
4114,200,11,2300,2500,"Sub-basin 5"
4115,700,20,7400,8100,"Sub-basin 5"
4116,200,2,1800,2000,"Sub-basin 5"
4117,13200,5360,23100,36300,"Sub-basin 5"
4118,600,44,2200,2800,"Sub-basin 5"
4119,200,2.0008,5100,5300,"Sub-basin 5"
4120,2800,183,11100,13900,"Sub-basin 5"
4121,500,38,2800,3300,"Sub-basin 5"
4122,100,5,1300,1400,"Sub-basin 5"
4123,600,22,6400,7000,"Sub-basin 5"
4124,1200,67,4200,5400,"Sub-basin 5"
4125,500,42,3200,3700,"Sub-basin 5"
4126,200,3,2300,2500,"Sub-basin 5"
4127,100,1,900,1000,"Sub-basin 5"
4128,200,10,2400,2600,"Sub-basin 5"
4129,1600,172,6000,7600,"Sub-basin 5"
4130,300,9,3300,3600,"Sub-basin 5"
4131,300,8,3800,4100,"Sub-basin 5"
4132,100,1,2700,2800,"Sub-basin 5"
4133,300,13,4500,4800,"Sub-basin 5"
4134,100,2,500,600,"Sub-basin 5"
4135,1100,63.83,13200,14300,"Sub-basin 5"
4136,100,5,1400,1500,"Sub-basin 5"
4137,100,1,1000,1100,"Sub-basin 5"
4138,200,5,2500,2700,"Sub-basin 5"
4139,1600,505,4400,6000,"Sub-basin 5"
4140,2500,1068,5400,7900,"Sub-basin 5"
4141,500,31,2100,2600,"Sub-basin 5"
4142,100,30,0,100,"Sub-basin 5"
4143,100,1,1400,1500,"Sub-basin 5"
4144,100,1,1900,2000,"Sub-basin 5"
4145,600,24,4500,5100,"Sub-basin 5"
4146,400,14,2600,3000,"Sub-basin 5"
4147,400,21,3300,3700,"Sub-basin 5"
4148,4700,496,24400,29100,"Sub-basin 5"
4149,100,1,3100,3200,"Sub-basin 5"
4150,100,1,1200,1300,"Sub-basin 5"
4151,1500,186,7000,8500,"Sub-basin 5"
4152,300,7,4500,4800,"Sub-basin 5"
4153,500,18,3400,3900,"Sub-basin 5"
4154,300,10,4200,4500,"Sub-basin 5"
4155,1500,146,5500,7000,"Sub-basin 5"
4156,5900,505,49200,55100,"Sub-basin 5"
4157,900,71,2800,3700,"Sub-basin 5"
4158,200,6,6800,7000,"Sub-basin 5"
4159,900,59,13200,14100,"Sub-basin 5"
4160,600,27,5100,5700,"Sub-basin 5"
4161,300,6,200,500,"Sub-basin 5"
4162,300,10,2900,3200,"Sub-basin 5"
4163,500,16,6600,7100,"Sub-basin 5"
4164,100,7,1300,1400,"Sub-basin 5"
4165,700,32,5800,6500,"Sub-basin 5"
4166,1800,276,2700,4500,"Sub-basin 5"
4167,500,51,3900,4400,"Sub-basin 5"
4168,1000,35,4000,5000,"Sub-basin 5"
4169,300,158,2300,2600,"Sub-basin 5"
4170,300,11,2800,3100,"Sub-basin 5"
4171,400,25,3700,4100,"Sub-basin 5"
4172,100,2,1500,1600,"Sub-basin 5"
4173,100,1,700,800,"Sub-basin 5"
4174,100,2,2700,2800,"Sub-basin 5"
4175,100,2,1200,1300,"Sub-basin 5"
4176,4500,1464,12000,16500,"Sub-basin 5"
4177,19100,8884,24400,43500,"Sub-basin 5"
4178,700,52,6100,6800,"Sub-basin 5"
4179,500,57,2200,2700,"Sub-basin 5"
4180,300,16,3800,4100,"Sub-basin 5"
4181,200,4,1700,1900,"Sub-basin 5"
4182,400,5,4800,5200,"Sub-basin 5"
4183,100,1,1600,1700,"Sub-basin 5"
4184,300,11,3800,4100,"Sub-basin 5"
4185,500,11,2400,2900,"Sub-basin 5"
4186,1100,122,4500,5600,"Sub-basin 5"
4187,100,2,1500,1600,"Sub-basin 5"
4188,34800,16436,65800,100600,"Sub-basin 5"
4189,200,8,3000,3200,"Sub-basin 5"
4190,300,5,2800,3100,"Sub-basin 5"
4191,100,1,600,700,"Sub-basin 5"
4192,400,14,6800,7200,"Sub-basin 5"
4193,500,21,6100,6600,"Sub-basin 5"
4194,100,1.0005,2400,2500,"Sub-basin 5"
4195,600,23,6400,7000,"Sub-basin 5"
4196,200,12,800,1000,"Sub-basin 5"
4197,400,10,5200,5600,"Sub-basin 5"
4198,100,1,2100,2200,"Sub-basin 5"
4199,200,4,3600,3800,"Sub-basin 5"
4200,300,4,4800,5100,"Sub-basin 5"
4201,1000,34,10000,11000,"Sub-basin 5"
4202,700,48,4000,4700,"Sub-basin 5"
4203,200,4,1900,2100,"Sub-basin 5"
4204,6900,2885,6300,13200,"Sub-basin 5"
4205,3800,396,14200,18000,"Sub-basin 5"
4206,5900,526,33700,39600,"Sub-basin 5"
4207,400,16,2500,2900,"Sub-basin 5"
4208,600,30,4200,4800,"Sub-basin 5"
4209,500,24,4500,5000,"Sub-basin 5"
4210,300,10,3300,3600,"Sub-basin 5"
4211,200,3,1500,1700,"Sub-basin 5"
4212,500,18,9900,10400,"Sub-basin 5"
4213,200,8,800,1000,"Sub-basin 5"
4214,900,55,4400,5300,"Sub-basin 5"
4215,200,7.002,4200,4400,"Sub-basin 5"
4216,100,1.0004,2800,2900,"Sub-basin 5"
4217,200,7.0012,2300,2500,"Sub-basin 5"
4218,400,19.0024,8800,9200,"Sub-basin 5"
4219,800,41,6400,7200,"Sub-basin 5"
4220,1700,114,10000,11700,"Sub-basin 5"
4221,500,19,5900,6400,"Sub-basin 5"
4222,400,8,5000,5400,"Sub-basin 5"
4223,400,13,4200,4600,"Sub-basin 5"
4224,200,8,1300,1500,"Sub-basin 5"
4225,200,5,1000,1200,"Sub-basin 5"
4226,100,6.0004,2100,2200,"Sub-basin 5"
4227,200,4,4300,4500,"Sub-basin 5"
4228,300,14,4200,4500,"Sub-basin 5"
4229,200,4,1800,2000,"Sub-basin 5"
4230,100,3,1200,1300,"Sub-basin 5"
4231,500,21,3800,4300,"Sub-basin 5"
4232,1500,98,9000,10500,"Sub-basin 5"
4233,100,1,2600,2700,"Sub-basin 5"
4234,200,6,5500,5700,"Sub-basin 5"
4235,1700,142,13800,15500,"Sub-basin 5"
4236,100,5,1000,1100,"Sub-basin 5"
4237,4900,2866,8600,13500,"Sub-basin 5"
4238,100,1,900,1000,"Sub-basin 5"
4239,10000,4358,24500,34500,"Sub-basin 5"
4240,200,4,1000,1200,"Sub-basin 5"
4241,300,6,1500,1800,"Sub-basin 5"
4242,400,43,2500,2900,"Sub-basin 5"
4243,2200,131.0331,44500,46700,"Sub-basin 5"
4244,100,5,3000,3100,"Sub-basin 5"
4245,1300,98,12800,14100,"Sub-basin 5"
4246,100,1,1600,1700,"Sub-basin 5"
4247,100,3,1100,1200,"Sub-basin 5"
4248,100,3,2100,2200,"Sub-basin 5"
4249,200,7,1800,2000,"Sub-basin 5"
4250,400,21,5200,5600,"Sub-basin 5"
4251,100,2.0005,3200,3300,"Sub-basin 5"
4252,300,8,5800,6100,"Sub-basin 5"
4253,700,26.0031,10700,11400,"Sub-basin 5"
4254,200,2,1900,2100,"Sub-basin 5"
4255,1900,181,9700,11600,"Sub-basin 5"
4256,1300,76,9100,10400,"Sub-basin 5"
4257,200,7,2500,2700,"Sub-basin 5"
4258,100,3,2200,2300,"Sub-basin 5"
4259,600,56,4400,5000,"Sub-basin 5"
4260,700,47,3800,4500,"Sub-basin 5"
4261,100,7,1700,1800,"Sub-basin 5"
4262,200,9,4100,4300,"Sub-basin 5"
4263,200,5,3500,3700,"Sub-basin 5"
4264,400,34,8000,8400,"Sub-basin 5"
4265,500,13,3600,4100,"Sub-basin 5"
4266,700,22,6700,7400,"Sub-basin 5"
4267,400,27,1600,2000,"Sub-basin 5"
4268,100,4,1200,1300,"Sub-basin 5"
4269,300,8,4500,4800,"Sub-basin 5"
4270,100,2,1400,1500,"Sub-basin 5"
4271,3200,326,27400,30600,"Sub-basin 5"
4272,400,20,1200,1600,"Sub-basin 5"
4273,300,10,4300,4600,"Sub-basin 5"
4274,800,48,9400,10200,"Sub-basin 5"
4275,100,1.0005,3900,4000,"Sub-basin 5"
4276,400,26,2000,2400,"Sub-basin 5"
4277,100,1,2600,2700,"Sub-basin 5"
4278,1200,220,5900,7100,"Sub-basin 5"
4279,200,2,1600,1800,"Sub-basin 5"
4280,100,3,2800,2900,"Sub-basin 5"
4281,300,9,4600,4900,"Sub-basin 5"
4282,100,2,600,700,"Sub-basin 5"
4283,100,2,1000,1100,"Sub-basin 5"
4284,200,4,2900,3100,"Sub-basin 5"
4285,100,1,2200,2300,"Sub-basin 5"
4286,100,4,2800,2900,"Sub-basin 5"
4287,3100,747,4300,7400,"Sub-basin 5"
4288,100,1,600,700,"Sub-basin 5"
4289,4300,664,22600,26900,"Sub-basin 5"
4290,2300,214,9300,11600,"Sub-basin 5"
4291,200,7,2600,2800,"Sub-basin 5"
4292,600,18.0031,11600,12200,"Sub-basin 5"
4293,400,16,3300,3700,"Sub-basin 5"
4294,100,1,1300,1400,"Sub-basin 5"
4295,900,32,10600,11500,"Sub-basin 5"
4296,200,2,4200,4400,"Sub-basin 5"
4297,100,3,1500,1600,"Sub-basin 5"
4298,200,2,3000,3200,"Sub-basin 5"
4299,700,65,3000,3700,"Sub-basin 5"
4300,1200,115,3200,4400,"Sub-basin 5"
4301,600,54,1600,2200,"Sub-basin 5"
4302,600,42,3400,4000,"Sub-basin 5"
4303,500,13,9700,10200,"Sub-basin 5"
4304,300,3,6300,6600,"Sub-basin 5"
4305,100,3,2000,2100,"Sub-basin 5"
4306,200,8,1000,1200,"Sub-basin 5"
4307,100,1,1500,1600,"Sub-basin 5"
4308,700,84,2100,2800,"Sub-basin 5"
4309,100,3,2900,3000,"Sub-basin 5"
4310,300,23,4500,4800,"Sub-basin 5"
4311,200,19,2800,3000,"Sub-basin 5"
4312,100,1,1400,1500,"Sub-basin 5"
4313,700,74,3200,3900,"Sub-basin 5"
4314,1300,126,2500,3800,"Sub-basin 5"
4315,1600,65,11800,13400,"Sub-basin 5"
4316,900,79,3300,4200,"Sub-basin 5"
4317,100,1,2700,2800,"Sub-basin 5"
4318,100,3.0003,1700,1800,"Sub-basin 5"
4319,100,1,1400,1500,"Sub-basin 5"
4320,200,4,2400,2600,"Sub-basin 5"
4321,700,35,6600,7300,"Sub-basin 5"
4322,200,5,1600,1800,"Sub-basin 5"
4323,400,25.5,6600,7000,"Sub-basin 5"
4324,100,1,1400,1500,"Sub-basin 5"
4325,4700,392,32400,37100,"Sub-basin 5"
4326,1200,76,6300,7500,"Sub-basin 5"
4327,100,2,700,800,"Sub-basin 5"
4328,4100,1616,3500,7600,"Sub-basin 5"
4329,100,4,2600,2700,"Sub-basin 5"
4330,300,4,7100,7400,"Sub-basin 5"
4331,3200,879,19800,23000,"Sub-basin 5"
4332,1100,43,6600,7700,"Sub-basin 5"
4333,1000,88,7500,8500,"Sub-basin 5"
4334,2300,269,10800,13100,"Sub-basin 5"
4335,500,22,2900,3400,"Sub-basin 5"
4336,2100,82,16500,18600,"Sub-basin 5"
4337,500,11,5000,5500,"Sub-basin 5"
4338,700,32,7600,8300,"Sub-basin 5"
4339,100,4,2300,2400,"Sub-basin 5"
4340,300,9,5300,5600,"Sub-basin 5"
4341,800,16,1500,2300,"Sub-basin 5"
4342,1100,133,2700,3800,"Sub-basin 5"
4343,400,17,4200,4600,"Sub-basin 5"
4344,100,1,1700,1800,"Sub-basin 5"
4345,100,3,2000,2100,"Sub-basin 5"
4346,100,1.0003,1700,1800,"Sub-basin 5"
4347,200,6,2600,2800,"Sub-basin 5"
4348,100,1,1400,1500,"Sub-basin 5"
4349,900,51,7600,8500,"Sub-basin 5"
4350,100,1,1300,1400,"Sub-basin 5"
4351,100,4,2400,2500,"Sub-basin 5"
4352,200,2,3200,3400,"Sub-basin 5"
4353,1000,29,10200,11200,"Sub-basin 5"
4354,2000,78,31400,33400,"Sub-basin 5"
4355,500,45,8000,8500,"Sub-basin 5"
4356,200,4,3000,3200,"Sub-basin 5"
4357,400,13,5400,5800,"Sub-basin 5"
4358,500,199,7500,8000,"Sub-basin 5"
4359,100,1,800,900,"Sub-basin 5"
4360,700,30,4400,5100,"Sub-basin 5"
4361,100,1,500,600,"Sub-basin 5"
4362,1500,83,16700,18200,"Sub-basin 5"
4363,400,30,2700,3100,"Sub-basin 5"
4364,600,24,4800,5400,"Sub-basin 5"
4365,13800,4500,16700,30500,"Sub-basin 5"
4366,600,31,5400,6000,"Sub-basin 5"
4367,100,3.0004,2300,2400,"Sub-basin 5"
4368,1400,108,10700,12100,"Sub-basin 5"
4369,100,8,1800,1900,"Sub-basin 5"
4370,200,4,2300,2500,"Sub-basin 5"
4371,200,9,2200,2400,"Sub-basin 5"
4372,1800,88,29900,31700,"Sub-basin 5"
4373,300,25,3900,4200,"Sub-basin 5"
4374,400,17,3000,3400,"Sub-basin 5"
4375,100,1,1000,1100,"Sub-basin 5"
4376,1900,141,3700,5600,"Sub-basin 5"
4377,400,19,4600,5000,"Sub-basin 5"
4378,200,6,7500,7700,"Sub-basin 5"
4379,700,23,10900,11600,"Sub-basin 5"
4380,400,7,7100,7500,"Sub-basin 5"
4381,100,2.0004,3000,3100,"Sub-basin 5"
4382,100,2,1400,1500,"Sub-basin 5"
4383,200,14,1900,2100,"Sub-basin 5"
4384,800,22,6800,7600,"Sub-basin 5"
4385,600,51,3300,3900,"Sub-basin 5"
4386,400,42,2900,3300,"Sub-basin 5"
4387,2000,136,10700,12700,"Sub-basin 5"
4388,200,6,1900,2100,"Sub-basin 5"
4389,100,2,2500,2600,"Sub-basin 5"
4390,100,1,1500,1600,"Sub-basin 5"
4391,1000,85,1700,2700,"Sub-basin 5"
4392,1300,137,4500,5800,"Sub-basin 5"
4393,100,1.0006,1000,1100,"Sub-basin 5"
4394,3000,237,14600,17600,"Sub-basin 5"
4395,300,8,4100,4400,"Sub-basin 5"
4396,200,7,2100,2300,"Sub-basin 5"
4397,500,24,2900,3400,"Sub-basin 5"
4398,4200,882,7300,11500,"Sub-basin 5"
4399,1200,55.0068,21200,22400,"Sub-basin 5"
4400,100,3,2600,2700,"Sub-basin 5"
4401,100,5.0005,1900,2000,"Sub-basin 5"
4402,100,1,1500,1600,"Sub-basin 5"
4403,900,24,10200,11100,"Sub-basin 5"
4404,700,30,4000,4700,"Sub-basin 5"
4405,100,1,1600,1700,"Sub-basin 5"
4406,600,29,4800,5400,"Sub-basin 5"
4407,200,14,5000,5200,"Sub-basin 5"
4408,100,1,3300,3400,"Sub-basin 5"
4409,200,4,3900,4100,"Sub-basin 5"
4410,300,6,4200,4500,"Sub-basin 5"
4411,600,20,5100,5700,"Sub-basin 5"
4412,100,1,1100,1200,"Sub-basin 5"
4413,400,29,5300,5700,"Sub-basin 5"
4414,300,7,1100,1400,"Sub-basin 5"
4415,100,4,1500,1600,"Sub-basin 5"
4416,1100,26,12200,13300,"Sub-basin 5"
4417,200,3,3900,4100,"Sub-basin 5"
4418,400,7,3600,4000,"Sub-basin 5"
4419,600,39,2900,3500,"Sub-basin 5"
4420,600,35,4100,4700,"Sub-basin 5"
4421,1600,108,6600,8200,"Sub-basin 5"
4422,200,5,2800,3000,"Sub-basin 5"
4423,200,3,800,1000,"Sub-basin 5"
4424,1100,84,5600,6700,"Sub-basin 5"
4425,100,3,1300,1400,"Sub-basin 5"
4426,1600,175,15500,17100,"Sub-basin 5"
4427,200,33,4600,4800,"Sub-basin 5"
4428,100,3.0004,2900,3000,"Sub-basin 5"
4429,300,14,5100,5400,"Sub-basin 5"
4430,300,17,3200,3500,"Sub-basin 5"
4431,300,8,7200,7500,"Sub-basin 5"
4432,200,8,5400,5600,"Sub-basin 5"
4433,300,14,2600,2900,"Sub-basin 5"
4434,400,19,5600,6000,"Sub-basin 5"
4435,100,2,1800,1900,"Sub-basin 5"
4436,100,1,2200,2300,"Sub-basin 5"
4437,800,24,10000,10800,"Sub-basin 5"
4438,3300,691,7800,11100,"Sub-basin 5"
4439,400,16,3100,3500,"Sub-basin 5"
4440,1200,151,5800,7000,"Sub-basin 5"
4441,200,4,1000,1200,"Sub-basin 5"
4442,500,57,1500,2000,"Sub-basin 5"
4443,100,1,1900,2000,"Sub-basin 5"
4444,500,18,4200,4700,"Sub-basin 5"
4445,700,36,4200,4900,"Sub-basin 5"
4446,100,2.0004,1800,1900,"Sub-basin 5"
4447,200,4.0008,1900,2100,"Sub-basin 5"
4448,100,77,2400,2500,"Sub-basin 5"
4449,100,4,2100,2200,"Sub-basin 5"
4450,500,31,3400,3900,"Sub-basin 5"
4451,100,3,2200,2300,"Sub-basin 5"
4452,100,1,1300,1400,"Sub-basin 5"
4453,100,2,500,600,"Sub-basin 5"
4454,500,13,10600,11100,"Sub-basin 5"
4455,100,3,2200,2300,"Sub-basin 5"
4456,1100,145,9900,11000,"Sub-basin 5"
4457,100,1,2100,2200,"Sub-basin 5"
4458,1100,187,6400,7500,"Sub-basin 5"
4459,500,25,4200,4700,"Sub-basin 5"
4460,1000,111,5100,6100,"Sub-basin 5"
4461,500,18,6800,7300,"Sub-basin 5"
4462,4800,144,39600,44400,"Sub-basin 5"
4463,600,32,5300,5900,"Sub-basin 5"
4464,1800,193,9900,11700,"Sub-basin 5"
4465,200,3,3000,3200,"Sub-basin 5"
4466,1900,68,19700,21600,"Sub-basin 5"
4467,200,3,4800,5000,"Sub-basin 5"
4468,300,4,4100,4400,"Sub-basin 5"
4469,100,1,700,800,"Sub-basin 5"
4470,200,4,3400,3600,"Sub-basin 5"
4471,200,2,2400,2600,"Sub-basin 5"
4472,100,1,1900,2000,"Sub-basin 5"
4473,200,3,3100,3300,"Sub-basin 5"
4474,500,53,5700,6200,"Sub-basin 5"
4475,100,2,1100,1200,"Sub-basin 5"
4476,200,5,3600,3800,"Sub-basin 5"
4477,200,5,2600,2800,"Sub-basin 5"
4478,600,19.0048,8100,8700,"Sub-basin 5"
4479,3800,326,25300,29100,"Sub-basin 5"
4480,100,6,1100,1200,"Sub-basin 5"
4481,5300,2055,10400,15700,"Sub-basin 5"
4482,63600,20439.83,145400,209000,"Sub-basin 5"
4483,1000,31,8700,9700,"Sub-basin 5"
4484,400,25,5200,5600,"Sub-basin 5"
4485,100,2,2600,2700,"Sub-basin 5"
4486,3500,260,35800,39300,"Sub-basin 5"
4487,100,1,800,900,"Sub-basin 5"
4488,300,5,3000,3300,"Sub-basin 5"
4489,3400,619,20800,24200,"Sub-basin 5"
4490,500,16,2000,2500,"Sub-basin 5"
4491,1100,108,3800,4900,"Sub-basin 5"
4492,4600,179,24600,29200,"Sub-basin 5"
4493,100,1,2300,2400,"Sub-basin 5"
4494,400,7,5500,5900,"Sub-basin 5"
4495,100,1,2100,2200,"Sub-basin 5"
4496,100,2,1600,1700,"Sub-basin 5"
4497,400,18.17,2900,3300,"Sub-basin 5"
4498,300,53,3800,4100,"Sub-basin 5"
4499,400,15,6100,6500,"Sub-basin 5"
4500,100,1,1800,1900,"Sub-basin 5"
4501,200,3,1800,2000,"Sub-basin 5"
4502,100,2,700,800,"Sub-basin 5"
4503,1800,380,5200,7000,"Sub-basin 5"
4504,100,3,1000,1100,"Sub-basin 5"
4505,200,4,3400,3600,"Sub-basin 5"
4506,900,99,3600,4500,"Sub-basin 5"
4507,2000,288,17700,19700,"Sub-basin 5"
4508,500,31,6100,6600,"Sub-basin 5"
4509,100,3,600,700,"Sub-basin 5"
4510,1800,132,11800,13600,"Sub-basin 5"
4511,1600,104,9700,11300,"Sub-basin 5"
4512,100,3,1800,1900,"Sub-basin 5"
4513,300,7,5200,5500,"Sub-basin 5"
4514,100,1,2100,2200,"Sub-basin 5"
4515,600,40,5500,6100,"Sub-basin 5"
4516,100,1,900,1000,"Sub-basin 5"
4517,1000,90,1700,2700,"Sub-basin 5"
4518,300,19,2300,2600,"Sub-basin 5"
4519,200,3,1800,2000,"Sub-basin 5"
4520,300,8,4700,5000,"Sub-basin 5"
4521,600,25.0032,11000,11600,"Sub-basin 5"
4522,6600,619,56200,62800,"Sub-basin 5"
4523,100,2,1200,1300,"Sub-basin 5"
4524,800,165,2000,2800,"Sub-basin 5"
4525,100,3,1900,2000,"Sub-basin 5"
4526,100,1,2000,2100,"Sub-basin 5"
4527,100,1,1700,1800,"Sub-basin 5"
4528,400,23,3700,4100,"Sub-basin 5"
4529,600,13,4100,4700,"Sub-basin 5"
4530,700,28,10000,10700,"Sub-basin 5"
4531,4100,2170,25700,29800,"Sub-basin 5"
4532,100,3,2600,2700,"Sub-basin 5"
4533,1800,1152.318,5800,7600,"Sub-basin 5"
4534,800,55,8500,9300,"Sub-basin 5"
4535,1600,71,6600,8200,"Sub-basin 5"
4536,100,4,1500,1600,"Sub-basin 5"
4537,200,5.0009,4500,4700,"Sub-basin 5"
4538,100,1.0009,2000,2100,"Sub-basin 5"
4539,200,6.0022,5100,5300,"Sub-basin 5"
4540,200,4.0036,2800,3000,"Sub-basin 5"
4541,1200,106,4700,5900,"Sub-basin 5"
4542,400,8,3200,3600,"Sub-basin 5"
4543,400,18,2600,3000,"Sub-basin 5"
4544,300,6,6200,6500,"Sub-basin 5"
4545,1400,222,13300,14700,"Sub-basin 5"
4546,100,3,1100,1200,"Sub-basin 5"
4547,200,8,5100,5300,"Sub-basin 5"
4548,800,49,7700,8500,"Sub-basin 5"
4549,900,45,10700,11600,"Sub-basin 5"
4550,100,1,1900,2000,"Sub-basin 5"
4551,200,14,1800,2000,"Sub-basin 5"
4552,100,2,1500,1600,"Sub-basin 5"
4553,100,4,1700,1800,"Sub-basin 5"
4554,100,2,1800,1900,"Sub-basin 5"
4555,1900,78.0279,18700,20600,"Sub-basin 5"
4556,100,2.0002,2100,2200,"Sub-basin 5"
4557,300,38,1400,1700,"Sub-basin 5"
4558,23900,13533,27100,51000,"Sub-basin 5"
4559,6700,2078,10900,17600,"Sub-basin 5"
4560,100,1,700,800,"Sub-basin 5"
4561,100,4,1300,1400,"Sub-basin 5"
4562,100,1,3800,3900,"Sub-basin 5"
4563,400,18,5500,5900,"Sub-basin 5"
4564,100,1,1400,1500,"Sub-basin 5"
4565,800,53,9500,10300,"Sub-basin 5"
4566,200,11,2200,2400,"Sub-basin 5"
4567,200,6,1300,1500,"Sub-basin 5"
4568,100,2,2300,2400,"Sub-basin 5"
4569,200,11,4200,4400,"Sub-basin 5"
4570,200,4,1400,1600,"Sub-basin 5"
4571,200,11,2500,2700,"Sub-basin 5"
4572,300,15,5200,5500,"Sub-basin 5"
4573,500,56,11700,12200,"Sub-basin 5"
4574,400,9,4100,4500,"Sub-basin 5"
4575,1500,105,10000,11500,"Sub-basin 5"
4576,100,1,2500,2600,"Sub-basin 5"
4577,700,27,5700,6400,"Sub-basin 5"
4578,200,5,4200,4400,"Sub-basin 5"
4579,400,8,5500,5900,"Sub-basin 5"
4580,100,1,900,1000,"Sub-basin 5"
4581,1400,33.0128,19000,20400,"Sub-basin 5"
4582,700,46,2700,3400,"Sub-basin 5"
4583,1100,40,19700,20800,"Sub-basin 5"
4584,1200,58,13000,14200,"Sub-basin 5"
4585,400,20,3500,3900,"Sub-basin 5"
4586,100,7,1300,1400,"Sub-basin 5"
4587,200,6,2800,3000,"Sub-basin 5"
4588,500,34,2100,2600,"Sub-basin 5"
4589,200,7,1400,1600,"Sub-basin 5"
4590,100,2,1800,1900,"Sub-basin 5"
4591,100,3,2000,2100,"Sub-basin 5"
4592,100,1,3000,3100,"Sub-basin 5"
4593,200,2,4300,4500,"Sub-basin 5"
4594,600,76,2000,2600,"Sub-basin 5"
4595,3600,256,27700,31300,"Sub-basin 5"
4596,100,1,700,800,"Sub-basin 5"
4597,300,12,4200,4500,"Sub-basin 5"
4598,500,13,3700,4200,"Sub-basin 5"
4599,400,7,1000,1400,"Sub-basin 5"
4600,300,13,2100,2400,"Sub-basin 5"
4601,400,53,3900,4300,"Sub-basin 5"
4602,200,4,2300,2500,"Sub-basin 5"
4603,300,14,1100,1400,"Sub-basin 5"
4604,100,1,2000,2100,"Sub-basin 5"
4605,1300,210,8600,9900,"Sub-basin 5"
4606,100,5,1500,1600,"Sub-basin 5"
4607,700,72,5900,6600,"Sub-basin 5"
4608,100,1,1400,1500,"Sub-basin 5"
4609,100,1,1700,1800,"Sub-basin 5"
4610,100,4,2200,2300,"Sub-basin 5"
4611,100,3,1400,1500,"Sub-basin 5"
4612,37500,9166,63800,101300,"Sub-basin 5"
4613,800,45,5100,5900,"Sub-basin 5"
4614,500,35,2700,3200,"Sub-basin 5"
4615,600,22,6400,7000,"Sub-basin 5"
4616,100,2,2200,2300,"Sub-basin 5"
4617,200,12,4200,4400,"Sub-basin 5"
4618,500,31,5200,5700,"Sub-basin 5"
4619,600,20,8300,8900,"Sub-basin 5"
4620,700,15,6600,7300,"Sub-basin 5"
4621,300,35,3300,3600,"Sub-basin 5"
4622,9700,3464,23200,32900,"Sub-basin 5"
4623,100,1,1900,2000,"Sub-basin 5"
4624,100,1,900,1000,"Sub-basin 5"
4625,300,8,1200,1500,"Sub-basin 5"
4626,100,1,1700,1800,"Sub-basin 5"
4627,1200,42,14200,15400,"Sub-basin 5"
4628,600,9.0023,9400,10000,"Sub-basin 5"
4629,300,18,2500,2800,"Sub-basin 5"
4630,200,4,1300,1500,"Sub-basin 5"
4631,100,1,1500,1600,"Sub-basin 5"
4632,4600,1162,9800,14400,"Sub-basin 5"
4633,100,4,1800,1900,"Sub-basin 5"
4634,100,1,1100,1200,"Sub-basin 5"
4635,500,40,2800,3300,"Sub-basin 5"
4636,200,5,2000,2200,"Sub-basin 5"
4637,100,3,2000,2100,"Sub-basin 5"
4638,1800,164,20700,22500,"Sub-basin 5"
4639,700,12,6600,7300,"Sub-basin 5"
4640,2400,636,4300,6700,"Sub-basin 5"
4641,5300,549,25600,30900,"Sub-basin 5"
4642,300,8,5700,6000,"Sub-basin 5"
4643,100,2,1300,1400,"Sub-basin 5"
4644,400,15,2900,3300,"Sub-basin 5"
4645,4500,2029,17000,21500,"Sub-basin 5"
4646,700,46,5800,6500,"Sub-basin 5"
4647,200,6.0065,2500,2700,"Sub-basin 5"
4648,100,1,2100,2200,"Sub-basin 5"
4649,100,3,1100,1200,"Sub-basin 5"
4650,600,71,4300,4900,"Sub-basin 5"
4651,400,17,3100,3500,"Sub-basin 5"
4652,1200,555,3700,4900,"Sub-basin 5"
4653,400,16,3100,3500,"Sub-basin 5"
4654,1200,30.0026,15300,16500,"Sub-basin 5"
4655,300,4,4500,4800,"Sub-basin 5"
4656,100,2,1400,1500,"Sub-basin 5"
4657,100,1,1100,1200,"Sub-basin 5"
4658,1100,181,3200,4300,"Sub-basin 5"
4659,100,1,600,700,"Sub-basin 5"
4660,100,1,1300,1400,"Sub-basin 5"
4661,700,41,6900,7600,"Sub-basin 5"
4662,100,2,1400,1500,"Sub-basin 5"
4663,100,2,1700,1800,"Sub-basin 5"
4664,600,25,9000,9600,"Sub-basin 5"
4665,100,1,1300,1400,"Sub-basin 5"
4666,200,2,3200,3400,"Sub-basin 5"
4667,500,40,2600,3100,"Sub-basin 5"
4668,100,2,2300,2400,"Sub-basin 5"
4669,300,15,3500,3800,"Sub-basin 5"
4670,400,14,6100,6500,"Sub-basin 5"
4671,100,4,1700,1800,"Sub-basin 5"
4672,200,2,1100,1300,"Sub-basin 5"
4673,2400,61.0293,28800,31200,"Sub-basin 5"
4674,100,3,1700,1800,"Sub-basin 5"
4675,100,4.0008,2100,2200,"Sub-basin 5"
4676,100,1,1600,1700,"Sub-basin 5"
4677,100,2,1000,1100,"Sub-basin 5"
4678,100,2,800,900,"Sub-basin 5"
4679,100,3,1300,1400,"Sub-basin 5"
4680,2900,521.84,14300,17200,"Sub-basin 5"
4681,1700,226,11000,12700,"Sub-basin 5"
4682,5400,1508,15400,20800,"Sub-basin 5"
4683,500,10,10600,11100,"Sub-basin 5"
4684,700,31,13000,13700,"Sub-basin 5"
4685,100,1,1500,1600,"Sub-basin 5"
4686,100,7,1000,1100,"Sub-basin 5"
4687,2100,116,16900,19000,"Sub-basin 5"
4688,200,4,1100,1300,"Sub-basin 5"
4689,100,1.0004,1600,1700,"Sub-basin 5"
4690,100,1.0005,2800,2900,"Sub-basin 5"
4691,500,29,4100,4600,"Sub-basin 5"
4692,7600,1829,10000,17600,"Sub-basin 5"
4693,700,48,8400,9100,"Sub-basin 5"
4694,2900,282,14000,16900,"Sub-basin 5"
4695,200,10,1900,2100,"Sub-basin 5"
4696,4700,839,13800,18500,"Sub-basin 5"
4697,1900,930,6400,8300,"Sub-basin 5"
4698,100,1,1100,1200,"Sub-basin 5"
4699,1000,77,14200,15200,"Sub-basin 5"
4700,200,5,3800,4000,"Sub-basin 5"
4701,200,6,3700,3900,"Sub-basin 5"
4702,100,3,1200,1300,"Sub-basin 5"
4703,100,2,400,500,"Sub-basin 5"
4704,200,5,1300,1500,"Sub-basin 5"
4705,100,2,1900,2000,"Sub-basin 5"
4706,200,5,3400,3600,"Sub-basin 5"
4707,2000,60,20400,22400,"Sub-basin 5"
4708,200,5,600,800,"Sub-basin 5"
4709,200,8,1700,1900,"Sub-basin 5"
4710,1400,97,7000,8400,"Sub-basin 5"
4711,700,53,5000,5700,"Sub-basin 5"
4712,100,2,1500,1600,"Sub-basin 5"
4713,900,77,10800,11700,"Sub-basin 5"
4714,100,1,400,500,"Sub-basin 5"
4715,1100,48,15400,16500,"Sub-basin 5"
4716,700,34,4100,4800,"Sub-basin 5"
4717,2100,96,16900,19000,"Sub-basin 5"
4718,1500,140,11200,12700,"Sub-basin 5"
4719,100,1,300,400,"Sub-basin 5"
4720,100,3.0003,2900,3000,"Sub-basin 5"
4721,100,7,1600,1700,"Sub-basin 5"
4722,500,34,6500,7000,"Sub-basin 5"
4723,200,14,4200,4400,"Sub-basin 5"
4724,100,1,900,1000,"Sub-basin 5"
4725,3400,693,6400,9800,"Sub-basin 5"
4726,200,4,2800,3000,"Sub-basin 5"
4727,200,5,3300,3500,"Sub-basin 5"
4728,100,1,2500,2600,"Sub-basin 5"
4729,800,39,4600,5400,"Sub-basin 5"
4730,500,39,2500,3000,"Sub-basin 5"
4731,500,14,2900,3400,"Sub-basin 5"
4732,1300,127,7200,8500,"Sub-basin 5"
4733,14700,5565,21600,36300,"Sub-basin 5"
4734,100,3,2000,2100,"Sub-basin 5"
4735,100,1,1200,1300,"Sub-basin 5"
4736,1100,53,6900,8000,"Sub-basin 5"
4737,100,2,800,900,"Sub-basin 5"
4738,700,16.006,3900,4600,"Sub-basin 5"
4739,100,1,1500,1600,"Sub-basin 5"
4740,100,3,2900,3000,"Sub-basin 5"
4741,100,4,1900,2000,"Sub-basin 5"
4742,300,13,3300,3600,"Sub-basin 5"
4743,100,1,700,800,"Sub-basin 5"
4744,100,2,800,900,"Sub-basin 5"
4745,400,22,2900,3300,"Sub-basin 5"
4746,100,1,2200,2300,"Sub-basin 5"
4747,500,18,7100,7600,"Sub-basin 5"
4748,200,8,900,1100,"Sub-basin 5"
4749,100,1,2100,2200,"Sub-basin 5"
4750,100,1,2700,2800,"Sub-basin 5"
4751,900,227,2200,3100,"Sub-basin 5"
4752,300,6,2400,2700,"Sub-basin 5"
4753,300,20,4200,4500,"Sub-basin 5"
4754,100,1,1100,1200,"Sub-basin 5"
4755,100,2,700,800,"Sub-basin 5"
4756,100,2,1400,1500,"Sub-basin 5"
4757,300,20,3600,3900,"Sub-basin 5"
4758,4800,859,14800,19600,"Sub-basin 5"
4759,400,16,1800,2200,"Sub-basin 5"
4760,700,24,5000,5700,"Sub-basin 5"
4761,300,22,1400,1700,"Sub-basin 5"
4762,400,35,4000,4400,"Sub-basin 5"
4763,100,3,2700,2800,"Sub-basin 5"
4764,700,67,5100,5800,"Sub-basin 5"
4765,500,53,6900,7400,"Sub-basin 5"
4766,100,2,1500,1600,"Sub-basin 5"
4767,300,7,2500,2800,"Sub-basin 5"
4768,900,100,3700,4600,"Sub-basin 5"
4769,1500,174,5600,7100,"Sub-basin 5"
4770,700,25.0023,7700,8400,"Sub-basin 5"
4771,100,1,1300,1400,"Sub-basin 5"
4772,300,6,1300,1600,"Sub-basin 5"
4773,700,36,7000,7700,"Sub-basin 5"
4774,600,26,6200,6800,"Sub-basin 5"
4775,1400,340,9600,11000,"Sub-basin 5"
4776,1100,125,6100,7200,"Sub-basin 5"
4777,500,31,2200,2700,"Sub-basin 5"
4778,500,38,6100,6600,"Sub-basin 5"
4779,100,1,3300,3400,"Sub-basin 5"
4780,6900,1667,30100,37000,"Sub-basin 5"
4781,100,2,1500,1600,"Sub-basin 5"
4782,400,31,3200,3600,"Sub-basin 5"
4783,800,81,3500,4300,"Sub-basin 5"
4784,300,4,2600,2900,"Sub-basin 5"
4785,100,3,2800,2900,"Sub-basin 5"
4786,5100,2129,19100,24200,"Sub-basin 5"
4787,300,5,4700,5000,"Sub-basin 5"
4788,200,7,3500,3700,"Sub-basin 5"
4789,200,3,1700,1900,"Sub-basin 5"
4790,100,2,1500,1600,"Sub-basin 5"
4791,3100,789,8100,11200,"Sub-basin 5"
4792,200,13,2600,2800,"Sub-basin 5"
4793,1300,33,10900,12200,"Sub-basin 5"
4794,100,3,1300,1400,"Sub-basin 5"
4795,1400,173,17400,18800,"Sub-basin 5"
4796,200,7,5000,5200,"Sub-basin 5"
4797,1000,94,5500,6500,"Sub-basin 5"
4798,100,2,2100,2200,"Sub-basin 5"
4799,100,1.0005,1600,1700,"Sub-basin 5"
4800,800,46,6100,6900,"Sub-basin 5"
4801,500,32,6500,7000,"Sub-basin 5"
4802,1800,195,7200,9000,"Sub-basin 5"
4803,100,2,1200,1300,"Sub-basin 5"
4804,300,6,700,1000,"Sub-basin 5"
4805,500,23,2600,3100,"Sub-basin 5"
4806,1000,68,6600,7600,"Sub-basin 5"
4807,600,53,5200,5800,"Sub-basin 5"
4808,100,2,1300,1400,"Sub-basin 5"
4809,1200,111,5700,6900,"Sub-basin 5"
4810,100,1,2300,2400,"Sub-basin 5"
4811,200,2,4800,5000,"Sub-basin 5"
4812,400,16,3700,4100,"Sub-basin 5"
4813,100,13,500,600,"Sub-basin 5"
4814,600,155,2800,3400,"Sub-basin 5"
4815,2100,408,5100,7200,"Sub-basin 5"
4816,800,25,5400,6200,"Sub-basin 5"
4817,200,18,2000,2200,"Sub-basin 5"
4818,1200,89,9900,11100,"Sub-basin 5"
4819,400,17,900,1300,"Sub-basin 5"
4820,500,12,2500,3000,"Sub-basin 5"
4821,200,3,2800,3000,"Sub-basin 5"
4822,100,3,1400,1500,"Sub-basin 5"
4823,400,13,800,1200,"Sub-basin 5"
4824,1100,89,9000,10100,"Sub-basin 5"
4825,2300,493,5800,8100,"Sub-basin 5"
4826,100,1.0005,1800,1900,"Sub-basin 5"
4827,300,29,2700,3000,"Sub-basin 5"
4828,1200,958,5200,6400,"Sub-basin 5"
4829,400,53,2700,3100,"Sub-basin 5"
4830,100,2,2400,2500,"Sub-basin 5"
4831,100,1,4900,5000,"Sub-basin 5"
4832,100,2,4400,4500,"Sub-basin 5"
4833,100,1,1000,1100,"Sub-basin 5"
4834,900,49,8100,9000,"Sub-basin 5"
4835,100,2,700,800,"Sub-basin 5"
4836,700,36,5000,5700,"Sub-basin 5"
4837,100,2,1000,1100,"Sub-basin 5"
4838,600,39,5700,6300,"Sub-basin 5"
4839,2600,915,5200,7800,"Sub-basin 5"
4840,100,5,2100,2200,"Sub-basin 5"
4841,200,3,2200,2400,"Sub-basin 5"
4842,300,28.83,1400,1700,"Sub-basin 5"
4843,1200,75,10300,11500,"Sub-basin 5"
4844,600,29,6000,6600,"Sub-basin 5"
4845,100,3.0008,1200,1300,"Sub-basin 5"
4846,500,58,3200,3700,"Sub-basin 5"
4847,1100,127,4600,5700,"Sub-basin 5"
4848,100,1,1100,1200,"Sub-basin 5"
4849,800,64,9800,10600,"Sub-basin 5"
4850,700,103,3900,4600,"Sub-basin 5"
4851,600,34,6700,7300,"Sub-basin 5"
4852,400,34,3100,3500,"Sub-basin 5"
4853,100,2,1500,1600,"Sub-basin 5"
4854,100,5,2800,2900,"Sub-basin 5"
4855,1100,106,6600,7700,"Sub-basin 5"
4856,200,7,1800,2000,"Sub-basin 5"
4857,1900,347,8500,10400,"Sub-basin 5"
4858,600,127,3800,4400,"Sub-basin 5"
4859,600,31,9200,9800,"Sub-basin 5"
4860,900,69,9900,10800,"Sub-basin 5"
4861,500,12,4500,5000,"Sub-basin 5"
4862,500,13,5100,5600,"Sub-basin 5"
4863,400,18,5500,5900,"Sub-basin 5"
4864,100,3.0005,2400,2500,"Sub-basin 5"
4865,400,47,1300,1700,"Sub-basin 5"
4866,200,20,3000,3200,"Sub-basin 5"
4867,3200,946,9800,13000,"Sub-basin 5"
4868,100,1,2200,2300,"Sub-basin 5"
4869,300,27,6400,6700,"Sub-basin 5"
4870,1800,272,17600,19400,"Sub-basin 5"
4871,3500,1771,8200,11700,"Sub-basin 5"
4872,1900,156,20200,22100,"Sub-basin 5"
4873,6400,1185,21000,27400,"Sub-basin 5"
4874,100,2,1100,1200,"Sub-basin 5"
4875,500,69,4300,4800,"Sub-basin 5"
4876,200,22,4300,4500,"Sub-basin 5"
4877,700,220,1700,2400,"Sub-basin 5"
4878,500,51,7900,8400,"Sub-basin 5"
4879,100,2,3400,3500,"Sub-basin 5"
4880,9400,2774,18200,27600,"Sub-basin 5"
4881,2900,883,4200,7100,"Sub-basin 5"
4882,100,2.0005,1800,1900,"Sub-basin 5"
4883,600,76,3700,4300,"Sub-basin 5"
4884,200,3,2600,2800,"Sub-basin 5"
4885,6400,1886,11500,17900,"Sub-basin 5"
4886,1000,63,2000,3000,"Sub-basin 5"
4887,1200,95,10300,11500,"Sub-basin 5"
4888,1200,117,12300,13500,"Sub-basin 5"
4889,300,14,2500,2800,"Sub-basin 5"
4890,100,2,3000,3100,"Sub-basin 5"
4891,600,18,11000,11600,"Sub-basin 5"
4892,1800,153,11000,12800,"Sub-basin 5"
4893,1200,86,900,2100,"Sub-basin 5"
4894,100,3,700,800,"Sub-basin 5"
4895,800,24,7700,8500,"Sub-basin 5"
4896,4200,692.16,18100,22300,"Sub-basin 5"
4897,100,1,2500,2600,"Sub-basin 5"
4898,100,5,2500,2600,"Sub-basin 5"
4899,600,15,5400,6000,"Sub-basin 5"
4900,1300,122,8600,9900,"Sub-basin 5"
4901,200,5,1600,1800,"Sub-basin 5"
4902,400,22,1100,1500,"Sub-basin 5"
4903,300,8,2400,2700,"Sub-basin 5"
4904,100,1,2200,2300,"Sub-basin 5"
4905,100,4,1300,1400,"Sub-basin 5"
4906,600,32,3200,3800,"Sub-basin 5"
4907,200,6,2700,2900,"Sub-basin 5"
4908,100,7,1500,1600,"Sub-basin 5"
4909,300,6,4800,5100,"Sub-basin 5"
4910,600,44,6500,7100,"Sub-basin 5"
4911,500,17,2600,3100,"Sub-basin 5"
4912,300,5.0023,4100,4400,"Sub-basin 5"
4913,1700,123,15300,17000,"Sub-basin 5"
4914,900,55,8500,9400,"Sub-basin 5"
4915,700,43,3700,4400,"Sub-basin 5"
4916,400,34,1100,1500,"Sub-basin 5"
4917,100,1,700,800,"Sub-basin 5"
4918,2100,270,8300,10400,"Sub-basin 5"
4919,1100,53,8700,9800,"Sub-basin 5"
4920,100,4,700,800,"Sub-basin 5"
4921,500,22,1100,1600,"Sub-basin 5"
4922,1200,105,4400,5600,"Sub-basin 5"
4923,400,34,1100,1500,"Sub-basin 5"
4924,100,3,1700,1800,"Sub-basin 5"
4925,100,1,1400,1500,"Sub-basin 5"
4926,2900,770,9000,11900,"Sub-basin 5"
4927,100,2,2800,2900,"Sub-basin 5"
4928,800,23,10300,11100,"Sub-basin 5"
4929,200,5,1900,2100,"Sub-basin 5"
4930,200,3.001,3600,3800,"Sub-basin 5"
4931,800,46,6700,7500,"Sub-basin 5"
4932,200,5,2200,2400,"Sub-basin 5"
4933,100,3,900,1000,"Sub-basin 5"
4934,2400,704,6200,8600,"Sub-basin 5"
4935,100,1.0004,1400,1500,"Sub-basin 5"
4936,200,3.001,3700,3900,"Sub-basin 5"
4937,200,5.0013,2600,2800,"Sub-basin 5"
4938,100,31,600,700,"Sub-basin 5"
4939,100,1,1000,1100,"Sub-basin 5"
4940,1100,109,5400,6500,"Sub-basin 5"
4941,400,16,3600,4000,"Sub-basin 5"
4942,6700,846,27900,34600,"Sub-basin 5"
4943,100,2,1700,1800,"Sub-basin 5"
4944,100,4,3100,3200,"Sub-basin 5"
4945,100,2,2200,2300,"Sub-basin 5"
4946,100,2,2000,2100,"Sub-basin 5"
4947,100,1,600,700,"Sub-basin 5"
4948,1000,72,17100,18100,"Sub-basin 5"
4949,200,3,3800,4000,"Sub-basin 5"
4950,100,1,900,1000,"Sub-basin 5"
4951,400,21,2600,3000,"Sub-basin 5"
4952,200,9,3100,3300,"Sub-basin 5"
4953,100,1,500,600,"Sub-basin 5"
4954,200,3,4500,4700,"Sub-basin 5"
4955,100,1,2900,3000,"Sub-basin 5"
4956,100,1,2200,2300,"Sub-basin 5"
4957,200,2,3400,3600,"Sub-basin 5"
4958,700,32,3100,3800,"Sub-basin 5"
4959,400,11.34,1600,2000,"Sub-basin 5"
4960,600,35,3800,4400,"Sub-basin 5"
4961,2700,589.66,16000,18700,"Sub-basin 5"
4962,600,54.83,2900,3500,"Sub-basin 5"
4963,400,21,2200,2600,"Sub-basin 5"
4964,300,8,2900,3200,"Sub-basin 5"
4965,2900,1036.99,19200,22100,"Sub-basin 5"
4966,3000,1133.17,3700,6700,"Sub-basin 5"
4967,100,2.0005,1400,1500,"Sub-basin 5"
4968,300,8,4400,4700,"Sub-basin 5"
4969,100,1.0005,1600,1700,"Sub-basin 5"
4970,100,2,100,200,"Sub-basin 5"
4971,200,2,1200,1400,"Sub-basin 5"
4972,100,2,900,1000,"Sub-basin 5"
4973,700,108.0014,6000,6700,"Sub-basin 5"
4974,200,6.0009,5900,6100,"Sub-basin 5"
4975,1100,379,4600,5700,"Sub-basin 5"
4976,300,23,3100,3400,"Sub-basin 5"
4977,300,10,3700,4000,"Sub-basin 5"
4978,500,13,10000,10500,"Sub-basin 5"
4979,100,2,1200,1300,"Sub-basin 5"
4980,400,26,4800,5200,"Sub-basin 5"
4981,200,4.0013,5500,5700,"Sub-basin 5"
4982,6200,3124.51,5200,11400,"Sub-basin 5"
4983,600,126,1700,2300,"Sub-basin 5"
4984,500,33,2700,3200,"Sub-basin 5"
4985,100,5,1600,1700,"Sub-basin 5"
4986,2400,556,11300,13700,"Sub-basin 5"
4987,100,2,900,1000,"Sub-basin 5"
4988,900,39,7700,8600,"Sub-basin 5"
4989,200,2,2600,2800,"Sub-basin 5"
4990,100,1,1900,2000,"Sub-basin 5"
4991,200,3,3500,3700,"Sub-basin 5"
4992,100,3,1600,1700,"Sub-basin 5"
4993,100,1.0004,1900,2000,"Sub-basin 5"
4994,100,1.0008,2800,2900,"Sub-basin 5"
4995,2000,282,15800,17800,"Sub-basin 5"
4996,200,4,5700,5900,"Sub-basin 5"
4997,1900,156,12000,13900,"Sub-basin 5"
4998,200,4,1900,2100,"Sub-basin 5"
4999,1000,71,6500,7500,"Sub-basin 5"
5000,100,5,1400,1500,"Sub-basin 5"
5001,700,68,5300,6000,"Sub-basin 5"
5002,900,34,8700,9600,"Sub-basin 5"
5003,400,18,1000,1400,"Sub-basin 5"
5004,300,29,3100,3400,"Sub-basin 5"
5005,200,11,1500,1700,"Sub-basin 5"
5006,500,38,2700,3200,"Sub-basin 5"
5007,100,3,2100,2200,"Sub-basin 5"
5008,100,4,400,500,"Sub-basin 5"
5009,1700,469,6100,7800,"Sub-basin 5"
5010,100,2.0002,1100,1200,"Sub-basin 5"
5011,1400,124,14000,15400,"Sub-basin 5"
5012,200,8,3600,3800,"Sub-basin 5"
5013,300,4,3800,4100,"Sub-basin 5"
5014,200,6,600,800,"Sub-basin 5"
5015,1000,86,5800,6800,"Sub-basin 5"
5016,100,7,1200,1300,"Sub-basin 5"
5017,200,6,2300,2500,"Sub-basin 5"
5018,100,5,1300,1400,"Sub-basin 5"
5019,600,86,2400,3000,"Sub-basin 5"
5020,100,2.0004,3400,3500,"Sub-basin 5"
5021,400,28,3600,4000,"Sub-basin 5"
5022,1400,183,8600,10000,"Sub-basin 5"
5023,400,12,4500,4900,"Sub-basin 5"
5024,3400,1629,13100,16500,"Sub-basin 5"
5025,200,5,3400,3600,"Sub-basin 5"
5026,300,4,1500,1800,"Sub-basin 5"
5027,400,53,2400,2800,"Sub-basin 5"
5028,1300,107,3500,4800,"Sub-basin 5"
5029,100,5,500,600,"Sub-basin 5"
5030,100,2,1700,1800,"Sub-basin 5"
5031,100,1,1700,1800,"Sub-basin 5"
5032,100,3,1800,1900,"Sub-basin 5"
5033,400,14,5300,5700,"Sub-basin 5"
5034,700,61,3100,3800,"Sub-basin 5"
5035,600,24,2500,3100,"Sub-basin 5"
5036,100,2,1100,1200,"Sub-basin 5"
5037,100,1,400,500,"Sub-basin 5"
5038,100,3,700,800,"Sub-basin 5"
5039,12100,5099,34800,46900,"Sub-basin 5"
5040,500,13,5800,6300,"Sub-basin 5"
5041,400,13,3700,4100,"Sub-basin 5"
5042,200,13,3600,3800,"Sub-basin 5"
5043,1700,140,8000,9700,"Sub-basin 5"
5044,5100,1433,42200,47300,"Sub-basin 5"
5045,100,3.0005,2700,2800,"Sub-basin 5"
5046,400,9,3200,3600,"Sub-basin 5"
5047,600,23,12300,12900,"Sub-basin 5"
5048,400,10.51,1600,2000,"Sub-basin 5"
5049,200,8,2100,2300,"Sub-basin 5"
5050,100,1,700,800,"Sub-basin 5"
5051,400,15,6500,6900,"Sub-basin 5"
5052,300,6,1500,1800,"Sub-basin 5"
5053,500,19,6600,7100,"Sub-basin 5"
5054,200,6,5300,5500,"Sub-basin 5"
5055,300,10,1800,2100,"Sub-basin 5"
5056,300,12,2800,3100,"Sub-basin 5"
5057,400,27,3700,4100,"Sub-basin 5"
5058,1400,112,7000,8400,"Sub-basin 5"
5059,200,3,3800,4000,"Sub-basin 5"
5060,400,11,4100,4500,"Sub-basin 5"
5061,200,4,2900,3100,"Sub-basin 5"
5062,200,13,1900,2100,"Sub-basin 5"
5063,400,5.0012,2700,3100,"Sub-basin 5"
5064,300,16,1800,2100,"Sub-basin 5"
5065,100,1,1300,1400,"Sub-basin 5"
5066,100,3,1300,1400,"Sub-basin 5"
5067,200,9,2700,2900,"Sub-basin 5"
5068,2500,553,16900,19400,"Sub-basin 5"
5069,200,4,4100,4300,"Sub-basin 5"
5070,100,3,1300,1400,"Sub-basin 5"
5071,400,11,4000,4400,"Sub-basin 5"
5072,500,6,5300,5800,"Sub-basin 5"
5073,500,5,8500,9000,"Sub-basin 5"
5074,2000,144,23700,25700,"Sub-basin 5"
5075,100,1,1500,1600,"Sub-basin 5"
5076,600,36,3200,3800,"Sub-basin 5"
5077,31100,8760,79500,110600,"Sub-basin 5"
5078,100,2,1400,1500,"Sub-basin 5"
5079,100,1,2900,3000,"Sub-basin 5"
5080,100,2,2600,2700,"Sub-basin 5"
5081,100,4,2100,2200,"Sub-basin 5"
5082,200,24,1000,1200,"Sub-basin 5"
5083,100,2.0005,1500,1600,"Sub-basin 5"
5084,1200,123,4500,5700,"Sub-basin 5"
5085,100,2,2300,2400,"Sub-basin 5"
5086,500,29,2000,2500,"Sub-basin 5"
5087,800,65,5000,5800,"Sub-basin 5"
5088,100,1,2100,2200,"Sub-basin 5"
5089,100,1,0,100,"Sub-basin 5"
5090,1600,73,15000,16600,"Sub-basin 5"
5091,600,17,3600,4200,"Sub-basin 5"
5092,3300,505,21400,24700,"Sub-basin 5"
5093,500,26,8400,8900,"Sub-basin 5"
5094,1000,85,6000,7000,"Sub-basin 5"
5095,100,1,1200,1300,"Sub-basin 5"
5096,300,12,2600,2900,"Sub-basin 5"
5097,600,43,4500,5100,"Sub-basin 5"
5098,100,1,1800,1900,"Sub-basin 5"
5099,2100,111,11400,13500,"Sub-basin 5"
5100,200,5,2300,2500,"Sub-basin 5"
5101,2200,766,8000,10200,"Sub-basin 5"
5102,100,2,1200,1300,"Sub-basin 5"
5103,5000,2613,23200,28200,"Sub-basin 5"
5104,100,1,1800,1900,"Sub-basin 5"
5105,100,2,2400,2500,"Sub-basin 5"
5106,100,1,2600,2700,"Sub-basin 5"
5107,300,5,3600,3900,"Sub-basin 5"
5108,1400,136,5600,7000,"Sub-basin 5"
5109,100,2,1700,1800,"Sub-basin 5"
5110,3200,188,26600,29800,"Sub-basin 5"
5111,100,2,1700,1800,"Sub-basin 5"
5112,1500,82,23500,25000,"Sub-basin 5"
5113,100,6,2400,2500,"Sub-basin 5"
5114,400,17,5000,5400,"Sub-basin 5"
5115,400,22,3800,4200,"Sub-basin 5"
5116,100,1.0002,2100,2200,"Sub-basin 5"
5117,200,5,2600,2800,"Sub-basin 5"
5118,100,1,800,900,"Sub-basin 5"
5119,200,5,1900,2100,"Sub-basin 5"
5120,800,52,3900,4700,"Sub-basin 5"
5121,600,40,5100,5700,"Sub-basin 5"
5122,100,1,800,900,"Sub-basin 5"
5123,3300,362,37700,41000,"Sub-basin 5"
5124,100,1,2000,2100,"Sub-basin 5"
5125,100,3,800,900,"Sub-basin 5"
5126,800,140,3900,4700,"Sub-basin 5"
5127,1000,83,4800,5800,"Sub-basin 5"
5128,600,27,4300,4900,"Sub-basin 5"
5129,200,3,5900,6100,"Sub-basin 5"
5130,3100,164,14700,17800,"Sub-basin 5"
5131,3100,253,17500,20600,"Sub-basin 5"
5132,200,6,2200,2400,"Sub-basin 5"
5133,3300,371,19800,23100,"Sub-basin 5"
5134,1000,96,26200,27200,"Sub-basin 5"
5135,200,10,1800,2000,"Sub-basin 5"
5136,100,1,1500,1600,"Sub-basin 5"
5137,200,3,1300,1500,"Sub-basin 5"
5138,200,5,3600,3800,"Sub-basin 5"
5139,300,12,2600,2900,"Sub-basin 5"
5140,400,20,2000,2400,"Sub-basin 5"
5141,100,1,1100,1200,"Sub-basin 5"
5142,2600,309,8100,10700,"Sub-basin 5"
5143,300,8.0015,6700,7000,"Sub-basin 5"
5144,400,5.002,8900,9300,"Sub-basin 5"
5145,600,20,3000,3600,"Sub-basin 5"
5146,400,9,6700,7100,"Sub-basin 5"
5147,1300,113,1900,3200,"Sub-basin 5"
5148,300,6.0073,5300,5600,"Sub-basin 5"
5149,100,1,4300,4400,"Sub-basin 5"
5150,200,7,1800,2000,"Sub-basin 5"
5151,600,42,4000,4600,"Sub-basin 5"
5152,100,2,1300,1400,"Sub-basin 5"
5153,100,1,1300,1400,"Sub-basin 5"
5154,100,3,300,400,"Sub-basin 5"
5155,100,1,3300,3400,"Sub-basin 5"
5156,600,16.004,12200,12800,"Sub-basin 5"
5157,500,24,1700,2200,"Sub-basin 5"
5158,100,2,1800,1900,"Sub-basin 5"
5159,100,2,1900,2000,"Sub-basin 5"
5160,100,1,1600,1700,"Sub-basin 5"
5161,1000,67,4100,5100,"Sub-basin 5"
5162,700,21.011,7400,8100,"Sub-basin 5"
5163,400,15,1500,1900,"Sub-basin 5"
5164,600,72,4800,5400,"Sub-basin 5"
5165,300,20,3900,4200,"Sub-basin 5"
5166,900,120,5300,6200,"Sub-basin 5"
5167,300,14,500,800,"Sub-basin 5"
5168,100,1.0005,2400,2500,"Sub-basin 5"
5169,500,19.0027,7600,8100,"Sub-basin 5"
5170,200,9,1900,2100,"Sub-basin 5"
5171,1400,108,11200,12600,"Sub-basin 5"
5172,100,2,1000,1100,"Sub-basin 5"
5173,1000,108,2400,3400,"Sub-basin 5"
5174,100,2,2800,2900,"Sub-basin 5"
5175,1400,512,3100,4500,"Sub-basin 5"
5176,700,109,5000,5700,"Sub-basin 5"
5177,200,10,4300,4500,"Sub-basin 5"
5178,300,5,1200,1500,"Sub-basin 5"
5179,100,2,1200,1300,"Sub-basin 5"
5180,200,6,3000,3200,"Sub-basin 5"
5181,100,2,1700,1800,"Sub-basin 5"
5182,700,24,8100,8800,"Sub-basin 5"
5183,100,1,1000,1100,"Sub-basin 5"
5184,300,38,2700,3000,"Sub-basin 5"
5185,1700,106,15100,16800,"Sub-basin 5"
5186,100,8,2700,2800,"Sub-basin 5"
5187,100,3,1400,1500,"Sub-basin 5"
5188,100,2,800,900,"Sub-basin 5"
5189,15100,11149,17000,32100,"Sub-basin 5"
5190,1400,83,11300,12700,"Sub-basin 5"
5191,600,10,5300,5900,"Sub-basin 5"
5192,400,20,2300,2700,"Sub-basin 5"
5193,300,5,2800,3100,"Sub-basin 5"
5194,800,29,5700,6500,"Sub-basin 5"
5195,200,13,2400,2600,"Sub-basin 5"
5196,5200,2649,13900,19100,"Sub-basin 5"
5197,500,25,3000,3500,"Sub-basin 5"
5198,1200,94,12800,14000,"Sub-basin 5"
5199,500,58,2800,3300,"Sub-basin 5"
5200,100,3,700,800,"Sub-basin 5"
5201,100,3,2000,2100,"Sub-basin 5"
5202,300,5,5000,5300,"Sub-basin 5"
5203,100,2,600,700,"Sub-basin 5"
5204,300,13,3900,4200,"Sub-basin 5"
5205,200,14,1300,1500,"Sub-basin 5"
5206,600,50,2000,2600,"Sub-basin 5"
5207,400,14,2700,3100,"Sub-basin 5"
5208,200,13,3000,3200,"Sub-basin 5"
5209,400,21,2400,2800,"Sub-basin 5"
5210,300,18,1800,2100,"Sub-basin 5"
5211,600,21,4700,5300,"Sub-basin 5"
5212,1700,400,7400,9100,"Sub-basin 5"
5213,200,11,1800,2000,"Sub-basin 5"
5214,500,20,3700,4200,"Sub-basin 5"
5215,400,24,600,1000,"Sub-basin 5"
5216,100,3,1300,1400,"Sub-basin 5"
5217,500,49,4500,5000,"Sub-basin 5"
5218,100,1,1700,1800,"Sub-basin 5"
5219,300,8,1900,2200,"Sub-basin 5"
5220,100,2,1100,1200,"Sub-basin 5"
5221,200,6,1100,1300,"Sub-basin 5"
5222,300,4,2600,2900,"Sub-basin 5"
5223,100,2,200,300,"Sub-basin 5"
5224,100,1,1100,1200,"Sub-basin 5"
5225,600,35,2500,3100,"Sub-basin 5"
5226,400,57,2400,2800,"Sub-basin 5"
5227,1300,180,3500,4800,"Sub-basin 5"
5228,1400,153,4500,5900,"Sub-basin 5"
5229,100,2,600,700,"Sub-basin 5"
5230,700,26,2400,3100,"Sub-basin 5"
5231,900,73,3000,3900,"Sub-basin 5"
5232,1400,1288,4300,5700,"Sub-basin 5"
5233,500,52,4300,4800,"Sub-basin 5"
5234,1000,38,7800,8800,"Sub-basin 5"
5235,400,13,6000,6400,"Sub-basin 5"
5236,100,1,700,800,"Sub-basin 5"
5237,500,59,1500,2000,"Sub-basin 5"
5238,200,3,1900,2100,"Sub-basin 5"
5239,100,1,2500,2600,"Sub-basin 5"
5240,300,14,6900,7200,"Sub-basin 5"
5241,2500,373,4000,6500,"Sub-basin 5"
5242,200,8,1000,1200,"Sub-basin 5"
5243,200,2,900,1100,"Sub-basin 5"
5244,2800,1876,8200,11000,"Sub-basin 5"
5245,3100,132,19500,22600,"Sub-basin 5"
5246,1800,191,12100,13900,"Sub-basin 5"
5247,300,8,900,1200,"Sub-basin 5"
5248,2800,155,10000,12800,"Sub-basin 5"
5249,400,6,3800,4200,"Sub-basin 5"
5250,100,2,2300,2400,"Sub-basin 5"
5251,400,13,5300,5700,"Sub-basin 5"
5252,1300,140,1000,2300,"Sub-basin 5"
5253,700,35,4600,5300,"Sub-basin 5"
5254,900,25,9000,9900,"Sub-basin 5"
5255,200,8,1900,2100,"Sub-basin 5"
5256,100,1,900,1000,"Sub-basin 5"
5257,100,1,1400,1500,"Sub-basin 5"
5258,400,23,3400,3800,"Sub-basin 5"
5259,300,10,3600,3900,"Sub-basin 5"
5260,200,8,1200,1400,"Sub-basin 5"
5261,1300,84,9900,11200,"Sub-basin 5"
5262,100,2,700,800,"Sub-basin 5"
5263,400,15,3200,3600,"Sub-basin 5"
5264,800,44,2900,3700,"Sub-basin 5"
5265,100,2,600,700,"Sub-basin 5"
5266,500,23,3400,3900,"Sub-basin 5"
1,200,6,500,700,"Sub-basin 6"
2,300,18,400,700,"Sub-basin 6"
3,1900,258,4500,6400,"Sub-basin 6"
4,500,46,1500,2000,"Sub-basin 6"
5,8500,2639,11600,20100,"Sub-basin 6"
6,2100,772,2800,4900,"Sub-basin 6"
7,700,143,1600,2300,"Sub-basin 6"
8,500,30,2000,2500,"Sub-basin 6"
9,600,71,900,1500,"Sub-basin 6"
10,1000,279,1000,2000,"Sub-basin 6"
11,200,12,800,1000,"Sub-basin 6"
12,300,20,700,1000,"Sub-basin 6"
13,900,140,2700,3600,"Sub-basin 6"
14,500,40,600,1100,"Sub-basin 6"
15,3500,903,6600,10100,"Sub-basin 6"
16,400,51,700,1100,"Sub-basin 6"
17,7000,3052,9100,16100,"Sub-basin 6"
18,200,26,500,700,"Sub-basin 6"
19,400,21,1300,1700,"Sub-basin 6"
20,14800,6087,17300,32100,"Sub-basin 6"
21,4300,1021,10100,14400,"Sub-basin 6"
22,300,24,1000,1300,"Sub-basin 6"
23,1500,478,4300,5800,"Sub-basin 6"
24,200,7,1700,1900,"Sub-basin 6"
25,500,64,2800,3300,"Sub-basin 6"
26,100,1,1700,1800,"Sub-basin 6"
27,100,5,1800,1900,"Sub-basin 6"
28,4200,1254,8400,12600,"Sub-basin 6"
29,400,18,3100,3500,"Sub-basin 6"
30,300,20,3200,3500,"Sub-basin 6"
31,200,12,1800,2000,"Sub-basin 6"
32,100,7,1700,1800,"Sub-basin 6"
33,1500,189,8300,9800,"Sub-basin 6"
34,800,174,3800,4600,"Sub-basin 6"
35,600,20,3400,4000,"Sub-basin 6"
36,200,5,1000,1200,"Sub-basin 6"
37,400,75,1700,2100,"Sub-basin 6"
38,100,1,600,700,"Sub-basin 6"
39,400,82,1700,2100,"Sub-basin 6"
40,500,45,3200,3700,"Sub-basin 6"
41,900,128,3500,4400,"Sub-basin 6"
42,2900,336,21000,23900,"Sub-basin 6"
43,200,3,2200,2400,"Sub-basin 6"
44,300,19,2600,2900,"Sub-basin 6"
45,100,3,1700,1800,"Sub-basin 6"
46,100,2,1200,1300,"Sub-basin 6"
47,1100,162,3100,4200,"Sub-basin 6"
48,400,81,1000,1400,"Sub-basin 6"
49,3600,443,16100,19700,"Sub-basin 6"
50,200,6,2100,2300,"Sub-basin 6"
51,400,23,3300,3700,"Sub-basin 6"
52,3500,455,15300,18800,"Sub-basin 6"
53,400,38,2300,2700,"Sub-basin 6"
54,900,79,6600,7500,"Sub-basin 6"
55,4800,1250,30300,35100,"Sub-basin 6"
56,200,5,1800,2000,"Sub-basin 6"
57,100,4,1200,1300,"Sub-basin 6"
58,200,6,2200,2400,"Sub-basin 6"
59,3700,867,11300,15000,"Sub-basin 6"
60,100,1,300,400,"Sub-basin 6"
61,200,10,1200,1400,"Sub-basin 6"
62,700,28,5100,5800,"Sub-basin 6"
63,800,48,4500,5300,"Sub-basin 6"
64,800,55,6500,7300,"Sub-basin 6"
65,100,4,2600,2700,"Sub-basin 6"
66,700,53,3600,4300,"Sub-basin 6"
67,300,7,2100,2400,"Sub-basin 6"
68,100,4,1600,1700,"Sub-basin 6"
69,1600,222,2300,3900,"Sub-basin 6"
70,100,1,1500,1600,"Sub-basin 6"
71,300,21,1800,2100,"Sub-basin 6"
72,500,20,3100,3600,"Sub-basin 6"
73,100,1,1300,1400,"Sub-basin 6"
74,300,12,4100,4400,"Sub-basin 6"
75,1500,203,6100,7600,"Sub-basin 6"
76,27200,5802,113600,140800,"Sub-basin 6"
77,100,1,1800,1900,"Sub-basin 6"
78,100,1,1000,1100,"Sub-basin 6"
79,700,34,2600,3300,"Sub-basin 6"
80,100,5,1300,1400,"Sub-basin 6"
81,9900,1221,31300,41200,"Sub-basin 6"
82,100,2,1500,1600,"Sub-basin 6"
83,100,2,2200,2300,"Sub-basin 6"
84,100,1,1900,2000,"Sub-basin 6"
85,800,97,5000,5800,"Sub-basin 6"
86,300,22,3100,3400,"Sub-basin 6"
87,3200,343,12400,15600,"Sub-basin 6"
88,1800,204,8900,10700,"Sub-basin 6"
89,100,5,1100,1200,"Sub-basin 6"
90,800,102,3700,4500,"Sub-basin 6"
91,1000,79,9100,10100,"Sub-basin 6"
92,100,1,1700,1800,"Sub-basin 6"
93,200,3,4100,4300,"Sub-basin 6"
94,200,4,4000,4200,"Sub-basin 6"
95,400,22,1900,2300,"Sub-basin 6"
96,400,50,1300,1700,"Sub-basin 6"
97,100,1,1300,1400,"Sub-basin 6"
98,2100,138,16700,18800,"Sub-basin 6"
99,400,71,600,1000,"Sub-basin 6"
100,3300,280,13800,17100,"Sub-basin 6"
101,100,3,2100,2200,"Sub-basin 6"
102,100,2,1100,1200,"Sub-basin 6"
103,500,21,4500,5000,"Sub-basin 6"
104,500,26,4100,4600,"Sub-basin 6"
105,3100,416,23600,26700,"Sub-basin 6"
106,400,62,2600,3000,"Sub-basin 6"
107,100,4,1300,1400,"Sub-basin 6"
108,100,4,1000,1100,"Sub-basin 6"
109,700,46,2700,3400,"Sub-basin 6"
110,1900,381,12200,14100,"Sub-basin 6"
111,2600,455,8500,11100,"Sub-basin 6"
112,400,18,3500,3900,"Sub-basin 6"
113,200,7,2400,2600,"Sub-basin 6"
114,2000,569.5,12200,14200,"Sub-basin 6"
115,800,90,4000,4800,"Sub-basin 6"
116,6200,1059,22800,29000,"Sub-basin 6"
117,100,6,800,900,"Sub-basin 6"
118,100,4,900,1000,"Sub-basin 6"
119,1400,149,10200,11600,"Sub-basin 6"
120,300,10,1600,1900,"Sub-basin 6"
121,1400,145,6800,8200,"Sub-basin 6"
122,300,27,600,900,"Sub-basin 6"
123,1500,191,6200,7700,"Sub-basin 6"
124,400,22,1700,2100,"Sub-basin 6"
125,12900,2090,43300,56200,"Sub-basin 6"
126,300,8,1900,2200,"Sub-basin 6"
127,100,2,1800,1900,"Sub-basin 6"
128,200,9,2300,2500,"Sub-basin 6"
129,5100,600.5,17800,22900,"Sub-basin 6"
130,200,11,1500,1700,"Sub-basin 6"
131,1100,72,5500,6600,"Sub-basin 6"
132,900,101,5300,6200,"Sub-basin 6"
133,200,9,2200,2400,"Sub-basin 6"
134,600,102,2500,3100,"Sub-basin 6"
135,4000,1193,5800,9800,"Sub-basin 6"
136,6000,883,20000,26000,"Sub-basin 6"
137,1000,71,5600,6600,"Sub-basin 6"
138,100,4,1900,2000,"Sub-basin 6"
139,200,2,1600,1800,"Sub-basin 6"
140,200,3,1800,2000,"Sub-basin 6"
141,4000,601,15000,19000,"Sub-basin 6"
142,200,12,1700,1900,"Sub-basin 6"
143,400,41,1600,2000,"Sub-basin 6"
144,3900,651,15700,19600,"Sub-basin 6"
145,1800,264,7100,8900,"Sub-basin 6"
146,200,15,1400,1600,"Sub-basin 6"
147,300,18,3500,3800,"Sub-basin 6"
148,2400,206,10400,12800,"Sub-basin 6"
149,400,24,3500,3900,"Sub-basin 6"
150,400,57,1800,2200,"Sub-basin 6"
151,1200,213,2200,3400,"Sub-basin 6"
152,300,16,2700,3000,"Sub-basin 6"
153,100,2,1200,1300,"Sub-basin 6"
154,500,27,3300,3800,"Sub-basin 6"
155,7900,1389,62100,70000,"Sub-basin 6"
156,400,13,3600,4000,"Sub-basin 6"
157,400,8,4200,4600,"Sub-basin 6"
158,500,73,500,1000,"Sub-basin 6"
159,100,2,900,1000,"Sub-basin 6"
160,2500,315,12300,14800,"Sub-basin 6"
161,200,10,1000,1200,"Sub-basin 6"
162,200,7,200,400,"Sub-basin 6"
163,1800,770,5900,7700,"Sub-basin 6"
164,600,39,2900,3500,"Sub-basin 6"
165,2000,217,8600,10600,"Sub-basin 6"
166,100,2,1100,1200,"Sub-basin 6"
167,400,19,4600,5000,"Sub-basin 6"
168,100,1,600,700,"Sub-basin 6"
169,1800,303,5100,6900,"Sub-basin 6"
170,500,35,5200,5700,"Sub-basin 6"
171,37200,12161,68100,105300,"Sub-basin 6"
172,2900,472,5500,8400,"Sub-basin 6"
173,7800,1498,21000,28800,"Sub-basin 6"
174,400,22,2600,3000,"Sub-basin 6"
175,600,42,4800,5400,"Sub-basin 6"
176,200,4,2700,2900,"Sub-basin 6"
177,300,14,1300,1600,"Sub-basin 6"
178,17600,3462,45500,63100,"Sub-basin 6"
179,100,1,1400,1500,"Sub-basin 6"
180,500,43,4300,4800,"Sub-basin 6"
181,3000,686,5400,8400,"Sub-basin 6"
182,100,1,800,900,"Sub-basin 6"
183,1600,550,5500,7100,"Sub-basin 6"
184,100,1,1000,1100,"Sub-basin 6"
185,900,95,2400,3300,"Sub-basin 6"
186,6400,1350,12800,19200,"Sub-basin 6"
187,600,31,5000,5600,"Sub-basin 6"
188,200,8,1900,2100,"Sub-basin 6"
189,100,5,1700,1800,"Sub-basin 6"
190,400,29,1900,2300,"Sub-basin 6"
191,900,77,5000,5900,"Sub-basin 6"
192,100,3,1200,1300,"Sub-basin 6"
193,500,39,4300,4800,"Sub-basin 6"
194,1200,119,6200,7400,"Sub-basin 6"
195,1200,353,2700,3900,"Sub-basin 6"
196,1400,211,4600,6000,"Sub-basin 6"
197,600,49,2800,3400,"Sub-basin 6"
198,100,2,200,300,"Sub-basin 6"
199,1100,88,10100,11200,"Sub-basin 6"
200,800,75,7700,8500,"Sub-basin 6"
201,100,1,1400,1500,"Sub-basin 6"
202,9000,1713,24600,33600,"Sub-basin 6"
203,3400,593,12100,15500,"Sub-basin 6"
204,700,47,6000,6700,"Sub-basin 6"
205,1300,83,9500,10800,"Sub-basin 6"
206,600,60,2200,2800,"Sub-basin 6"
207,500,60,3000,3500,"Sub-basin 6"
208,600,101,3300,3900,"Sub-basin 6"
209,400,20,3800,4200,"Sub-basin 6"
210,1200,109,5300,6500,"Sub-basin 6"
211,500,42,2700,3200,"Sub-basin 6"
212,100,1,800,900,"Sub-basin 6"
213,200,6,1100,1300,"Sub-basin 6"
214,200,5,1500,1700,"Sub-basin 6"
215,1700,209,13700,15400,"Sub-basin 6"
216,100,2,800,900,"Sub-basin 6"
217,300,7,2600,2900,"Sub-basin 6"
218,100,2,1100,1200,"Sub-basin 6"
219,200,11,700,900,"Sub-basin 6"
220,2300,742,9700,12000,"Sub-basin 6"
221,100,1,500,600,"Sub-basin 6"
222,200,14,1400,1600,"Sub-basin 6"
223,1000,107,4500,5500,"Sub-basin 6"
224,500,32,2200,2700,"Sub-basin 6"
225,100,1,2500,2600,"Sub-basin 6"
226,2700,719,8300,11000,"Sub-basin 6"
227,2800,1020,6400,9200,"Sub-basin 6"
228,900,192,3800,4700,"Sub-basin 6"
229,800,125,4000,4800,"Sub-basin 6"
230,1200,99,5300,6500,"Sub-basin 6"
231,1400,342,3900,5300,"Sub-basin 6"
232,300,17,1700,2000,"Sub-basin 6"
233,1500,153,4100,5600,"Sub-basin 6"
234,400,20,4000,4400,"Sub-basin 6"
235,400,26,1000,1400,"Sub-basin 6"
236,3500,821,9800,13300,"Sub-basin 6"
237,400,38,2700,3100,"Sub-basin 6"
238,200,5,1800,2000,"Sub-basin 6"
239,400,19,5500,5900,"Sub-basin 6"
240,100,3,900,1000,"Sub-basin 6"
241,1100,322,3500,4600,"Sub-basin 6"
242,1100,147,3100,4200,"Sub-basin 6"
243,600,33,3100,3700,"Sub-basin 6"
244,3800,379.17,7600,11400,"Sub-basin 6"
245,100,3,200,300,"Sub-basin 6"
246,700,56,3100,3800,"Sub-basin 6"
247,1200,157,5000,6200,"Sub-basin 6"
248,200,3,900,1100,"Sub-basin 6"
249,200,8,700,900,"Sub-basin 6"
250,100,2,1000,1100,"Sub-basin 6"
251,500,44,3800,4300,"Sub-basin 6"
252,100,8,1900,2000,"Sub-basin 6"
253,4300,517,12000,16300,"Sub-basin 6"
254,1100,79,3400,4500,"Sub-basin 6"
255,700,161,4200,4900,"Sub-basin 6"
256,700,48,4400,5100,"Sub-basin 6"
257,700,60,3000,3700,"Sub-basin 6"
258,400,27,1900,2300,"Sub-basin 6"
259,400,23,1500,1900,"Sub-basin 6"
260,1800,454,4600,6400,"Sub-basin 6"
261,2400,766,5600,8000,"Sub-basin 6"
262,100,1,1000,1100,"Sub-basin 6"
263,100,8,1300,1400,"Sub-basin 6"
264,300,9,4500,4800,"Sub-basin 6"
265,200,5,2200,2400,"Sub-basin 6"
266,300,5,2700,3000,"Sub-basin 6"
267,1300,115,5000,6300,"Sub-basin 6"
268,100,1,600,700,"Sub-basin 6"
269,2000,684,8600,10600,"Sub-basin 6"
270,200,13,1500,1700,"Sub-basin 6"
271,3100,697,8500,11600,"Sub-basin 6"
272,400,18,5600,6000,"Sub-basin 6"
273,3200,366,17600,20800,"Sub-basin 6"
274,2000,243,9200,11200,"Sub-basin 6"
275,1000,136,5100,6100,"Sub-basin 6"
276,400,21,1500,1900,"Sub-basin 6"
277,600,22,1900,2500,"Sub-basin 6"
278,1400,136,5300,6700,"Sub-basin 6"
279,5600,396,16000,21600,"Sub-basin 6"
280,1000,55,5700,6700,"Sub-basin 6"
281,100,1,1600,1700,"Sub-basin 6"
282,1900,180,5200,7100,"Sub-basin 6"
283,600,60,2600,3200,"Sub-basin 6"
284,400,15,3300,3700,"Sub-basin 6"
285,2400,280,9000,11400,"Sub-basin 6"
286,700,25,7800,8500,"Sub-basin 6"
287,2000,210,8000,10000,"Sub-basin 6"
288,700,55,3200,3900,"Sub-basin 6"
289,1000,314,3000,4000,"Sub-basin 6"
290,300,19,2200,2500,"Sub-basin 6"
291,1700,73,10400,12100,"Sub-basin 6"
292,200,2,1000,1200,"Sub-basin 6"
293,1800,136,9500,11300,"Sub-basin 6"
294,600,44,2300,2900,"Sub-basin 6"
295,600,72,2300,2900,"Sub-basin 6"
296,400,7,2600,3000,"Sub-basin 6"
297,200,5,2400,2600,"Sub-basin 6"
298,900,50,6800,7700,"Sub-basin 6"
299,100,1,1400,1500,"Sub-basin 6"
300,400,9,2900,3300,"Sub-basin 6"
301,1000,125,7400,8400,"Sub-basin 6"
302,100,1,1000,1100,"Sub-basin 6"
303,1400,67,6000,7400,"Sub-basin 6"
304,400,14,2900,3300,"Sub-basin 6"
305,200,6,1400,1600,"Sub-basin 6"
306,400,15,2900,3300,"Sub-basin 6"
307,3100,255,10500,13600,"Sub-basin 6"
308,100,2,1000,1100,"Sub-basin 6"
309,400,31,5100,5500,"Sub-basin 6"
310,500,11,1900,2400,"Sub-basin 6"
311,100,3,900,1000,"Sub-basin 6"
312,900,100,2900,3800,"Sub-basin 6"
313,800,36,5700,6500,"Sub-basin 6"
314,700,67,4300,5000,"Sub-basin 6"
315,600,128,1700,2300,"Sub-basin 6"
316,400,31,3100,3500,"Sub-basin 6"
317,2500,210,9000,11500,"Sub-basin 6"
318,700,31,4900,5600,"Sub-basin 6"
319,2400,349,12300,14700,"Sub-basin 6"
320,900,222,3200,4100,"Sub-basin 6"
321,800,127,2800,3600,"Sub-basin 6"
322,800,45,4500,5300,"Sub-basin 6"
323,200,4,2200,2400,"Sub-basin 6"
324,900,35,5700,6600,"Sub-basin 6"
325,1200,76,7200,8400,"Sub-basin 6"
326,800,22,14200,15000,"Sub-basin 6"
327,11000,2477,52500,63500,"Sub-basin 6"
328,600,48,5000,5600,"Sub-basin 6"
329,800,25,7100,7900,"Sub-basin 6"
330,300,20,3500,3800,"Sub-basin 6"
331,1500,109,5600,7100,"Sub-basin 6"
332,500,12,4900,5400,"Sub-basin 6"
333,900,70,3900,4800,"Sub-basin 6"
334,2900,459,9500,12400,"Sub-basin 6"
335,300,18,1200,1500,"Sub-basin 6"
336,100,4,1300,1400,"Sub-basin 6"
337,6100,873,31000,37100,"Sub-basin 6"
338,600,123,5000,5600,"Sub-basin 6"
339,200,5,1500,1700,"Sub-basin 6"
340,2500,466,5300,7800,"Sub-basin 6"
341,400,15,2300,2700,"Sub-basin 6"
342,1800,322,5100,6900,"Sub-basin 6"
343,1600,164,8200,9800,"Sub-basin 6"
344,100,1,2100,2200,"Sub-basin 6"
345,800,38,3400,4200,"Sub-basin 6"
346,700,56,2700,3400,"Sub-basin 6"
347,300,11,3100,3400,"Sub-basin 6"
348,200,2,1500,1700,"Sub-basin 6"
349,200,18,2400,2600,"Sub-basin 6"
350,400,12,3400,3800,"Sub-basin 6"
351,800,104,4900,5700,"Sub-basin 6"
352,600,64,5600,6200,"Sub-basin 6"
353,400,21,3100,3500,"Sub-basin 6"
354,1900,453,7300,9200,"Sub-basin 6"
355,2700,499,4300,7000,"Sub-basin 6"
356,100,1,300,400,"Sub-basin 6"
357,200,2,3400,3600,"Sub-basin 6"
358,100,6,1700,1800,"Sub-basin 6"
359,16000,1723,65000,81000,"Sub-basin 6"
360,1100,90,11000,12100,"Sub-basin 6"
361,200,12,2700,2900,"Sub-basin 6"
362,200,12,600,800,"Sub-basin 6"
363,5100,664,24800,29900,"Sub-basin 6"
364,300,8,1500,1800,"Sub-basin 6"
365,100,2,800,900,"Sub-basin 6"
366,200,5,3300,3500,"Sub-basin 6"
367,100,1,700,800,"Sub-basin 6"
368,100,1,2100,2200,"Sub-basin 6"
369,200,2,1200,1400,"Sub-basin 6"
370,2100,212,6100,8200,"Sub-basin 6"
371,100,1,1200,1300,"Sub-basin 6"
372,2000,219,13100,15100,"Sub-basin 6"
373,300,7,4800,5100,"Sub-basin 6"
374,100,2,2300,2400,"Sub-basin 6"
375,100,7,1100,1200,"Sub-basin 6"
376,200,19,2700,2900,"Sub-basin 6"
377,16800,2021.5,51100,67900,"Sub-basin 6"
378,100,1,1000,1100,"Sub-basin 6"
379,1000,120,4900,5900,"Sub-basin 6"
380,200,6,6000,6200,"Sub-basin 6"
381,800,70,3700,4500,"Sub-basin 6"
382,1700,189,6100,7800,"Sub-basin 6"
383,2700,185,9900,12600,"Sub-basin 6"
384,400,20,1900,2300,"Sub-basin 6"
385,1800,213,10500,12300,"Sub-basin 6"
386,1400,217,3500,4900,"Sub-basin 6"
387,1000,96,3000,4000,"Sub-basin 6"
388,100,1,1300,1400,"Sub-basin 6"
389,100,1,2400,2500,"Sub-basin 6"
390,1100,125,4600,5700,"Sub-basin 6"
391,500,21,3200,3700,"Sub-basin 6"
392,3600,1098,5700,9300,"Sub-basin 6"
393,400,56,1200,1600,"Sub-basin 6"
394,200,8,5200,5400,"Sub-basin 6"
395,600,30,3900,4500,"Sub-basin 6"
396,200,15,2100,2300,"Sub-basin 6"
397,400,27,1600,2000,"Sub-basin 6"
398,400,32,2400,2800,"Sub-basin 6"
399,1300,89,8600,9900,"Sub-basin 6"
400,100,1,1500,1600,"Sub-basin 6"
401,500,25,2200,2700,"Sub-basin 6"
402,600,91,3100,3700,"Sub-basin 6"
403,300,14,3700,4000,"Sub-basin 6"
404,5000,337,26100,31100,"Sub-basin 6"
405,2800,407,12300,15100,"Sub-basin 6"
406,4700,1732,6700,11400,"Sub-basin 6"
407,12800,2292,15500,28300,"Sub-basin 6"
408,1200,178,3900,5100,"Sub-basin 6"
409,1700,124,9100,10800,"Sub-basin 6"
410,100,3,300,400,"Sub-basin 6"
411,1800,220,13400,15200,"Sub-basin 6"
412,800,91,3400,4200,"Sub-basin 6"
413,1400,236,5600,7000,"Sub-basin 6"
414,3400,585,9600,13000,"Sub-basin 6"
415,900,52,3000,3900,"Sub-basin 6"
416,700,44,3600,4300,"Sub-basin 6"
417,800,90,4400,5200,"Sub-basin 6"
418,200,9,2000,2200,"Sub-basin 6"
419,400,48,2600,3000,"Sub-basin 6"
420,400,50,2500,2900,"Sub-basin 6"
421,300,14,3300,3600,"Sub-basin 6"
422,500,19,6100,6600,"Sub-basin 6"
423,100,2,900,1000,"Sub-basin 6"
424,100,2,500,600,"Sub-basin 6"
425,100,2,300,400,"Sub-basin 6"
426,1100,91,8800,9900,"Sub-basin 6"
427,200,4,1300,1500,"Sub-basin 6"
428,1800,202,3900,5700,"Sub-basin 6"
429,700,38,3100,3800,"Sub-basin 6"
430,4200,318,12600,16800,"Sub-basin 6"
431,200,4,5100,5300,"Sub-basin 6"
432,3800,852,9700,13500,"Sub-basin 6"
433,4100,401,13900,18000,"Sub-basin 6"
434,100,1,700,800,"Sub-basin 6"
435,100,2,700,800,"Sub-basin 6"
436,400,16,6400,6800,"Sub-basin 6"
437,700,81,5700,6400,"Sub-basin 6"
438,900,76,3400,4300,"Sub-basin 6"
439,600,47,3200,3800,"Sub-basin 6"
440,200,19,2800,3000,"Sub-basin 6"
441,100,2,1200,1300,"Sub-basin 6"
442,100,2,400,500,"Sub-basin 6"
443,500,55,2600,3100,"Sub-basin 6"
444,300,8,2100,2400,"Sub-basin 6"
445,100,4,1900,2000,"Sub-basin 6"
446,700,104,8600,9300,"Sub-basin 6"
447,1800,253,12400,14200,"Sub-basin 6"
448,400,76,1600,2000,"Sub-basin 6"
449,100,5,700,800,"Sub-basin 6"
450,900,89,3600,4500,"Sub-basin 6"
451,800,102,5200,6000,"Sub-basin 6"
452,600,31,6300,6900,"Sub-basin 6"
453,900,135,5400,6300,"Sub-basin 6"
454,13100,3150,20200,33300,"Sub-basin 6"
455,500,32,3300,3800,"Sub-basin 6"
456,100,1,1100,1200,"Sub-basin 6"
457,400,15,2800,3200,"Sub-basin 6"
458,1100,78,7000,8100,"Sub-basin 6"
459,4000,979,6200,10200,"Sub-basin 6"
460,200,2,800,1000,"Sub-basin 6"
461,300,9,2200,2500,"Sub-basin 6"
462,1000,90,5300,6300,"Sub-basin 6"
463,3800,378,14300,18100,"Sub-basin 6"
464,200,3,2300,2500,"Sub-basin 6"
465,300,5,4400,4700,"Sub-basin 6"
466,1100,257,5800,6900,"Sub-basin 6"
467,1200,171,9300,10500,"Sub-basin 6"
468,1400,90,11900,13300,"Sub-basin 6"
469,1600,157,6100,7700,"Sub-basin 6"
470,3300,421,17200,20500,"Sub-basin 6"
471,1700,238,11900,13600,"Sub-basin 6"
472,1700,170,9200,10900,"Sub-basin 6"
473,2800,763,4500,7300,"Sub-basin 6"
474,800,46,5100,5900,"Sub-basin 6"
475,400,22,2400,2800,"Sub-basin 6"
476,600,39,2500,3100,"Sub-basin 6"
477,600,28,4500,5100,"Sub-basin 6"
478,100,6,1600,1700,"Sub-basin 6"
479,200,25,3600,3800,"Sub-basin 6"
480,600,41,4400,5000,"Sub-basin 6"
481,700,101,2000,2700,"Sub-basin 6"
482,600,40,4000,4600,"Sub-basin 6"
483,800,48,5100,5900,"Sub-basin 6"
484,200,11,1900,2100,"Sub-basin 6"
485,2500,389,8200,10700,"Sub-basin 6"
486,100,6,1200,1300,"Sub-basin 6"
487,1500,363,17400,18900,"Sub-basin 6"
488,300,14,2800,3100,"Sub-basin 6"
489,700,94,2100,2800,"Sub-basin 6"
490,200,4,3100,3300,"Sub-basin 6"
491,25600,4907,57300,82900,"Sub-basin 6"
492,900,93,2700,3600,"Sub-basin 6"
493,1000,36,4400,5400,"Sub-basin 6"
494,2200,170,13100,15300,"Sub-basin 6"
495,200,27,1600,1800,"Sub-basin 6"
496,1500,101,9100,10600,"Sub-basin 6"
497,1400,199,4800,6200,"Sub-basin 6"
498,100,9,1000,1100,"Sub-basin 6"
499,100,4,1400,1500,"Sub-basin 6"
500,200,3,2600,2800,"Sub-basin 6"
501,100,1,1400,1500,"Sub-basin 6"
502,800,161,2700,3500,"Sub-basin 6"
503,800,46,4500,5300,"Sub-basin 6"
504,200,11,1400,1600,"Sub-basin 6"
505,600,29,6200,6800,"Sub-basin 6"
506,300,10,1200,1500,"Sub-basin 6"
507,100,1,900,1000,"Sub-basin 6"
508,500,34,5000,5500,"Sub-basin 6"
509,100,1,800,900,"Sub-basin 6"
510,200,14,2000,2200,"Sub-basin 6"
511,700,41,1900,2600,"Sub-basin 6"
512,400,20,1900,2300,"Sub-basin 6"
513,700,43,5500,6200,"Sub-basin 6"
514,500,36,5000,5500,"Sub-basin 6"
515,600,81,2800,3400,"Sub-basin 6"
516,500,32,3300,3800,"Sub-basin 6"
517,600,90,2200,2800,"Sub-basin 6"
518,10200,2223.83,49400,59600,"Sub-basin 6"
519,200,7,1700,1900,"Sub-basin 6"
520,6900,1445,13100,20000,"Sub-basin 6"
521,500,87,3000,3500,"Sub-basin 6"
522,500,25,2700,3200,"Sub-basin 6"
523,700,48,4500,5200,"Sub-basin 6"
524,200,5,2100,2300,"Sub-basin 6"
525,200,3,1200,1400,"Sub-basin 6"
526,100,4,1000,1100,"Sub-basin 6"
527,200,6,2100,2300,"Sub-basin 6"
528,11300,6640,14600,25900,"Sub-basin 6"
529,400,21,2100,2500,"Sub-basin 6"
530,17900,3446,47900,65800,"Sub-basin 6"
531,1400,84,4000,5400,"Sub-basin 6"
532,200,6,1600,1800,"Sub-basin 6"
533,200,3,900,1100,"Sub-basin 6"
534,100,3,1600,1700,"Sub-basin 6"
535,400,21,3500,3900,"Sub-basin 6"
536,1700,334,5100,6800,"Sub-basin 6"
537,600,42,3800,4400,"Sub-basin 6"
538,500,31,5100,5600,"Sub-basin 6"
539,800,55,3900,4700,"Sub-basin 6"
540,1100,155,5100,6200,"Sub-basin 6"
541,1500,170,5600,7100,"Sub-basin 6"
542,400,67,600,1000,"Sub-basin 6"
543,200,12,2200,2400,"Sub-basin 6"
544,6000,531,24800,30800,"Sub-basin 6"
545,100,3,1500,1600,"Sub-basin 6"
546,100,3,700,800,"Sub-basin 6"
547,200,9,1500,1700,"Sub-basin 6"
548,600,92,3800,4400,"Sub-basin 6"
549,100,1,1200,1300,"Sub-basin 6"
550,600,63,3900,4500,"Sub-basin 6"
551,900,77,3300,4200,"Sub-basin 6"
552,200,10,1500,1700,"Sub-basin 6"
553,400,22,6700,7100,"Sub-basin 6"
554,2200,234,15500,17700,"Sub-basin 6"
555,1300,122,4000,5300,"Sub-basin 6"
556,200,4,700,900,"Sub-basin 6"
557,400,25,3500,3900,"Sub-basin 6"
558,500,51,4800,5300,"Sub-basin 6"
559,400,30,4600,5000,"Sub-basin 6"
560,2300,420.66,7700,10000,"Sub-basin 6"
561,500,77,1700,2200,"Sub-basin 6"
562,6400,568,26200,32600,"Sub-basin 6"
563,400,31,2200,2600,"Sub-basin 6"
564,800,84,11200,12000,"Sub-basin 6"
565,1000,280,3100,4100,"Sub-basin 6"
566,1700,76,8700,10400,"Sub-basin 6"
567,1900,87,15300,17200,"Sub-basin 6"
568,300,6,2100,2400,"Sub-basin 6"
569,1300,165,8700,10000,"Sub-basin 6"
570,200,4,1100,1300,"Sub-basin 6"
571,500,31,2700,3200,"Sub-basin 6"
572,1000,192,3900,4900,"Sub-basin 6"
573,2200,348,7900,10100,"Sub-basin 6"
574,600,22,3500,4100,"Sub-basin 6"
575,700,63,5400,6100,"Sub-basin 6"
576,2600,363,12400,15000,"Sub-basin 6"
577,100,1,3000,3100,"Sub-basin 6"
578,300,25,2600,2900,"Sub-basin 6"
579,100,8,1400,1500,"Sub-basin 6"
580,400,40,3100,3500,"Sub-basin 6"
581,200,4,1200,1400,"Sub-basin 6"
582,1500,287,5700,7200,"Sub-basin 6"
583,200,12,900,1100,"Sub-basin 6"
584,1900,81,14700,16600,"Sub-basin 6"
585,500,63,1300,1800,"Sub-basin 6"
586,100,4,1100,1200,"Sub-basin 6"
587,200,3,4000,4200,"Sub-basin 6"
588,400,53,5700,6100,"Sub-basin 6"
589,300,33,1900,2200,"Sub-basin 6"
590,300,11,3400,3700,"Sub-basin 6"
591,200,2,1700,1900,"Sub-basin 6"
592,100,1,500,600,"Sub-basin 6"
593,1200,127.67,5500,6700,"Sub-basin 6"
594,1200,273,2400,3600,"Sub-basin 6"
595,900,70,5700,6600,"Sub-basin 6"
596,2400,717,4200,6600,"Sub-basin 6"
597,1000,139,3500,4500,"Sub-basin 6"
598,600,115,3700,4300,"Sub-basin 6"
599,5200,602,28100,33300,"Sub-basin 6"
600,200,4,2600,2800,"Sub-basin 6"
601,1900,333,8300,10200,"Sub-basin 6"
602,2100,527,6300,8400,"Sub-basin 6"
603,100,1,1000,1100,"Sub-basin 6"
604,900,118,2200,3100,"Sub-basin 6"
605,300,12,3100,3400,"Sub-basin 6"
606,600,49,4500,5100,"Sub-basin 6"
607,200,4,1200,1400,"Sub-basin 6"
608,100,3,1000,1100,"Sub-basin 6"
609,200,8,3500,3700,"Sub-basin 6"
610,1200,219,3000,4200,"Sub-basin 6"
611,100,2,700,800,"Sub-basin 6"
612,800,55,3000,3800,"Sub-basin 6"
613,500,80,1700,2200,"Sub-basin 6"
614,2500,314,6100,8600,"Sub-basin 6"
615,400,85,2500,2900,"Sub-basin 6"
616,100,1,700,800,"Sub-basin 6"
617,200,9,2000,2200,"Sub-basin 6"
618,100,2,1600,1700,"Sub-basin 6"
619,100,2,800,900,"Sub-basin 6"
620,200,29,1200,1400,"Sub-basin 6"
621,400,44,1100,1500,"Sub-basin 6"
622,6600,1298,26700,33300,"Sub-basin 6"
623,5300,571,27600,32900,"Sub-basin 6"
624,1300,89,5700,7000,"Sub-basin 6"
625,200,4,1300,1500,"Sub-basin 6"
626,100,5,900,1000,"Sub-basin 6"
627,800,53,5300,6100,"Sub-basin 6"
628,700,65,7200,7900,"Sub-basin 6"
629,900,80,4100,5000,"Sub-basin 6"
630,300,15,3400,3700,"Sub-basin 6"
631,400,58,3200,3600,"Sub-basin 6"
632,1200,302,5300,6500,"Sub-basin 6"
633,1400,266,3800,5200,"Sub-basin 6"
634,600,31,3500,4100,"Sub-basin 6"
635,100,5,900,1000,"Sub-basin 6"
636,800,201,1600,2400,"Sub-basin 6"
637,2100,237,10000,12100,"Sub-basin 6"
638,100,2,1800,1900,"Sub-basin 6"
639,200,16,800,1000,"Sub-basin 6"
640,600,29,5300,5900,"Sub-basin 6"
641,400,16,2000,2400,"Sub-basin 6"
642,100,3,700,800,"Sub-basin 6"
643,2100,137,11600,13700,"Sub-basin 6"
644,1100,210,3000,4100,"Sub-basin 6"
645,2700,530,4400,7100,"Sub-basin 6"
646,600,55,1100,1700,"Sub-basin 6"
647,200,9,400,600,"Sub-basin 6"
648,100,3,800,900,"Sub-basin 6"
649,1200,153,4100,5300,"Sub-basin 6"
650,800,66,4500,5300,"Sub-basin 6"
651,100,3,400,500,"Sub-basin 6"
652,600,80,2000,2600,"Sub-basin 6"
653,300,13,1300,1600,"Sub-basin 6"
654,100,3,400,500,"Sub-basin 6"
655,2000,655,6100,8100,"Sub-basin 6"
656,500,66,2700,3200,"Sub-basin 6"
657,100,2,400,500,"Sub-basin 6"
658,700,35,6600,7300,"Sub-basin 6"
659,500,42,5600,6100,"Sub-basin 6"
660,400,13,2500,2900,"Sub-basin 6"
661,2800,403,18200,21000,"Sub-basin 6"
662,500,78,2400,2900,"Sub-basin 6"
663,700,107,2000,2700,"Sub-basin 6"
664,4300,1206,9400,13700,"Sub-basin 6"
665,1100,206,3800,4900,"Sub-basin 6"
666,700,25,2000,2700,"Sub-basin 6"
667,6200,1359,12700,18900,"Sub-basin 6"
668,400,30,1800,2200,"Sub-basin 6"
669,300,7,3800,4100,"Sub-basin 6"
670,400,27,1700,2100,"Sub-basin 6"
671,1000,129,7800,8800,"Sub-basin 6"
672,400,32,4200,4600,"Sub-basin 6"
673,900,102,5400,6300,"Sub-basin 6"
674,600,34,3700,4300,"Sub-basin 6"
675,3900,504,9800,13700,"Sub-basin 6"
676,700,55,2200,2900,"Sub-basin 6"
677,3100,861,6200,9300,"Sub-basin 6"
678,2200,324,1500,3700,"Sub-basin 6"
679,200,18,2100,2300,"Sub-basin 6"
680,3200,1284,9700,12900,"Sub-basin 6"
681,400,39,11700,12100,"Sub-basin 6"
682,500,120,1100,1600,"Sub-basin 6"
683,700,73,5100,5800,"Sub-basin 6"
684,100,6,1800,1900,"Sub-basin 6"
685,100,3,1300,1400,"Sub-basin 6"
686,100,19,1300,1400,"Sub-basin 6"
687,200,14,2000,2200,"Sub-basin 6"
688,300,13,2200,2500,"Sub-basin 6"
689,100,11,1400,1500,"Sub-basin 6"
690,900,59,3900,4800,"Sub-basin 6"
691,100,2,100,200,"Sub-basin 6"
692,800,62,3100,3900,"Sub-basin 6"
693,100,1,1200,1300,"Sub-basin 6"
694,400,45,3600,4000,"Sub-basin 6"
695,100,2,2100,2200,"Sub-basin 6"
696,100,1,1300,1400,"Sub-basin 6"
697,59100,9261,85200,144300,"Sub-basin 6"
698,100,2,600,700,"Sub-basin 6"
699,200,7,1100,1300,"Sub-basin 6"
700,200,20,1400,1600,"Sub-basin 6"
701,700,136,4500,5200,"Sub-basin 6"
702,400,18,4400,4800,"Sub-basin 6"
703,100,7,1700,1800,"Sub-basin 6"
704,100,4,900,1000,"Sub-basin 6"
705,100,2,1100,1200,"Sub-basin 6"
706,200,11,1800,2000,"Sub-basin 6"
707,200,15,3300,3500,"Sub-basin 6"
708,400,38,2600,3000,"Sub-basin 6"
709,800,55,4600,5400,"Sub-basin 6"
710,600,27,4600,5200,"Sub-basin 6"
711,2800,392,5300,8100,"Sub-basin 6"
712,100,1,1300,1400,"Sub-basin 6"
713,500,14,7700,8200,"Sub-basin 6"
714,200,7,1900,2100,"Sub-basin 6"
715,600,219,7000,7600,"Sub-basin 6"
716,100,6,1000,1100,"Sub-basin 6"
717,800,38,9400,10200,"Sub-basin 6"
718,400,13,3400,3800,"Sub-basin 6"
719,400,15,1900,2300,"Sub-basin 6"
720,200,12,2800,3000,"Sub-basin 6"
721,300,30,2200,2500,"Sub-basin 6"
722,500,52,3100,3600,"Sub-basin 6"
723,500,17,3500,4000,"Sub-basin 6"
724,100,1,1700,1800,"Sub-basin 6"
725,1900,196,12800,14700,"Sub-basin 6"
726,1200,171,6200,7400,"Sub-basin 6"
727,100,8,500,600,"Sub-basin 6"
728,200,4,1200,1400,"Sub-basin 6"
729,100,26,2700,2800,"Sub-basin 6"
730,300,7,2200,2500,"Sub-basin 6"
731,100,5,800,900,"Sub-basin 6"
732,600,26,1600,2200,"Sub-basin 6"
733,100,1,700,800,"Sub-basin 6"
734,100,1,1100,1200,"Sub-basin 6"
735,300,15,1800,2100,"Sub-basin 6"
736,300,16,1600,1900,"Sub-basin 6"
737,100,3,400,500,"Sub-basin 6"
738,1800,85,12700,14500,"Sub-basin 6"
739,700,53,1300,2000,"Sub-basin 6"
740,500,30,2900,3400,"Sub-basin 6"
741,100,1,1300,1400,"Sub-basin 6"
742,100,1,2700,2800,"Sub-basin 6"
743,1700,452,8200,9900,"Sub-basin 6"
744,900,65,9600,10500,"Sub-basin 6"
745,200,7,300,500,"Sub-basin 6"
746,100,2,400,500,"Sub-basin 6"
747,400,44,1500,1900,"Sub-basin 6"
748,17900,2935,29400,47300,"Sub-basin 6"
749,600,37,1400,2000,"Sub-basin 6"
750,200,5,1200,1400,"Sub-basin 6"
751,400,38,3600,4000,"Sub-basin 6"
752,200,5,3000,3200,"Sub-basin 6"
753,400,5,5700,6100,"Sub-basin 6"
754,1000,128,4000,5000,"Sub-basin 6"
755,200,2,1900,2100,"Sub-basin 6"
756,600,118,2200,2800,"Sub-basin 6"
757,400,57,1900,2300,"Sub-basin 6"
758,300,16,1300,1600,"Sub-basin 6"
759,900,135,2400,3300,"Sub-basin 6"
760,300,11,500,800,"Sub-basin 6"
761,200,10,900,1100,"Sub-basin 6"
762,2300,176,16100,18400,"Sub-basin 6"
763,200,16,3500,3700,"Sub-basin 6"
764,500,16,8300,8800,"Sub-basin 6"
765,100,2,1300,1400,"Sub-basin 6"
766,200,4,1400,1600,"Sub-basin 6"
767,100,1,300,400,"Sub-basin 6"
768,300,9,3400,3700,"Sub-basin 6"
769,9500,1571,34100,43600,"Sub-basin 6"
770,300,21,1700,2000,"Sub-basin 6"
771,100,3,700,800,"Sub-basin 6"
772,8200,1751,17600,25800,"Sub-basin 6"
773,3200,440,11300,14500,"Sub-basin 6"
774,600,64,7400,8000,"Sub-basin 6"
775,600,63,5500,6100,"Sub-basin 6"
776,400,19,2600,3000,"Sub-basin 6"
777,700,125,4000,4700,"Sub-basin 6"
778,500,16,4200,4700,"Sub-basin 6"
779,300,20,1200,1500,"Sub-basin 6"
780,600,106,3600,4200,"Sub-basin 6"
781,300,10,4600,4900,"Sub-basin 6"
782,100,4,700,800,"Sub-basin 6"
783,700,51,4500,5200,"Sub-basin 6"
784,6700,2308,9900,16600,"Sub-basin 6"
785,300,9,3700,4000,"Sub-basin 6"
786,100,2,1400,1500,"Sub-basin 6"
787,600,24,7100,7700,"Sub-basin 6"
788,400,22,5300,5700,"Sub-basin 6"
789,100,6,1300,1400,"Sub-basin 6"
790,100,1,800,900,"Sub-basin 6"
791,15700,4120.34,40600,56300,"Sub-basin 6"
792,4500,1072,11700,16200,"Sub-basin 6"
793,100,3,2800,2900,"Sub-basin 6"
794,400,16,1700,2100,"Sub-basin 6"
795,100,1,1200,1300,"Sub-basin 6"
796,100,1,1500,1600,"Sub-basin 6"
797,200,9,2300,2500,"Sub-basin 6"
798,400,23,6900,7300,"Sub-basin 6"
799,2200,204,12500,14700,"Sub-basin 6"
800,1100,72,10200,11300,"Sub-basin 6"
801,200,4,1100,1300,"Sub-basin 6"
802,1600,270,12300,13900,"Sub-basin 6"
803,200,4,3600,3800,"Sub-basin 6"
804,500,40,4400,4900,"Sub-basin 6"
805,3600,1220,13600,17200,"Sub-basin 6"
806,300,10,6800,7100,"Sub-basin 6"
807,200,11,3700,3900,"Sub-basin 6"
808,2000,169,19000,21000,"Sub-basin 6"
809,1200,115,7100,8300,"Sub-basin 6"
810,400,25,2200,2600,"Sub-basin 6"
811,800,60,6200,7000,"Sub-basin 6"
812,100,2,1000,1100,"Sub-basin 6"
813,300,20,2100,2400,"Sub-basin 6"
814,43200,22476,63000,106200,"Sub-basin 6"
815,2000,124,13100,15100,"Sub-basin 6"
816,100,2,2000,2100,"Sub-basin 6"
817,100,6,2000,2100,"Sub-basin 6"
818,200,4,900,1100,"Sub-basin 6"
819,2400,480,11100,13500,"Sub-basin 6"
820,9800,6441.5738,10200,20000,"Sub-basin 6"
821,1100,71,8900,10000,"Sub-basin 6"
822,1000,152,9500,10500,"Sub-basin 6"
823,100,1,1500,1600,"Sub-basin 6"
824,7800,4575,8300,16100,"Sub-basin 6"
825,200,15,500,700,"Sub-basin 6"
826,900,134,1500,2400,"Sub-basin 6"
827,3400,891,8300,11700,"Sub-basin 6"
828,600,62,8600,9200,"Sub-basin 6"
829,600,112,2100,2700,"Sub-basin 6"
830,1600,121,15000,16600,"Sub-basin 6"
831,500,109,2700,3200,"Sub-basin 6"
832,300,13,800,1100,"Sub-basin 6"
833,1000,175,7000,8000,"Sub-basin 6"
834,100,3,1300,1400,"Sub-basin 6"
835,1800,167,9900,11700,"Sub-basin 6"
836,300,10,3400,3700,"Sub-basin 6"
837,100,2,1800,1900,"Sub-basin 6"
838,500,43,700,1200,"Sub-basin 6"
839,4400,528,15700,20100,"Sub-basin 6"
840,1600,293,5700,7300,"Sub-basin 6"
841,500,40,5500,6000,"Sub-basin 6"
842,100,6,700,800,"Sub-basin 6"
843,100,1,300,400,"Sub-basin 6"
844,600,45,6900,7500,"Sub-basin 6"
845,200,7,100,300,"Sub-basin 6"
846,1900,228,9400,11300,"Sub-basin 6"
847,600,52,2000,2600,"Sub-basin 6"
848,3200,1068,7100,10300,"Sub-basin 6"
849,400,76,3900,4300,"Sub-basin 6"
850,100,2,1700,1800,"Sub-basin 6"
851,2200,277,8800,11000,"Sub-basin 6"
852,600,81,4600,5200,"Sub-basin 6"
853,300,20,1400,1700,"Sub-basin 6"
854,900,217,1400,2300,"Sub-basin 6"
855,1300,401,2900,4200,"Sub-basin 6"
856,400,31,3600,4000,"Sub-basin 6"
857,100,1,600,700,"Sub-basin 6"
858,1600,158,15000,16600,"Sub-basin 6"
859,4500,1392,8000,12500,"Sub-basin 6"
860,100,1,1100,1200,"Sub-basin 6"
861,400,78,3900,4300,"Sub-basin 6"
862,100,2,1500,1600,"Sub-basin 6"
863,7800,1743,22700,30500,"Sub-basin 6"
864,25900,12290,29300,55200,"Sub-basin 6"
865,17700,8946,19400,37100,"Sub-basin 6"
866,800,60,4300,5100,"Sub-basin 6"
867,1200,178,5000,6200,"Sub-basin 6"
868,100,4,300,400,"Sub-basin 6"
869,1200,186,5600,6800,"Sub-basin 6"
870,100,3,200,300,"Sub-basin 6"
871,500,36,2500,3000,"Sub-basin 6"
872,200,10,600,800,"Sub-basin 6"
873,400,19,3100,3500,"Sub-basin 6"
874,800,61,5800,6600,"Sub-basin 6"
875,1600,96,17300,18900,"Sub-basin 6"
876,400,27,1400,1800,"Sub-basin 6"
877,100,7,400,500,"Sub-basin 6"
878,2300,598,5300,7600,"Sub-basin 6"
879,500,29,7000,7500,"Sub-basin 6"
880,500,89,3900,4400,"Sub-basin 6"
881,100,1,100,200,"Sub-basin 6"
882,800,56,4500,5300,"Sub-basin 6"
883,400,31,3700,4100,"Sub-basin 6"
884,300,19,2000,2300,"Sub-basin 6"
885,100,3,1400,1500,"Sub-basin 6"
886,100,2,1700,1800,"Sub-basin 6"
887,300,16,3500,3800,"Sub-basin 6"
888,6200,1308,19400,25600,"Sub-basin 6"
889,1000,187,1800,2800,"Sub-basin 6"
890,4800,2233,7200,12000,"Sub-basin 6"
891,100,1,1600,1700,"Sub-basin 6"
892,1600,183,4400,6000,"Sub-basin 6"
893,400,28,1900,2300,"Sub-basin 6"
894,1500,241,9700,11200,"Sub-basin 6"
895,13400,3944,62600,76000,"Sub-basin 6"
896,200,15,1700,1900,"Sub-basin 6"
897,100,1,1000,1100,"Sub-basin 6"
898,100,1,1600,1700,"Sub-basin 6"
899,300,11,5800,6100,"Sub-basin 6"
900,900,111,4500,5400,"Sub-basin 6"
901,700,54,2200,2900,"Sub-basin 6"
902,300,6,3300,3600,"Sub-basin 6"
903,200,6,800,1000,"Sub-basin 6"
904,5900,1998,12400,18300,"Sub-basin 6"
905,3100,901,7200,10300,"Sub-basin 6"
906,3100,733,5700,8800,"Sub-basin 6"
907,6900,3809,19000,25900,"Sub-basin 6"
908,400,33,2600,3000,"Sub-basin 6"
909,1300,176,5600,6900,"Sub-basin 6"
910,400,13,3200,3600,"Sub-basin 6"
911,1300,176,5800,7100,"Sub-basin 6"
912,2100,377,11800,13900,"Sub-basin 6"
913,800,149,5100,5900,"Sub-basin 6"
914,4700,1270,18100,22800,"Sub-basin 6"
915,300,8,3400,3700,"Sub-basin 6"
916,100,2,900,1000,"Sub-basin 6"
917,200,6,1600,1800,"Sub-basin 6"
918,100,1,500,600,"Sub-basin 6"
919,100,2,1100,1200,"Sub-basin 6"
920,100,2,1300,1400,"Sub-basin 6"
921,200,5,2300,2500,"Sub-basin 6"
922,400,30,3200,3600,"Sub-basin 6"
923,800,140,7200,8000,"Sub-basin 6"
924,200,15,4200,4400,"Sub-basin 6"
925,300,7,3200,3500,"Sub-basin 6"
926,500,33,8900,9400,"Sub-basin 6"
927,1100,79,10700,11800,"Sub-basin 6"
928,100,2,900,1000,"Sub-basin 6"
929,900,193,4200,5100,"Sub-basin 6"
930,3900,604,11100,15000,"Sub-basin 6"
931,5800,1949,11100,16900,"Sub-basin 6"
932,400,23,4200,4600,"Sub-basin 6"
933,700,33,3900,4600,"Sub-basin 6"
934,11900,5039,14300,26200,"Sub-basin 6"
935,1100,98,8200,9300,"Sub-basin 6"
936,100,2,800,900,"Sub-basin 6"
937,1100,140,2100,3200,"Sub-basin 6"
938,5400,1755,16000,21400,"Sub-basin 6"
939,500,25,3900,4400,"Sub-basin 6"
940,2300,345,9600,11900,"Sub-basin 6"
941,800,49,1800,2600,"Sub-basin 6"
942,200,8,3800,4000,"Sub-basin 6"
943,700,46,5000,5700,"Sub-basin 6"
944,1200,87,6600,7800,"Sub-basin 6"
945,1300,146,4600,5900,"Sub-basin 6"
946,1200,130,7100,8300,"Sub-basin 6"
947,2200,281,8600,10800,"Sub-basin 6"
948,2400,513,7600,10000,"Sub-basin 6"
949,100,2,700,800,"Sub-basin 6"
950,2400,213,13800,16200,"Sub-basin 6"
951,300,5,3900,4200,"Sub-basin 6"
952,1400,150,3600,5000,"Sub-basin 6"
953,400,32,5600,6000,"Sub-basin 6"
954,100,7,2100,2200,"Sub-basin 6"
955,2300,1042,7500,9800,"Sub-basin 6"
956,200,4,3100,3300,"Sub-basin 6"
957,400,16,2400,2800,"Sub-basin 6"
958,1400,344,9600,11000,"Sub-basin 6"
959,600,45,5700,6300,"Sub-basin 6"
960,400,30,2600,3000,"Sub-basin 6"
961,900,83,2900,3800,"Sub-basin 6"
962,100,1,1700,1800,"Sub-basin 6"
963,400,27,4400,4800,"Sub-basin 6"
964,2100,316,11900,14000,"Sub-basin 6"
965,200,6,1900,2100,"Sub-basin 6"
966,1600,131,10500,12100,"Sub-basin 6"
967,100,4,1500,1600,"Sub-basin 6"
968,2500,308,14600,17100,"Sub-basin 6"
969,100,1,2400,2500,"Sub-basin 6"
970,200,2,600,800,"Sub-basin 6"
971,400,13,2300,2700,"Sub-basin 6"
972,1100,296,5700,6800,"Sub-basin 6"
973,2700,483,7500,10200,"Sub-basin 6"
974,100,1,800,900,"Sub-basin 6"
975,600,132,3100,3700,"Sub-basin 6"
976,600,82,2000,2600,"Sub-basin 6"
977,700,64,5300,6000,"Sub-basin 6"
978,300,14,4500,4800,"Sub-basin 6"
979,400,19,2300,2700,"Sub-basin 6"
980,100,2,800,900,"Sub-basin 6"
981,900,115,4500,5400,"Sub-basin 6"
982,100,1,1300,1400,"Sub-basin 6"
983,300,14,6200,6500,"Sub-basin 6"
984,700,83,4400,5100,"Sub-basin 6"
985,1700,110,10400,12100,"Sub-basin 6"
986,700,184,4600,5300,"Sub-basin 6"
987,1200,117,7500,8700,"Sub-basin 6"
988,600,56,3900,4500,"Sub-basin 6"
989,2300,749,5200,7500,"Sub-basin 6"
990,600,94,3100,3700,"Sub-basin 6"
991,2400,457,5500,7900,"Sub-basin 6"
992,8300,2405,20100,28400,"Sub-basin 6"
993,200,15,2500,2700,"Sub-basin 6"
994,400,29,2900,3300,"Sub-basin 6"
995,300,9,1500,1800,"Sub-basin 6"
996,1600,345,5100,6700,"Sub-basin 6"
997,500,63,4100,4600,"Sub-basin 6"
998,2500,279,10200,12700,"Sub-basin 6"
999,800,66,7000,7800,"Sub-basin 6"
1000,500,25,6800,7300,"Sub-basin 6"
1001,1400,135,9400,10800,"Sub-basin 6"
1002,800,115,4800,5600,"Sub-basin 6"
1003,100,6,500,600,"Sub-basin 6"
1004,900,138,6700,7600,"Sub-basin 6"
1005,400,94,400,800,"Sub-basin 6"
1006,4100,1079,5500,9600,"Sub-basin 6"
1007,7400,1595,17300,24700,"Sub-basin 6"
1008,3100,825,14000,17100,"Sub-basin 6"
1009,100,3,1300,1400,"Sub-basin 6"
1010,100,6,1700,1800,"Sub-basin 6"
1011,2000,353,10500,12500,"Sub-basin 6"
1012,2500,478,19300,21800,"Sub-basin 6"
1013,700,52,5900,6600,"Sub-basin 6"
1014,1800,921,2100,3900,"Sub-basin 6"
1015,1000,224,1700,2700,"Sub-basin 6"
1016,100,2,1900,2000,"Sub-basin 6"
1017,200,9,1700,1900,"Sub-basin 6"
1018,100,3,1100,1200,"Sub-basin 6"
1019,300,16,1800,2100,"Sub-basin 6"
1020,3700,421,22900,26600,"Sub-basin 6"
1021,100,2,800,900,"Sub-basin 6"
1022,400,18,2800,3200,"Sub-basin 6"
1023,29400,9493,79400,108800,"Sub-basin 6"
1024,1900,220,12400,14300,"Sub-basin 6"
1025,300,30,1800,2100,"Sub-basin 6"
1026,1900,399,2000,3900,"Sub-basin 6"
1027,900,144,5300,6200,"Sub-basin 6"
1028,100,2,1400,1500,"Sub-basin 6"
1029,3500,404,21800,25300,"Sub-basin 6"
1030,1100,71.37,9700,10800,"Sub-basin 6"
1031,100,1,2200,2300,"Sub-basin 6"
1032,200,16,1600,1800,"Sub-basin 6"
1033,1100,158,7200,8300,"Sub-basin 6"
1034,100,4,200,300,"Sub-basin 6"
1035,3700,1019,7900,11600,"Sub-basin 6"
1036,200,5,2300,2500,"Sub-basin 6"
1037,500,43,3500,4000,"Sub-basin 6"
1038,100,1,1200,1300,"Sub-basin 6"
1039,900,136,8300,9200,"Sub-basin 6"
1040,100,3,700,800,"Sub-basin 6"
1041,700,110,5700,6400,"Sub-basin 6"
1042,1000,125,7600,8600,"Sub-basin 6"
1043,2900,990,8400,11300,"Sub-basin 6"
1044,200,4,4100,4300,"Sub-basin 6"
1045,100,1,2000,2100,"Sub-basin 6"
1046,2300,651,4400,6700,"Sub-basin 6"
1047,1300,167,3200,4500,"Sub-basin 6"
1048,200,8,1000,1200,"Sub-basin 6"
1049,600,29,5100,5700,"Sub-basin 6"
1050,700,47,4300,5000,"Sub-basin 6"
1051,1000,215,3600,4600,"Sub-basin 6"
1052,1300,300,3600,4900,"Sub-basin 6"
1053,800,66,4200,5000,"Sub-basin 6"
1054,600,57,4700,5300,"Sub-basin 6"
1055,3100,1026,4300,7400,"Sub-basin 6"
1056,1800,674,4700,6500,"Sub-basin 6"
1057,500,32,4100,4600,"Sub-basin 6"
1058,1800,363,11800,13600,"Sub-basin 6"
1059,1100,62,6700,7800,"Sub-basin 6"
1060,400,18,3300,3700,"Sub-basin 6"
1061,900,54,10500,11400,"Sub-basin 6"
1062,1100,73,8400,9500,"Sub-basin 6"
1063,2400,402,10600,13000,"Sub-basin 6"
1064,1200,162,3600,4800,"Sub-basin 6"
1065,500,72,5000,5500,"Sub-basin 6"
1066,100,5,1900,2000,"Sub-basin 6"
1067,200,14,2000,2200,"Sub-basin 6"
1068,100,1,2500,2600,"Sub-basin 6"
1069,100,1,700,800,"Sub-basin 6"
1070,17600,4608,41500,59100,"Sub-basin 6"
1071,100,2,1400,1500,"Sub-basin 6"
1072,100,1,1200,1300,"Sub-basin 6"
1073,16600,3871,35600,52200,"Sub-basin 6"
1074,2000,494,7200,9200,"Sub-basin 6"
1075,100,6,2000,2100,"Sub-basin 6"
1076,1300,62,9900,11200,"Sub-basin 6"
1077,100,6,1000,1100,"Sub-basin 6"
1078,600,39,4000,4600,"Sub-basin 6"
1079,600,45,2900,3500,"Sub-basin 6"
1080,200,4,1500,1700,"Sub-basin 6"
1081,9600,2419,29200,38800,"Sub-basin 6"
1082,300,19,1900,2200,"Sub-basin 6"
1083,1300,116,6600,7900,"Sub-basin 6"
1084,600,25,5200,5800,"Sub-basin 6"
1085,100,1,1800,1900,"Sub-basin 6"
1086,700,88,5600,6300,"Sub-basin 6"
1087,500,35,3100,3600,"Sub-basin 6"
1088,400,14,1800,2200,"Sub-basin 6"
1089,800,69,2800,3600,"Sub-basin 6"
1090,3600,641,22400,26000,"Sub-basin 6"
1091,600,59,4300,4900,"Sub-basin 6"
1092,3300,242,25300,28600,"Sub-basin 6"
1093,3400,1420,5400,8800,"Sub-basin 6"
1094,400,21,2000,2400,"Sub-basin 6"
1095,1700,326,5500,7200,"Sub-basin 6"
1096,100,2,1500,1600,"Sub-basin 6"
1097,1700,244,14000,15700,"Sub-basin 6"
1098,1200,232,7000,8200,"Sub-basin 6"
1099,3100,1013,4000,7100,"Sub-basin 6"
1100,1100,49,10900,12000,"Sub-basin 6"
1101,200,7,2600,2800,"Sub-basin 6"
1102,1000,126,3600,4600,"Sub-basin 6"
1103,1200,115,6700,7900,"Sub-basin 6"
1104,600,168,3000,3600,"Sub-basin 6"
1105,2400,1161,3600,6000,"Sub-basin 6"
1106,10800,2887,30200,41000,"Sub-basin 6"
1107,1300,115,12300,13600,"Sub-basin 6"
1108,4100,922,16400,20500,"Sub-basin 6"
1109,1700,195,7300,9000,"Sub-basin 6"
1110,1300,240,6900,8200,"Sub-basin 6"
1111,100,2,500,600,"Sub-basin 6"
1112,300,21,2400,2700,"Sub-basin 6"
1113,700,81,4100,4800,"Sub-basin 6"
1114,500,31,5700,6200,"Sub-basin 6"
1115,400,17,3200,3600,"Sub-basin 6"
1116,2500,417,16700,19200,"Sub-basin 6"
1117,200,6,2400,2600,"Sub-basin 6"
1118,200,13,1800,2000,"Sub-basin 6"
1119,11100,2931,15700,26800,"Sub-basin 6"
1120,800,57,4200,5000,"Sub-basin 6"
1121,300,9,3400,3700,"Sub-basin 6"
1122,200,5,3200,3400,"Sub-basin 6"
1123,1800,125,14300,16100,"Sub-basin 6"
1124,1300,95,7900,9200,"Sub-basin 6"
1125,100,3,1800,1900,"Sub-basin 6"
1126,400,51,2000,2400,"Sub-basin 6"
1127,400,16,4000,4400,"Sub-basin 6"
1128,800,61,6000,6800,"Sub-basin 6"
1129,100,2,2200,2300,"Sub-basin 6"
1130,800,75,4300,5100,"Sub-basin 6"
1131,300,38,1400,1700,"Sub-basin 6"
1132,1500,420,9100,10600,"Sub-basin 6"
1133,700,45,5100,5800,"Sub-basin 6"
1134,200,3,1200,1400,"Sub-basin 6"
1135,100,1,1600,1700,"Sub-basin 6"
1136,1400,87,8800,10200,"Sub-basin 6"
1137,100,3,1800,1900,"Sub-basin 6"
1138,1900,407,8000,9900,"Sub-basin 6"
1139,1200,115,7100,8300,"Sub-basin 6"
1140,700,91,2100,2800,"Sub-basin 6"
1141,900,194,8500,9400,"Sub-basin 6"
1142,100,1,900,1000,"Sub-basin 6"
1143,1600,258,9900,11500,"Sub-basin 6"
1144,300,4,5800,6100,"Sub-basin 6"
1145,600,40,5000,5600,"Sub-basin 6"
1146,100,2,800,900,"Sub-basin 6"
1147,900,67,4400,5300,"Sub-basin 6"
1148,100,3,3000,3100,"Sub-basin 6"
1149,200,3,1700,1900,"Sub-basin 6"
1150,700,48,8600,9300,"Sub-basin 6"
1151,200,14,1000,1200,"Sub-basin 6"
1152,1300,241,4100,5400,"Sub-basin 6"
1153,100,1,1500,1600,"Sub-basin 6"
1154,100,1,3100,3200,"Sub-basin 6"
1155,800,81,2500,3300,"Sub-basin 6"
1156,800,37,9800,10600,"Sub-basin 6"
1157,500,22,1700,2200,"Sub-basin 6"
1158,200,5,3100,3300,"Sub-basin 6"
1159,1100,83,10900,12000,"Sub-basin 6"
1160,1100,67,8300,9400,"Sub-basin 6"
1161,1500,319,6200,7700,"Sub-basin 6"
1162,1000,75,10200,11200,"Sub-basin 6"
1163,100,6,2500,2600,"Sub-basin 6"
1164,17400,9162,15200,32600,"Sub-basin 6"
1165,200,8,2500,2700,"Sub-basin 6"
1166,100,2,1800,1900,"Sub-basin 6"
1167,500,50,5700,6200,"Sub-basin 6"
1168,900,44,15200,16100,"Sub-basin 6"
1169,300,12,3300,3600,"Sub-basin 6"
1170,300,20,1900,2200,"Sub-basin 6"
1171,8300,2258.16,21600,29900,"Sub-basin 6"
1172,1200,141,4300,5500,"Sub-basin 6"
1173,100,6,800,900,"Sub-basin 6"
1174,4100,398,17500,21600,"Sub-basin 6"
1175,100,1,1300,1400,"Sub-basin 6"
1176,600,75,2400,3000,"Sub-basin 6"
1177,900,267,2600,3500,"Sub-basin 6"
1178,400,18,4900,5300,"Sub-basin 6"
1179,1700,191,11100,12800,"Sub-basin 6"
1180,400,26,3200,3600,"Sub-basin 6"
1181,600,100,4800,5400,"Sub-basin 6"
1182,1700,121,9100,10800,"Sub-basin 6"
1183,100,2,1900,2000,"Sub-basin 6"
1184,200,2,2500,2700,"Sub-basin 6"
1185,1000,156,3500,4500,"Sub-basin 6"
1186,200,4,3200,3400,"Sub-basin 6"
1187,800,57,6200,7000,"Sub-basin 6"
1188,500,77,1800,2300,"Sub-basin 6"
1189,400,26,5400,5800,"Sub-basin 6"
1190,400,11,4600,5000,"Sub-basin 6"
1191,700,37,5100,5800,"Sub-basin 6"
1192,600,69,2200,2800,"Sub-basin 6"
1193,15900,4146.83,23700,39600,"Sub-basin 6"
1194,400,24,3900,4300,"Sub-basin 6"
1195,300,13,2700,3000,"Sub-basin 6"
1196,100,2,1800,1900,"Sub-basin 6"
1197,200,20,2200,2400,"Sub-basin 6"
1198,100,2,1600,1700,"Sub-basin 6"
1199,600,88,1700,2300,"Sub-basin 6"
1200,4500,1095,10700,15200,"Sub-basin 6"
1201,500,28,5600,6100,"Sub-basin 6"
1202,2600,429.17,9100,11700,"Sub-basin 6"
1203,1200,138,5600,6800,"Sub-basin 6"
1204,3300,413,22700,26000,"Sub-basin 6"
1205,100,1,2000,2100,"Sub-basin 6"
1206,6400,1111.5,40100,46500,"Sub-basin 6"
1207,300,28,2900,3200,"Sub-basin 6"
1208,3200,530,25800,29000,"Sub-basin 6"
1209,11400,2113,40200,51600,"Sub-basin 6"
1210,1600,203,6200,7800,"Sub-basin 6"
1211,600,30,6600,7200,"Sub-basin 6"
1212,8800,1006,30600,39400,"Sub-basin 6"
1213,300,10,1800,2100,"Sub-basin 6"
1214,300,22,3900,4200,"Sub-basin 6"
1215,800,179.5,2600,3400,"Sub-basin 6"
1216,200,6.84,1700,1900,"Sub-basin 6"
1217,200,3,2200,2400,"Sub-basin 6"
1218,400,26,4400,4800,"Sub-basin 6"
1219,300,15,2900,3200,"Sub-basin 6"
1220,1100,139,3800,4900,"Sub-basin 6"
1221,2600,192,21200,23800,"Sub-basin 6"
1222,1200,183,10400,11600,"Sub-basin 6"
1223,100,5,800,900,"Sub-basin 6"
1224,100,1,1600,1700,"Sub-basin 6"
1225,500,31,5000,5500,"Sub-basin 6"
1226,500,60,1700,2200,"Sub-basin 6"
1227,300,15,4000,4300,"Sub-basin 6"
1228,1000,189,6200,7200,"Sub-basin 6"
1229,1300,274,2300,3600,"Sub-basin 6"
1230,800,44,3800,4600,"Sub-basin 6"
1231,1200,139,4000,5200,"Sub-basin 6"
1232,700,31,7900,8600,"Sub-basin 6"
1233,1500,203,5800,7300,"Sub-basin 6"
1234,800,63,2500,3300,"Sub-basin 6"
1235,600,36,5100,5700,"Sub-basin 6"
1236,300,43,4200,4500,"Sub-basin 6"
1237,200,13,1200,1400,"Sub-basin 6"
1238,900,54,6500,7400,"Sub-basin 6"
1239,800,23,6000,6800,"Sub-basin 6"
1240,700,146,3600,4300,"Sub-basin 6"
1241,600,8,7600,8200,"Sub-basin 6"
1242,900,45,9200,10100,"Sub-basin 6"
1243,100,14,1100,1200,"Sub-basin 6"
1244,500,20,5200,5700,"Sub-basin 6"
1245,200,6,2000,2200,"Sub-basin 6"
1246,300,13,3700,4000,"Sub-basin 6"
1247,1200,488,3700,4900,"Sub-basin 6"
1248,100,4,1400,1500,"Sub-basin 6"
1249,600,36,4000,4600,"Sub-basin 6"
1250,200,8,2800,3000,"Sub-basin 6"
1251,1200,131,13600,14800,"Sub-basin 6"
1252,600,65,3900,4500,"Sub-basin 6"
1253,1600,158,9600,11200,"Sub-basin 6"
1254,100,3,700,800,"Sub-basin 6"
1255,900,329,3900,4800,"Sub-basin 6"
1256,100,2,1500,1600,"Sub-basin 6"
1257,100,2,800,900,"Sub-basin 6"
1258,300,17,3700,4000,"Sub-basin 6"
1259,300,4,3700,4000,"Sub-basin 6"
1260,600,41,3400,4000,"Sub-basin 6"
1261,300,38,3200,3500,"Sub-basin 6"
1262,100,4,2200,2300,"Sub-basin 6"
1263,500,24,3600,4100,"Sub-basin 6"
1264,600,55,4100,4700,"Sub-basin 6"
1265,300,30,1400,1700,"Sub-basin 6"
1266,1800,431,3000,4800,"Sub-basin 6"
1267,2100,401,8200,10300,"Sub-basin 6"
1268,300,35,1500,1800,"Sub-basin 6"
1269,200,5,1200,1400,"Sub-basin 6"
1270,200,24,2300,2500,"Sub-basin 6"
1271,1700,151,8700,10400,"Sub-basin 6"
1272,2400,289,26300,28700,"Sub-basin 6"
1273,600,103,9000,9600,"Sub-basin 6"
1274,600,83,4000,4600,"Sub-basin 6"
1275,1500,279,3900,5400,"Sub-basin 6"
1276,3400,1236,7200,10600,"Sub-basin 6"
1277,1300,82,8000,9300,"Sub-basin 6"
1278,12100,5121,32000,44100,"Sub-basin 6"
1279,100,7,1200,1300,"Sub-basin 6"
1280,800,67,2700,3500,"Sub-basin 6"
1281,400,22,2800,3200,"Sub-basin 6"
1282,500,14,2100,2600,"Sub-basin 6"
1283,300,7,2300,2600,"Sub-basin 6"
1284,800,51,4700,5500,"Sub-basin 6"
1285,400,66,2400,2800,"Sub-basin 6"
1286,5100,824,28400,33500,"Sub-basin 6"
1287,100,1,500,600,"Sub-basin 6"
1288,7400,1219,40000,47400,"Sub-basin 6"
1289,1700,230,10400,12100,"Sub-basin 6"
1290,2300,361,9000,11300,"Sub-basin 6"
1291,200,6,2300,2500,"Sub-basin 6"
1292,200,4,2300,2500,"Sub-basin 6"
1293,100,2,1000,1100,"Sub-basin 6"
1294,1800,252,3700,5500,"Sub-basin 6"
1295,800,68,3800,4600,"Sub-basin 6"
1296,200,13,1500,1700,"Sub-basin 6"
1297,300,12,3400,3700,"Sub-basin 6"
1298,600,26,4000,4600,"Sub-basin 6"
1299,1100,80,5100,6200,"Sub-basin 6"
1300,1400,166,7500,8900,"Sub-basin 6"
1301,200,9,700,900,"Sub-basin 6"
1302,400,18,3800,4200,"Sub-basin 6"
1303,700,164,3000,3700,"Sub-basin 6"
1304,1800,80,8900,10700,"Sub-basin 6"
1305,200,7,2700,2900,"Sub-basin 6"
1306,900,116,5100,6000,"Sub-basin 6"
1307,1700,156,8800,10500,"Sub-basin 6"
1308,600,46,3500,4100,"Sub-basin 6"
1309,1200,85,7700,8900,"Sub-basin 6"
1310,200,12,2100,2300,"Sub-basin 6"
1311,2100,197,11700,13800,"Sub-basin 6"
1312,4500,636,12800,17300,"Sub-basin 6"
1313,200,15,2200,2400,"Sub-basin 6"
1314,1100,74,5500,6600,"Sub-basin 6"
1315,1500,156,7800,9300,"Sub-basin 6"
1316,700,52,11400,12100,"Sub-basin 6"
1317,10200,2651,38100,48300,"Sub-basin 6"
1318,6200,1009,21100,27300,"Sub-basin 6"
1319,200,17,1100,1300,"Sub-basin 6"
1320,300,9,1000,1300,"Sub-basin 6"
1321,1700,537,6100,7800,"Sub-basin 6"
1322,500,41,3200,3700,"Sub-basin 6"
1323,100,1,1100,1200,"Sub-basin 6"
1324,400,13,3100,3500,"Sub-basin 6"
1325,200,6,1800,2000,"Sub-basin 6"
1326,1000,85,4700,5700,"Sub-basin 6"
1327,2800,174,22300,25100,"Sub-basin 6"
1328,100,1,1100,1200,"Sub-basin 6"
1329,100,2,1000,1100,"Sub-basin 6"
1330,500,29,4100,4600,"Sub-basin 6"
1331,300,20,1900,2200,"Sub-basin 6"
1332,200,6,2000,2200,"Sub-basin 6"
1333,600,106,3000,3600,"Sub-basin 6"
1334,200,6,3000,3200,"Sub-basin 6"
1335,100,6,1200,1300,"Sub-basin 6"
1336,200,5,1000,1200,"Sub-basin 6"
1337,800,134,8600,9400,"Sub-basin 6"
1338,400,20,5200,5600,"Sub-basin 6"
1339,400,20,2300,2700,"Sub-basin 6"
1340,100,1,1100,1200,"Sub-basin 6"
1341,1200,151,6000,7200,"Sub-basin 6"
1342,500,38,1600,2100,"Sub-basin 6"
1343,2700,354,7700,10400,"Sub-basin 6"
1344,100,1,1200,1300,"Sub-basin 6"
1345,100,1,1500,1600,"Sub-basin 6"
1346,2200,217,19300,21500,"Sub-basin 6"
1347,2600,647,9000,11600,"Sub-basin 6"
1348,11500,5506,16200,27700,"Sub-basin 6"
1349,300,9,4200,4500,"Sub-basin 6"
1350,1500,145,5300,6800,"Sub-basin 6"
1351,7800,1573,27400,35200,"Sub-basin 6"
1352,200,10,2100,2300,"Sub-basin 6"
1353,600,82,6800,7400,"Sub-basin 6"
1354,7400,1911,41200,48600,"Sub-basin 6"
1355,500,88,3500,4000,"Sub-basin 6"
1356,8400,2972,23900,32300,"Sub-basin 6"
1357,100,1,800,900,"Sub-basin 6"
1358,2700,446,15200,17900,"Sub-basin 6"
1359,600,120,6500,7100,"Sub-basin 6"
1360,200,10,2300,2500,"Sub-basin 6"
1361,2400,433,10700,13100,"Sub-basin 6"
1362,100,6,1100,1200,"Sub-basin 6"
1363,200,27,1600,1800,"Sub-basin 6"
1364,8200,405,19300,27500,"Sub-basin 6"
1365,500,100,4000,4500,"Sub-basin 6"
1366,300,27,2100,2400,"Sub-basin 6"
1367,2200,393,10800,13000,"Sub-basin 6"
1368,1300,88,10600,11900,"Sub-basin 6"
1369,100,1,1800,1900,"Sub-basin 6"
1370,300,18,2300,2600,"Sub-basin 6"
1371,1200,92,5800,7000,"Sub-basin 6"
1372,100,2,1900,2000,"Sub-basin 6"
1373,200,16,1400,1600,"Sub-basin 6"
1374,500,150,3400,3900,"Sub-basin 6"
1375,20900,5008,101400,122300,"Sub-basin 6"
1376,100,1,1400,1500,"Sub-basin 6"
1377,8300,2714,17500,25800,"Sub-basin 6"
1378,100,5,1300,1400,"Sub-basin 6"
1379,100,1,1100,1200,"Sub-basin 6"
1380,600,84,3900,4500,"Sub-basin 6"
1381,100,1,1100,1200,"Sub-basin 6"
1382,700,39,3100,3800,"Sub-basin 6"
1383,1200,243,5300,6500,"Sub-basin 6"
1384,200,5,2500,2700,"Sub-basin 6"
1385,100,4,1000,1100,"Sub-basin 6"
1386,1000,119,5600,6600,"Sub-basin 6"
1387,1300,124,5200,6500,"Sub-basin 6"
1388,200,11,1000,1200,"Sub-basin 6"
1389,1100,230,7900,9000,"Sub-basin 6"
1390,100,1,1100,1200,"Sub-basin 6"
1391,100,1,1000,1100,"Sub-basin 6"
1392,1100,64,8400,9500,"Sub-basin 6"
1393,200,2,1800,2000,"Sub-basin 6"
1394,500,46,1800,2300,"Sub-basin 6"
1395,2200,482,5600,7800,"Sub-basin 6"
1396,100,3,900,1000,"Sub-basin 6"
1397,7000,802,44800,51800,"Sub-basin 6"
1398,300,16,1800,2100,"Sub-basin 6"
1399,200,9,1100,1300,"Sub-basin 6"
1400,8200,1247,24500,32700,"Sub-basin 6"
1401,600,58,600,1200,"Sub-basin 6"
1402,2000,347,8400,10400,"Sub-basin 6"
1403,100,1,2700,2800,"Sub-basin 6"
1404,600,25,3000,3600,"Sub-basin 6"
1405,100,1,1700,1800,"Sub-basin 6"
1406,400,26,2300,2700,"Sub-basin 6"
1407,800,116,6100,6900,"Sub-basin 6"
1408,100,3,1600,1700,"Sub-basin 6"
1409,2300,433,11500,13800,"Sub-basin 6"
1410,1000,131,2300,3300,"Sub-basin 6"
1411,200,7,2100,2300,"Sub-basin 6"
1412,800,153,3700,4500,"Sub-basin 6"
1413,400,123,4100,4500,"Sub-basin 6"
1414,500,126,2000,2500,"Sub-basin 6"
1415,100,5,1100,1200,"Sub-basin 6"
1416,11800,4443,12600,24400,"Sub-basin 6"
1417,100,2,1200,1300,"Sub-basin 6"
1418,700,86,3800,4500,"Sub-basin 6"
1419,300,42,5100,5400,"Sub-basin 6"
1420,300,50,4500,4800,"Sub-basin 6"
1421,100,1,2000,2100,"Sub-basin 6"
1422,200,9,1000,1200,"Sub-basin 6"
1423,100,2,1200,1300,"Sub-basin 6"
1424,600,135,4500,5100,"Sub-basin 6"
1425,200,9,1500,1700,"Sub-basin 6"
1426,100,2,1800,1900,"Sub-basin 6"
1427,700,112,3500,4200,"Sub-basin 6"
1428,1200,50,13100,14300,"Sub-basin 6"
1429,100,12,1000,1100,"Sub-basin 6"
1430,100,2,1700,1800,"Sub-basin 6"
1431,100,2,2500,2600,"Sub-basin 6"
1432,1300,118,8600,9900,"Sub-basin 6"
1433,4000,421,14100,18100,"Sub-basin 6"
1434,400,45,3600,4000,"Sub-basin 6"
1435,400,59,4500,4900,"Sub-basin 6"
1436,100,4,1500,1600,"Sub-basin 6"
1437,100,1,1100,1200,"Sub-basin 6"
1438,500,26,4200,4700,"Sub-basin 6"
1439,300,11,4600,4900,"Sub-basin 6"
1440,100,2,3200,3300,"Sub-basin 6"
1441,100,1,600,700,"Sub-basin 6"
1442,100,2,500,600,"Sub-basin 6"
1443,300,13,4300,4600,"Sub-basin 6"
1444,100,7,1600,1700,"Sub-basin 6"
1445,100,1,500,600,"Sub-basin 6"
1446,2200,604,5800,8000,"Sub-basin 6"
1447,300,15,5000,5300,"Sub-basin 6"
1448,1400,236,5700,7100,"Sub-basin 6"
1449,100,2,2300,2400,"Sub-basin 6"
1450,600,24,5600,6200,"Sub-basin 6"
1451,1300,253,4400,5700,"Sub-basin 6"
1452,100,1,1200,1300,"Sub-basin 6"
1453,100,2,1600,1700,"Sub-basin 6"
1454,600,82,2400,3000,"Sub-basin 6"
1455,1800,203,11900,13700,"Sub-basin 6"
1456,1200,495,800,2000,"Sub-basin 6"
1457,1500,207,6700,8200,"Sub-basin 6"
1458,300,21,2300,2600,"Sub-basin 6"
1459,700,17,8700,9400,"Sub-basin 6"
1460,1200,106,12100,13300,"Sub-basin 6"
1461,400,16,2900,3300,"Sub-basin 6"
1462,100,2,1700,1800,"Sub-basin 6"
1463,300,17,3200,3500,"Sub-basin 6"
1464,4400,599,30000,34400,"Sub-basin 6"
1465,900,137,6600,7500,"Sub-basin 6"
1466,1800,333,5100,6900,"Sub-basin 6"
1467,400,11,7900,8300,"Sub-basin 6"
1468,300,6,2200,2500,"Sub-basin 6"
1469,600,34,6000,6600,"Sub-basin 6"
1470,200,5,2300,2500,"Sub-basin 6"
1471,100,1,1300,1400,"Sub-basin 6"
1472,100,1,900,1000,"Sub-basin 6"
1473,400,12,1400,1800,"Sub-basin 6"
1474,300,13,1200,1500,"Sub-basin 6"
1475,200,4,4300,4500,"Sub-basin 6"
1476,400,11,2700,3100,"Sub-basin 6"
1477,3200,400.33,16000,19200,"Sub-basin 6"
1478,700,34,5800,6500,"Sub-basin 6"
1479,4300,1063,16300,20600,"Sub-basin 6"
1480,100,7,500,600,"Sub-basin 6"
1481,100,1,1700,1800,"Sub-basin 6"
1482,500,25,5400,5900,"Sub-basin 6"
1483,100,1,800,900,"Sub-basin 6"
1484,400,16,6000,6400,"Sub-basin 6"
1485,100,2,3300,3400,"Sub-basin 6"
1486,100,3,700,800,"Sub-basin 6"
1487,100,1,1000,1100,"Sub-basin 6"
1488,900,34,8900,9800,"Sub-basin 6"
1489,200,4,1900,2100,"Sub-basin 6"
1490,2300,613,8600,10900,"Sub-basin 6"
1491,800,161,1600,2400,"Sub-basin 6"
1492,1100,81,6000,7100,"Sub-basin 6"
1493,700,74,6600,7300,"Sub-basin 6"
1494,900,142,6200,7100,"Sub-basin 6"
1495,200,10,2400,2600,"Sub-basin 6"
1496,5300,1420,15700,21000,"Sub-basin 6"
1497,500,61,1400,1900,"Sub-basin 6"
1498,600,75,1300,1900,"Sub-basin 6"
1499,1100,147,1600,2700,"Sub-basin 6"
1500,300,11,6200,6500,"Sub-basin 6"
1501,400,17,3300,3700,"Sub-basin 6"
1502,600,194,3600,4200,"Sub-basin 6"
1503,5600,952,25800,31400,"Sub-basin 6"
1504,100,2,700,800,"Sub-basin 6"
1505,100,9,1300,1400,"Sub-basin 6"
1506,300,19,4400,4700,"Sub-basin 6"
1507,1600,255,8700,10300,"Sub-basin 6"
1508,700,33,3700,4400,"Sub-basin 6"
1509,100,1,900,1000,"Sub-basin 6"
1510,100,2,2800,2900,"Sub-basin 6"
1511,100,7,1600,1700,"Sub-basin 6"
1512,10300,2449,33100,43400,"Sub-basin 6"
1513,1000,74,8900,9900,"Sub-basin 6"
1514,100,1,2000,2100,"Sub-basin 6"
1515,100,1,1100,1200,"Sub-basin 6"
1516,200,8,1300,1500,"Sub-basin 6"
1517,400,115,2200,2600,"Sub-basin 6"
1518,100,1,1700,1800,"Sub-basin 6"
1519,300,9,3800,4100,"Sub-basin 6"
1520,600,59,2600,3200,"Sub-basin 6"
1521,200,9,3000,3200,"Sub-basin 6"
1522,200,4,500,700,"Sub-basin 6"
1523,13900,5474,15600,29500,"Sub-basin 6"
1524,2200,749,3900,6100,"Sub-basin 6"
1525,100,37,1000,1100,"Sub-basin 6"
1526,400,18,3200,3600,"Sub-basin 6"
1527,1300,196,5300,6600,"Sub-basin 6"
1528,16900,3029,41100,58000,"Sub-basin 6"
1529,100,6,1700,1800,"Sub-basin 6"
1530,100,3,2300,2400,"Sub-basin 6"
1531,300,30,3000,3300,"Sub-basin 6"
1532,100,1,2000,2100,"Sub-basin 6"
1533,5000,1187,15000,20000,"Sub-basin 6"
1534,2100,1070,3800,5900,"Sub-basin 6"
1535,100,5,2900,3000,"Sub-basin 6"
1536,100,2,2200,2300,"Sub-basin 6"
1537,100,1,1700,1800,"Sub-basin 6"
1538,100,1,1100,1200,"Sub-basin 6"
1539,1600,176,12500,14100,"Sub-basin 6"
1540,100,3,2200,2300,"Sub-basin 6"
1541,400,96,2500,2900,"Sub-basin 6"
1542,400,47,2500,2900,"Sub-basin 6"
1543,300,53,3000,3300,"Sub-basin 6"
1544,500,18,3900,4400,"Sub-basin 6"
1545,900,43,10200,11100,"Sub-basin 6"
1546,400,31,3600,4000,"Sub-basin 6"
1547,100,5,2500,2600,"Sub-basin 6"
1548,400,85,2600,3000,"Sub-basin 6"
1549,1700,739,5900,7600,"Sub-basin 6"
1550,400,57,1500,1900,"Sub-basin 6"
1551,100,2,1500,1600,"Sub-basin 6"
1552,300,11,2800,3100,"Sub-basin 6"
1553,100,1,2900,3000,"Sub-basin 6"
1554,1900,136,5500,7400,"Sub-basin 6"
1555,400,59,5300,5700,"Sub-basin 6"
1556,100,1,3200,3300,"Sub-basin 6"
1557,100,1,1000,1100,"Sub-basin 6"
1558,200,5,1700,1900,"Sub-basin 6"
1559,200,7,3000,3200,"Sub-basin 6"
1560,500,18,2000,2500,"Sub-basin 6"
1561,1200,298,5600,6800,"Sub-basin 6"
1562,400,23,5300,5700,"Sub-basin 6"
1563,6000,2025,12800,18800,"Sub-basin 6"
1564,1000,110,3600,4600,"Sub-basin 6"
1565,4000,476,12700,16700,"Sub-basin 6"
1566,200,4,500,700,"Sub-basin 6"
1567,300,21,1200,1500,"Sub-basin 6"
1568,200,4,1200,1400,"Sub-basin 6"
1569,800,112,8500,9300,"Sub-basin 6"
1570,400,92,3300,3700,"Sub-basin 6"
1571,25700,7812,34900,60600,"Sub-basin 6"
1572,200,24,600,800,"Sub-basin 6"
1573,500,150,2400,2900,"Sub-basin 6"
1574,200,8,1100,1300,"Sub-basin 6"
1575,200,7,2500,2700,"Sub-basin 6"
1576,2900,1012,7700,10600,"Sub-basin 6"
1577,400,15,5900,6300,"Sub-basin 6"
1578,7900,844,44200,52100,"Sub-basin 6"
1579,2700,540,9600,12300,"Sub-basin 6"
1580,100,1,300,400,"Sub-basin 6"
1581,3500,775,12200,15700,"Sub-basin 6"
1582,2200,252,8400,10600,"Sub-basin 6"
1583,700,85,9100,9800,"Sub-basin 6"
1584,100,2,1900,2000,"Sub-basin 6"
1585,400,11,3600,4000,"Sub-basin 6"
1586,100,4,2300,2400,"Sub-basin 6"
1587,500,30,3500,4000,"Sub-basin 6"
1588,100,3,800,900,"Sub-basin 6"
1589,23000,12079,26900,49900,"Sub-basin 6"
1590,1300,95,10100,11400,"Sub-basin 6"
1591,100,2,500,600,"Sub-basin 6"
1592,3800,800,10000,13800,"Sub-basin 6"
1593,1800,174,4900,6700,"Sub-basin 6"
1594,21900,1842,55700,77600,"Sub-basin 6"
1595,800,93,4100,4900,"Sub-basin 6"
1596,700,42,4400,5100,"Sub-basin 6"
1597,100,5,1400,1500,"Sub-basin 6"
1598,100,3,1900,2000,"Sub-basin 6"
1599,100,2,1100,1200,"Sub-basin 6"
1600,200,11,3800,4000,"Sub-basin 6"
1601,5000,899,27400,32400,"Sub-basin 6"
1602,4900,1311,31300,36200,"Sub-basin 6"
1603,200,8,800,1000,"Sub-basin 6"
1604,500,102,8600,9100,"Sub-basin 6"
1605,900,154,5400,6300,"Sub-basin 6"
1606,100,5,1400,1500,"Sub-basin 6"
1607,200,12,1300,1500,"Sub-basin 6"
1608,100,1,900,1000,"Sub-basin 6"
1609,1300,136,8500,9800,"Sub-basin 6"
1610,7400,415,39200,46600,"Sub-basin 6"
1611,200,5,3000,3200,"Sub-basin 6"
1612,1100,85,13600,14700,"Sub-basin 6"
1613,100,4,2500,2600,"Sub-basin 6"
1614,300,12,6600,6900,"Sub-basin 6"
1615,400,11,7000,7400,"Sub-basin 6"
1616,400,50,3600,4000,"Sub-basin 6"
1617,900,110,3700,4600,"Sub-basin 6"
1618,100,2,1900,2000,"Sub-basin 6"
1619,700,133,13700,14400,"Sub-basin 6"
1620,100,4,900,1000,"Sub-basin 6"
1621,2700,378,8200,10900,"Sub-basin 6"
1622,200,2,2700,2900,"Sub-basin 6"
1623,900,83,5300,6200,"Sub-basin 6"
1624,300,6,4400,4700,"Sub-basin 6"
1625,200,14,2900,3100,"Sub-basin 6"
1626,400,43,8400,8800,"Sub-basin 6"
1627,100,1,900,1000,"Sub-basin 6"
1628,100,1,1200,1300,"Sub-basin 6"
1629,100,4,1200,1300,"Sub-basin 6"
1630,200,10,1600,1800,"Sub-basin 6"
1631,1100,167,4800,5900,"Sub-basin 6"
1632,1400,179,6600,8000,"Sub-basin 6"
1633,1500,131,4200,5700,"Sub-basin 6"
1634,900,115,6000,6900,"Sub-basin 6"
1635,2200,755,6400,8600,"Sub-basin 6"
1636,600,105,2500,3100,"Sub-basin 6"
1637,100,9,2100,2200,"Sub-basin 6"
1638,2400,449,13000,15400,"Sub-basin 6"
1639,400,78,4600,5000,"Sub-basin 6"
1640,700,145,8500,9200,"Sub-basin 6"
1641,200,3,900,1100,"Sub-basin 6"
1642,600,41,4300,4900,"Sub-basin 6"
1643,700,111,2300,3000,"Sub-basin 6"
1644,4700,607,26700,31400,"Sub-basin 6"
1645,100,1,600,700,"Sub-basin 6"
1646,500,27,2400,2900,"Sub-basin 6"
1647,300,5,2000,2300,"Sub-basin 6"
1648,6100,794,17300,23400,"Sub-basin 6"
1649,600,65,4700,5300,"Sub-basin 6"
1650,1800,605,7300,9100,"Sub-basin 6"
1651,1300,98,14200,15500,"Sub-basin 6"
1652,100,1,2700,2800,"Sub-basin 6"
1653,300,12,1300,1600,"Sub-basin 6"
1654,12700,6309,14600,27300,"Sub-basin 6"
1655,1000,185,2200,3200,"Sub-basin 6"
1656,500,69,1300,1800,"Sub-basin 6"
1657,600,37,4700,5300,"Sub-basin 6"
1658,400,23,3100,3500,"Sub-basin 6"
1659,600,108,3200,3800,"Sub-basin 6"
1660,400,83,2800,3200,"Sub-basin 6"
1661,800,54,4100,4900,"Sub-basin 6"
1662,200,13,2900,3100,"Sub-basin 6"
1663,100,4,1200,1300,"Sub-basin 6"
1664,2200,953,8400,10600,"Sub-basin 6"
1665,300,35,2300,2600,"Sub-basin 6"
1666,100,1,1600,1700,"Sub-basin 6"
1667,100,2,1100,1200,"Sub-basin 6"
1668,2100,344,10900,13000,"Sub-basin 6"
1669,1700,713,3500,5200,"Sub-basin 6"
1670,2100,564,4100,6200,"Sub-basin 6"
1671,2300,647,4100,6400,"Sub-basin 6"
1672,100,3,1100,1200,"Sub-basin 6"
1673,100,2,800,900,"Sub-basin 6"
1674,100,29,3900,4000,"Sub-basin 6"
1675,100,1,900,1000,"Sub-basin 6"
1676,4400,2166,12700,17100,"Sub-basin 6"
1677,200,6,3700,3900,"Sub-basin 6"
1678,200,15,900,1100,"Sub-basin 6"
1679,4200,1106,11300,15500,"Sub-basin 6"
1680,900,190,6200,7100,"Sub-basin 6"
1681,400,96,1200,1600,"Sub-basin 6"
1682,200,9,3300,3500,"Sub-basin 6"
1683,1800,251,5700,7500,"Sub-basin 6"
1684,300,14,1300,1600,"Sub-basin 6"
1685,800,67,5400,6200,"Sub-basin 6"
1686,18500,5231,68600,87100,"Sub-basin 6"
1687,1200,429,2000,3200,"Sub-basin 6"
1688,200,17,800,1000,"Sub-basin 6"
1689,800,30,6500,7300,"Sub-basin 6"
1690,100,2,400,500,"Sub-basin 6"
1691,300,21,3900,4200,"Sub-basin 6"
1692,2700,523,16200,18900,"Sub-basin 6"
1693,400,14,2900,3300,"Sub-basin 6"
1694,400,13,1200,1600,"Sub-basin 6"
1695,100,3,900,1000,"Sub-basin 6"
1696,700,133,4900,5600,"Sub-basin 6"
1697,2800,528,15600,18400,"Sub-basin 6"
1698,100,1,2500,2600,"Sub-basin 6"
1699,500,17,3100,3600,"Sub-basin 6"
1700,2900,329,24200,27100,"Sub-basin 6"
1701,1900,179,10700,12600,"Sub-basin 6"
1702,100,2,1600,1700,"Sub-basin 6"
1703,100,1,1600,1700,"Sub-basin 6"
1704,100,3,1500,1600,"Sub-basin 6"
1705,100,6,1300,1400,"Sub-basin 6"
1706,200,4,2300,2500,"Sub-basin 6"
1707,1900,434,6500,8400,"Sub-basin 6"
1708,1600,113,6100,7700,"Sub-basin 6"
1709,900,56,4800,5700,"Sub-basin 6"
1710,100,1,1400,1500,"Sub-basin 6"
1711,300,32,2000,2300,"Sub-basin 6"
1712,1100,290,2200,3300,"Sub-basin 6"
1713,600,58,6400,7000,"Sub-basin 6"
1714,1400,216,5700,7100,"Sub-basin 6"
1715,2200,380,5700,7900,"Sub-basin 6"
1716,600,38,5500,6100,"Sub-basin 6"
1717,500,12,9400,9900,"Sub-basin 6"
1718,300,27,3000,3300,"Sub-basin 6"
1719,200,12,1000,1200,"Sub-basin 6"
1720,1000,182,4400,5400,"Sub-basin 6"
1721,200,5,2200,2400,"Sub-basin 6"
1722,200,5,2000,2200,"Sub-basin 6"
1723,100,18,500,600,"Sub-basin 6"
1724,100,1,600,700,"Sub-basin 6"
1725,100,4,700,800,"Sub-basin 6"
1726,1700,348,4200,5900,"Sub-basin 6"
1727,100,6,600,700,"Sub-basin 6"
1728,700,100,2000,2700,"Sub-basin 6"
1729,100,5,700,800,"Sub-basin 6"
1730,1300,303,6700,8000,"Sub-basin 6"
1731,1000,396,2700,3700,"Sub-basin 6"
1732,600,200,3200,3800,"Sub-basin 6"
1733,100,4,2200,2300,"Sub-basin 6"
1734,100,1,1800,1900,"Sub-basin 6"
1735,1400,223,7200,8600,"Sub-basin 6"
1736,100,3,1900,2000,"Sub-basin 6"
1737,2400,410,12200,14600,"Sub-basin 6"
1738,300,25,900,1200,"Sub-basin 6"
1739,1100,308,4200,5300,"Sub-basin 6"
1740,700,50,3100,3800,"Sub-basin 6"
1741,1000,236,4500,5500,"Sub-basin 6"
1742,100,2,2000,2100,"Sub-basin 6"
1743,200,5,2400,2600,"Sub-basin 6"
1744,100,1,1900,2000,"Sub-basin 6"
1745,600,85,2000,2600,"Sub-basin 6"
1746,10400,5026,11500,21900,"Sub-basin 6"
1747,700,239,2100,2800,"Sub-basin 6"
1748,100,1,900,1000,"Sub-basin 6"
1749,700,85,6900,7600,"Sub-basin 6"
1750,1700,166,11600,13300,"Sub-basin 6"
1751,100,6,1300,1400,"Sub-basin 6"
1752,5600,1531,34200,39800,"Sub-basin 6"
1753,100,8,1000,1100,"Sub-basin 6"
1754,400,17,1900,2300,"Sub-basin 6"
1755,100,1,1100,1200,"Sub-basin 6"
1756,300,9,2100,2400,"Sub-basin 6"
1757,2800,779,5600,8400,"Sub-basin 6"
1758,800,147,2200,3000,"Sub-basin 6"
1759,11000,1269,33300,44300,"Sub-basin 6"
1760,2600,215,19100,21700,"Sub-basin 6"
1761,200,14,100,300,"Sub-basin 6"
1762,100,2,400,500,"Sub-basin 6"
1763,800,140,3600,4400,"Sub-basin 6"
1764,500,34,6500,7000,"Sub-basin 6"
1765,1000,179,5300,6300,"Sub-basin 6"
1766,100,2,1800,1900,"Sub-basin 6"
1767,100,3,1500,1600,"Sub-basin 6"
1768,100,5,3100,3200,"Sub-basin 6"
1769,5000,406,28700,33700,"Sub-basin 6"
1770,400,17,3400,3800,"Sub-basin 6"
1771,700,57,4100,4800,"Sub-basin 6"
1772,1300,141,5700,7000,"Sub-basin 6"
1773,600,165,5600,6200,"Sub-basin 6"
1774,1900,330,13700,15600,"Sub-basin 6"
1775,400,42,1200,1600,"Sub-basin 6"
1776,3300,386,23300,26600,"Sub-basin 6"
1777,100,5,1400,1500,"Sub-basin 6"
1778,5100,2367,7400,12500,"Sub-basin 6"
1779,400,37,1800,2200,"Sub-basin 6"
1780,1000,114,6200,7200,"Sub-basin 6"
1781,2200,470,8800,11000,"Sub-basin 6"
1782,300,4,5300,5600,"Sub-basin 6"
1783,100,1,600,700,"Sub-basin 6"
1784,1800,158,7700,9500,"Sub-basin 6"
1785,100,1,300,400,"Sub-basin 6"
1786,7100,2496,13500,20600,"Sub-basin 6"
1787,8400,2284,20900,29300,"Sub-basin 6"
1788,2300,748,8300,10600,"Sub-basin 6"
1789,100,1,1100,1200,"Sub-basin 6"
1790,100,1,1600,1700,"Sub-basin 6"
1791,300,8,5500,5800,"Sub-basin 6"
1792,100,1,2600,2700,"Sub-basin 6"
1793,500,12,5400,5900,"Sub-basin 6"
1794,400,16,3900,4300,"Sub-basin 6"
1795,500,8,15100,15600,"Sub-basin 6"
1796,600,26,3000,3600,"Sub-basin 6"
1797,5800,1776,20400,26200,"Sub-basin 6"
1798,100,1,500,600,"Sub-basin 6"
1799,1000,124,9100,10100,"Sub-basin 6"
1800,300,16,2900,3200,"Sub-basin 6"
1801,1000,256,2700,3700,"Sub-basin 6"
1802,100,1,900,1000,"Sub-basin 6"
1803,200,11,1500,1700,"Sub-basin 6"
1804,200,56,1300,1500,"Sub-basin 6"
1805,100,5,1900,2000,"Sub-basin 6"
1806,2800,784,6800,9600,"Sub-basin 6"
1807,3100,1058,6000,9100,"Sub-basin 6"
1808,200,4,3100,3300,"Sub-basin 6"
1809,14800,2886,45300,60100,"Sub-basin 6"
1810,200,5,800,1000,"Sub-basin 6"
1811,100,2,900,1000,"Sub-basin 6"
1812,100,3,2100,2200,"Sub-basin 6"
1813,900,32,5800,6700,"Sub-basin 6"
1814,4400,1474,8700,13100,"Sub-basin 6"
1815,400,12,900,1300,"Sub-basin 6"
1816,200,23,1700,1900,"Sub-basin 6"
1817,100,2,1300,1400,"Sub-basin 6"
1818,12200,3901.67,26400,38600,"Sub-basin 6"
1819,3300,1062,4100,7400,"Sub-basin 6"
1820,700,82,4800,5500,"Sub-basin 6"
1821,600,100,1900,2500,"Sub-basin 6"
1822,100,1,1400,1500,"Sub-basin 6"
1823,100,1,2200,2300,"Sub-basin 6"
1824,200,10,3300,3500,"Sub-basin 6"
1825,100,1,400,500,"Sub-basin 6"
1826,500,107.5,1500,2000,"Sub-basin 6"
1827,200,17,500,700,"Sub-basin 6"
1828,100,2,600,700,"Sub-basin 6"
1829,900,217,4900,5800,"Sub-basin 6"
1830,1800,400,4400,6200,"Sub-basin 6"
1831,1600,68,13600,15200,"Sub-basin 6"
1832,100,4,900,1000,"Sub-basin 6"
1833,1000,157,5700,6700,"Sub-basin 6"
1834,100,0.17,2100,2200,"Sub-basin 6"
1835,100,1,300,400,"Sub-basin 6"
1836,3900,533.83,15100,19000,"Sub-basin 6"
1837,100,3,2100,2200,"Sub-basin 6"
1838,700,46,6900,7600,"Sub-basin 6"
1839,100,1,1200,1300,"Sub-basin 6"
1840,800,229,2200,3000,"Sub-basin 6"
1841,3100,1050,5400,8500,"Sub-basin 6"
1842,400,47,3400,3800,"Sub-basin 6"
1843,200,2,1100,1300,"Sub-basin 6"
1844,300,16,1000,1300,"Sub-basin 6"
1845,400,69,3000,3400,"Sub-basin 6"
1846,800,95,5700,6500,"Sub-basin 6"
1847,600,31,7100,7700,"Sub-basin 6"
1848,100,1,500,600,"Sub-basin 6"
1849,2800,1310,5000,7800,"Sub-basin 6"
1850,800,134,3100,3900,"Sub-basin 6"
1851,100,1,900,1000,"Sub-basin 6"
1852,400,9,4100,4500,"Sub-basin 6"
1853,200,3,1500,1700,"Sub-basin 6"
1854,200,3,1300,1500,"Sub-basin 6"
1855,200,10,1800,2000,"Sub-basin 6"
1856,400,26,1800,2200,"Sub-basin 6"
1857,300,48,4200,4500,"Sub-basin 6"
1858,100,3,700,800,"Sub-basin 6"
1859,200,3,4700,4900,"Sub-basin 6"
1860,500,71,4000,4500,"Sub-basin 6"
1861,700,51,6300,7000,"Sub-basin 6"
1862,500,94,2300,2800,"Sub-basin 6"
1863,1300,373,4200,5500,"Sub-basin 6"
1864,800,76,2400,3200,"Sub-basin 6"
1865,1300,132,5400,6700,"Sub-basin 6"
1866,400,17,5500,5900,"Sub-basin 6"
1867,700,137,2900,3600,"Sub-basin 6"
1868,2200,857,2700,4900,"Sub-basin 6"
1869,200,14,1800,2000,"Sub-basin 6"
1870,200,7,800,1000,"Sub-basin 6"
1871,100,1,1300,1400,"Sub-basin 6"
1872,400,56,2500,2900,"Sub-basin 6"
1873,600,94,3500,4100,"Sub-basin 6"
1874,2200,786,4700,6900,"Sub-basin 6"
1875,1400,341,5500,6900,"Sub-basin 6"
1876,200,30,1800,2000,"Sub-basin 6"
1877,400,22,2900,3300,"Sub-basin 6"
1878,100,1,1300,1400,"Sub-basin 6"
1879,200,3,2300,2500,"Sub-basin 6"
1880,200,4.66,2500,2700,"Sub-basin 6"
1881,100,4,2300,2400,"Sub-basin 6"
1882,100,3,2700,2800,"Sub-basin 6"
1883,100,1,1100,1200,"Sub-basin 6"
1884,100,1,1900,2000,"Sub-basin 6"
1885,54900,11313,74500,129400,"Sub-basin 6"
1886,20000,5583,38100,58100,"Sub-basin 6"
1887,200,9,1300,1500,"Sub-basin 6"
1888,200,3,3500,3700,"Sub-basin 6"
1889,100,1,2300,2400,"Sub-basin 6"
1890,400,54,4200,4600,"Sub-basin 6"
1891,1400,314,4300,5700,"Sub-basin 6"
1892,600,78,3500,4100,"Sub-basin 6"
1893,1300,214,3700,5000,"Sub-basin 6"
1894,3900,985,10000,13900,"Sub-basin 6"
1895,200,9,2600,2800,"Sub-basin 6"
1896,700,53,5800,6500,"Sub-basin 6"
1897,100,1,600,700,"Sub-basin 6"
1898,100,1,1400,1500,"Sub-basin 6"
1899,200,6,1700,1900,"Sub-basin 6"
1900,100,5,800,900,"Sub-basin 6"
1901,900,176,2800,3700,"Sub-basin 6"
1902,600,37,2300,2900,"Sub-basin 6"
1903,300,25,1100,1400,"Sub-basin 6"
1904,500,68,3300,3800,"Sub-basin 6"
1905,2300,597,10300,12600,"Sub-basin 6"
1906,100,5,1500,1600,"Sub-basin 6"
1907,200,3,3200,3400,"Sub-basin 6"
1908,200,3,3000,3200,"Sub-basin 6"
1909,800,102,3600,4400,"Sub-basin 6"
1910,200,7,2800,3000,"Sub-basin 6"
1911,500,29,3200,3700,"Sub-basin 6"
1912,600,26,6000,6600,"Sub-basin 6"
1913,900,171,4600,5500,"Sub-basin 6"
1914,300,13,2600,2900,"Sub-basin 6"
1915,15300,3478,29000,44300,"Sub-basin 6"
1916,300,9,1800,2100,"Sub-basin 6"
1917,1400,140,7600,9000,"Sub-basin 6"
1918,1000,152,4400,5400,"Sub-basin 6"
1919,600,44,3300,3900,"Sub-basin 6"
1920,2800,454,14100,16900,"Sub-basin 6"
1921,100,4,700,800,"Sub-basin 6"
1922,100,1,3200,3300,"Sub-basin 6"
1923,5200,2226,6600,11800,"Sub-basin 6"
1924,1000,130,2600,3600,"Sub-basin 6"
1925,100,2,800,900,"Sub-basin 6"
1926,400,39,2800,3200,"Sub-basin 6"
1927,400,27,3000,3400,"Sub-basin 6"
1928,7200,1217,15500,22700,"Sub-basin 6"
1929,100,8,500,600,"Sub-basin 6"
1930,1700,521,7700,9400,"Sub-basin 6"
1931,1500,78,6200,7700,"Sub-basin 6"
1932,3100,918,17500,20600,"Sub-basin 6"
1933,200,19,3200,3400,"Sub-basin 6"
1934,600,60,4000,4600,"Sub-basin 6"
1935,1600,255,5400,7000,"Sub-basin 6"
1936,100,1,1300,1400,"Sub-basin 6"
1937,1000,100,6800,7800,"Sub-basin 6"
1938,100,15,700,800,"Sub-basin 6"
1939,600,99,2200,2800,"Sub-basin 6"
1940,600,94,5300,5900,"Sub-basin 6"
1941,100,2,700,800,"Sub-basin 6"
1942,100,3,2400,2500,"Sub-basin 6"
1943,3400,560,12600,16000,"Sub-basin 6"
1944,500,15,7500,8000,"Sub-basin 6"
1945,2600,692,17500,20100,"Sub-basin 6"
1946,700,38,3700,4400,"Sub-basin 6"
1947,100,3,400,500,"Sub-basin 6"
1948,1100,249,3200,4300,"Sub-basin 6"
1949,3500,340,21100,24600,"Sub-basin 6"
1950,100,4,1200,1300,"Sub-basin 6"
1951,400,26,2300,2700,"Sub-basin 6"
1952,3400,712,10100,13500,"Sub-basin 6"
1953,700,96,2000,2700,"Sub-basin 6"
1954,3200,1273,11900,15100,"Sub-basin 6"
1955,100,4,300,400,"Sub-basin 6"
1956,900,83,5100,6000,"Sub-basin 6"
1957,700,19,3900,4600,"Sub-basin 6"
1958,100,3,1500,1600,"Sub-basin 6"
1959,200,8,1500,1700,"Sub-basin 6"
1960,1700,365,6000,7700,"Sub-basin 6"
1961,1900,411,9600,11500,"Sub-basin 6"
1962,300,38,1200,1500,"Sub-basin 6"
1963,700,129,3700,4400,"Sub-basin 6"
1964,300,12,2600,2900,"Sub-basin 6"
1965,1000,245,3900,4900,"Sub-basin 6"
1966,100,5,1300,1400,"Sub-basin 6"
1967,200,15,3100,3300,"Sub-basin 6"
1968,4900,1448,6100,11000,"Sub-basin 6"
1969,1800,65,15200,17000,"Sub-basin 6"
1970,1500,129,16300,17800,"Sub-basin 6"
1971,100,3,2300,2400,"Sub-basin 6"
1972,700,144,7000,7700,"Sub-basin 6"
1973,400,41,3000,3400,"Sub-basin 6"
1974,1500,309,3800,5300,"Sub-basin 6"
1975,3600,623,17100,20700,"Sub-basin 6"
1976,400,14,5600,6000,"Sub-basin 6"
1977,10500,1321,28500,39000,"Sub-basin 6"
1978,800,130,3600,4400,"Sub-basin 6"
1979,100,2,600,700,"Sub-basin 6"
1980,500,37,5300,5800,"Sub-basin 6"
1981,1300,58,12300,13600,"Sub-basin 6"
1982,100,2,1300,1400,"Sub-basin 6"
1983,600,48,1300,1900,"Sub-basin 6"
1984,100,2,500,600,"Sub-basin 6"
1985,5400,1670,9700,15100,"Sub-basin 6"
1986,100,3,200,300,"Sub-basin 6"
1987,300,8,3000,3300,"Sub-basin 6"
1988,2700,500,11700,14400,"Sub-basin 6"
1989,100,2,500,600,"Sub-basin 6"
1990,100,1,1900,2000,"Sub-basin 6"
1991,600,65,5300,5900,"Sub-basin 6"
1992,8600,1393,26600,35200,"Sub-basin 6"
1993,200,3,1500,1700,"Sub-basin 6"
1994,3400,506,15000,18400,"Sub-basin 6"
1995,200,7,2100,2300,"Sub-basin 6"
1996,2400,480,6200,8600,"Sub-basin 6"
1997,500,30,1700,2200,"Sub-basin 6"
1998,200,7,3600,3800,"Sub-basin 6"
1999,200,21,2800,3000,"Sub-basin 6"
2000,5700,2768,11300,17000,"Sub-basin 6"
2001,2000,415,4000,6000,"Sub-basin 6"
2002,100,1,300,400,"Sub-basin 6"
2003,9500,1958,23300,32800,"Sub-basin 6"
2004,700,37,3700,4400,"Sub-basin 6"
2005,2200,250,10300,12500,"Sub-basin 6"
2006,300,26,1700,2000,"Sub-basin 6"
2007,200,4,3000,3200,"Sub-basin 6"
2008,100,1,1800,1900,"Sub-basin 6"
2009,1100,80,5300,6400,"Sub-basin 6"
2010,100,1,800,900,"Sub-basin 6"
2011,900,64,4200,5100,"Sub-basin 6"
2012,100,3,2200,2300,"Sub-basin 6"
2013,500,68,3600,4100,"Sub-basin 6"
2014,500,48,3300,3800,"Sub-basin 6"
2015,100,1,1400,1500,"Sub-basin 6"
2016,300,10,4900,5200,"Sub-basin 6"
2017,3000,804,6000,9000,"Sub-basin 6"
2018,7100,2783,23800,30900,"Sub-basin 6"
2019,1600,222,6500,8100,"Sub-basin 6"
2020,6300,1348,18200,24500,"Sub-basin 6"
2021,300,28,2100,2400,"Sub-basin 6"
2022,400,14,3000,3400,"Sub-basin 6"
2023,400,16,4500,4900,"Sub-basin 6"
2024,200,8,1200,1400,"Sub-basin 6"
2025,200,6,1800,2000,"Sub-basin 6"
2026,100,3,2100,2200,"Sub-basin 6"
2027,3600,195,34800,38400,"Sub-basin 6"
2028,100,5,1500,1600,"Sub-basin 6"
2029,900,107,3200,4100,"Sub-basin 6"
2030,500,68,3900,4400,"Sub-basin 6"
2031,100,6,2200,2300,"Sub-basin 6"
2032,100,1,1500,1600,"Sub-basin 6"
2033,400,10,4800,5200,"Sub-basin 6"
2034,700,118,2800,3500,"Sub-basin 6"
2035,500,127,5600,6100,"Sub-basin 6"
2036,200,11,1500,1700,"Sub-basin 6"
2037,100,2,1300,1400,"Sub-basin 6"
2038,100,3,400,500,"Sub-basin 6"
2039,9400,3203,20300,29700,"Sub-basin 6"
2040,100,5,1000,1100,"Sub-basin 6"
2041,100,1,1700,1800,"Sub-basin 6"
2042,600,142,4000,4600,"Sub-basin 6"
2043,2200,507,7300,9500,"Sub-basin 6"
2044,6300,2099,14400,20700,"Sub-basin 6"
2045,600,138,3700,4300,"Sub-basin 6"
2046,200,3,2100,2300,"Sub-basin 6"
2047,1800,622,3300,5100,"Sub-basin 6"
2048,400,12,2400,2800,"Sub-basin 6"
2049,1100,132,7200,8300,"Sub-basin 6"
2050,100,6,2500,2600,"Sub-basin 6"
2051,600,22,7000,7600,"Sub-basin 6"
2052,1500,60,18600,20100,"Sub-basin 6"
2053,1900,297,4600,6500,"Sub-basin 6"
2054,200,26,2600,2800,"Sub-basin 6"
2055,600,130,4000,4600,"Sub-basin 6"
2056,100,4,1200,1300,"Sub-basin 6"
2057,400,35,3000,3400,"Sub-basin 6"
2058,1500,49,9900,11400,"Sub-basin 6"
2059,100,2,1600,1700,"Sub-basin 6"
2060,100,5,1000,1100,"Sub-basin 6"
2061,700,183,3400,4100,"Sub-basin 6"
2062,100,1,1700,1800,"Sub-basin 6"
2063,200,2,2900,3100,"Sub-basin 6"
2064,7700,1935,13300,21000,"Sub-basin 6"
2065,200,3,2200,2400,"Sub-basin 6"
2066,3400,684,8900,12300,"Sub-basin 6"
2067,200,25,1400,1600,"Sub-basin 6"
2068,4300,1011,10700,15000,"Sub-basin 6"
2069,800,91,6500,7300,"Sub-basin 6"
2070,100,1,1600,1700,"Sub-basin 6"
2071,1500,200,3700,5200,"Sub-basin 6"
2072,4500,1704,8100,12600,"Sub-basin 6"
2073,300,60,2500,2800,"Sub-basin 6"
2074,2900,727,7100,10000,"Sub-basin 6"
2075,100,15,1200,1300,"Sub-basin 6"
2076,1000,345,7300,8300,"Sub-basin 6"
2077,800,52,3600,4400,"Sub-basin 6"
2078,500,29,2700,3200,"Sub-basin 6"
2079,400,21,3400,3800,"Sub-basin 6"
2080,1100,57,9400,10500,"Sub-basin 6"
2081,100,1,2000,2100,"Sub-basin 6"
2082,1700,222,8900,10600,"Sub-basin 6"
2083,100,2,700,800,"Sub-basin 6"
2084,100,2,1400,1500,"Sub-basin 6"
2085,1600,319,13300,14900,"Sub-basin 6"
2086,400,30,2100,2500,"Sub-basin 6"
2087,700,55,5700,6400,"Sub-basin 6"
2088,100,9,1100,1200,"Sub-basin 6"
2089,200,18,1800,2000,"Sub-basin 6"
2090,400,8,7500,7900,"Sub-basin 6"
2091,900,70,8600,9500,"Sub-basin 6"
2092,700,216,3400,4100,"Sub-basin 6"
2093,2300,256,18400,20700,"Sub-basin 6"
2094,100,2,1000,1100,"Sub-basin 6"
2095,100,5,700,800,"Sub-basin 6"
2096,1800,63,19000,20800,"Sub-basin 6"
2097,500,30,7900,8400,"Sub-basin 6"
2098,100,2,1100,1200,"Sub-basin 6"
2099,275000,101955.8237,196900,471900,"Sub-basin 6"
2100,100,5,1700,1800,"Sub-basin 6"
2101,1200,116,6000,7200,"Sub-basin 6"
2102,500,65,4200,4700,"Sub-basin 6"
2103,5700,1618,16100,21800,"Sub-basin 6"
2104,100,3,2100,2200,"Sub-basin 6"
2105,26200,4410,75800,102000,"Sub-basin 6"
2106,500,134,4200,4700,"Sub-basin 6"
2107,100,8,1100,1200,"Sub-basin 6"
2108,300,19,3000,3300,"Sub-basin 6"
2109,300,12,1800,2100,"Sub-basin 6"
2110,1400,206,5900,7300,"Sub-basin 6"
2111,500,56,1900,2400,"Sub-basin 6"
2112,6000,1676,20600,26600,"Sub-basin 6"
2113,3600,1319,8400,12000,"Sub-basin 6"
2114,2000,287,11700,13700,"Sub-basin 6"
2115,300,10,2700,3000,"Sub-basin 6"
2116,300,10,1600,1900,"Sub-basin 6"
2117,100,3,1300,1400,"Sub-basin 6"
2118,800,195,4200,5000,"Sub-basin 6"
2119,100,1,2800,2900,"Sub-basin 6"
2120,1400,119,9400,10800,"Sub-basin 6"
2121,100,5,500,600,"Sub-basin 6"
2122,100,7,1200,1300,"Sub-basin 6"
2123,100,1,200,300,"Sub-basin 6"
2124,1100,102,4500,5600,"Sub-basin 6"
2125,800,49,3500,4300,"Sub-basin 6"
2126,6100,2274,14300,20400,"Sub-basin 6"
2127,1000,114,5700,6700,"Sub-basin 6"
2128,100,5,900,1000,"Sub-basin 6"
2129,500,100,2400,2900,"Sub-basin 6"
2130,100,2,700,800,"Sub-basin 6"
2131,1700,378,4300,6000,"Sub-basin 6"
2132,400,18,900,1300,"Sub-basin 6"
2133,100,2,700,800,"Sub-basin 6"
2134,200,5,800,1000,"Sub-basin 6"
2135,200,6,800,1000,"Sub-basin 6"
2136,100,4,2100,2200,"Sub-basin 6"
2137,300,30,4200,4500,"Sub-basin 6"
2138,200,21,1400,1600,"Sub-basin 6"
2139,500,49,2000,2500,"Sub-basin 6"
2140,25500,17708,20600,46100,"Sub-basin 6"
2141,600,138,3000,3600,"Sub-basin 6"
2142,800,97,4300,5100,"Sub-basin 6"
2143,100,1,1100,1200,"Sub-basin 6"
2144,500,63,5100,5600,"Sub-basin 6"
2145,7600,1094,35300,42900,"Sub-basin 6"
2146,200,9,1500,1700,"Sub-basin 6"
2147,600,101,4300,4900,"Sub-basin 6"
2148,200,28,1400,1600,"Sub-basin 6"
2149,100,6,1000,1100,"Sub-basin 6"
2150,700,120,1700,2400,"Sub-basin 6"
2151,900,77,7800,8700,"Sub-basin 6"
2152,100,2,800,900,"Sub-basin 6"
2153,600,28,5700,6300,"Sub-basin 6"
2154,700,172,2500,3200,"Sub-basin 6"
2155,1600,430,6100,7700,"Sub-basin 6"
2156,100,1,1600,1700,"Sub-basin 6"
2157,300,8,3100,3400,"Sub-basin 6"
2158,200,3,1300,1500,"Sub-basin 6"
2159,200,5,2400,2600,"Sub-basin 6"
2160,200,3,3300,3500,"Sub-basin 6"
2161,700,108,2700,3400,"Sub-basin 6"
2162,700,77,2900,3600,"Sub-basin 6"
2163,600,41,2200,2800,"Sub-basin 6"
2164,100,2,1900,2000,"Sub-basin 6"
2165,300,18,3600,3900,"Sub-basin 6"
2166,2700,258,9900,12600,"Sub-basin 6"
2167,200,13,3500,3700,"Sub-basin 6"
2168,400,6,5800,6200,"Sub-basin 6"
2169,100,2,400,500,"Sub-basin 6"
2170,100,3,900,1000,"Sub-basin 6"
2171,3900,1059,6700,10600,"Sub-basin 6"
2172,100,2,1100,1200,"Sub-basin 6"
2173,100,2,1100,1200,"Sub-basin 6"
2174,100,4,2100,2200,"Sub-basin 6"
2175,300,14,3500,3800,"Sub-basin 6"
2176,600,96,4500,5100,"Sub-basin 6"
2177,17200,4975,35800,53000,"Sub-basin 6"
2178,1100,160,8800,9900,"Sub-basin 6"
2179,3000,678,11700,14700,"Sub-basin 6"
2180,100,3,800,900,"Sub-basin 6"
2181,1400,87,10400,11800,"Sub-basin 6"
2182,1800,350,6900,8700,"Sub-basin 6"
2183,400,116,2800,3200,"Sub-basin 6"
2184,200,4,1700,1900,"Sub-basin 6"
2185,100,15,1500,1600,"Sub-basin 6"
2186,200,70.0006,1400,1600,"Sub-basin 6"
2187,1400,142,11300,12700,"Sub-basin 6"
2188,2700,269,19000,21700,"Sub-basin 6"
2189,500,26,3700,4200,"Sub-basin 6"
2190,4400,1985,6900,11300,"Sub-basin 6"
2191,800,109,5200,6000,"Sub-basin 6"
2192,100,4,1200,1300,"Sub-basin 6"
2193,500,29,6000,6500,"Sub-basin 6"
2194,200,11,1200,1400,"Sub-basin 6"
2195,2300,523,6900,9200,"Sub-basin 6"
2196,1500,259,5300,6800,"Sub-basin 6"
2197,800,196,3200,4000,"Sub-basin 6"
2198,4500,1167,10500,15000,"Sub-basin 6"
2199,200,12,1900,2100,"Sub-basin 6"
2200,500,40,2900,3400,"Sub-basin 6"
2201,400,32,1400,1800,"Sub-basin 6"
2202,800,59,4500,5300,"Sub-basin 6"
2203,800,91,8000,8800,"Sub-basin 6"
2204,200,7,5200,5400,"Sub-basin 6"
2205,800,88,3500,4300,"Sub-basin 6"
2206,700,121,2100,2800,"Sub-basin 6"
2207,100,3,1600,1700,"Sub-basin 6"
2208,100,11,1800,1900,"Sub-basin 6"
2209,900,114,6300,7200,"Sub-basin 6"
2210,500,17,9700,10200,"Sub-basin 6"
2211,3400,853,12400,15800,"Sub-basin 6"
2212,200,12,1700,1900,"Sub-basin 6"
2213,200,9,1700,1900,"Sub-basin 6"
2214,400,35,3600,4000,"Sub-basin 6"
2215,2700,333,14100,16800,"Sub-basin 6"
2216,400,49,1900,2300,"Sub-basin 6"
2217,400,40,4200,4600,"Sub-basin 6"
2218,100,1,3600,3700,"Sub-basin 6"
2219,1700,144,16700,18400,"Sub-basin 6"
2220,3000,277,24500,27500,"Sub-basin 6"
2221,900,316,2600,3500,"Sub-basin 6"
2222,1600,463,9500,11100,"Sub-basin 6"
2223,600,59,4000,4600,"Sub-basin 6"
2224,2500,179,21800,24300,"Sub-basin 6"
2225,300,41,1300,1600,"Sub-basin 6"
2226,100,5,1700,1800,"Sub-basin 6"
2227,300,7,1800,2100,"Sub-basin 6"
2228,100,2,500,600,"Sub-basin 6"
2229,5000,533,28600,33600,"Sub-basin 6"
2230,100,2,1200,1300,"Sub-basin 6"
2231,100,2,1100,1200,"Sub-basin 6"
2232,500,47,3400,3900,"Sub-basin 6"
2233,1000,29,12000,13000,"Sub-basin 6"
2234,2000,691,7800,9800,"Sub-basin 6"
2235,1800,401,6800,8600,"Sub-basin 6"
2236,400,39,4900,5300,"Sub-basin 6"
2237,400,35,4500,4900,"Sub-basin 6"
2238,900,208,3300,4200,"Sub-basin 6"
2239,1500,326,9200,10700,"Sub-basin 6"
2240,400,58,2800,3200,"Sub-basin 6"
2241,3100,208,13600,16700,"Sub-basin 6"
2242,1200,134,8300,9500,"Sub-basin 6"
2243,9600,4997,10100,19700,"Sub-basin 6"
2244,1400,145,13500,14900,"Sub-basin 6"
2245,700,100,3100,3800,"Sub-basin 6"
2246,5600,1741,19600,25200,"Sub-basin 6"
2247,2600,412,14700,17300,"Sub-basin 6"
2248,500,35,6800,7300,"Sub-basin 6"
2249,300,14,7400,7700,"Sub-basin 6"
2250,1400,82,9100,10500,"Sub-basin 6"
2251,300,18,1900,2200,"Sub-basin 6"
2252,1400,195,8000,9400,"Sub-basin 6"
2253,200,5,1700,1900,"Sub-basin 6"
2254,800,162,4000,4800,"Sub-basin 6"
2255,400,46,3600,4000,"Sub-basin 6"
2256,1900,186,20400,22300,"Sub-basin 6"
2257,100,1,700,800,"Sub-basin 6"
2258,200,4,2300,2500,"Sub-basin 6"
2259,600,16,4100,4700,"Sub-basin 6"
2260,600,117,4500,5100,"Sub-basin 6"
2261,100,7,2200,2300,"Sub-basin 6"
2262,200,14,2000,2200,"Sub-basin 6"
2263,200,31,1700,1900,"Sub-basin 6"
2264,200,3,1500,1700,"Sub-basin 6"
2265,4200,332,35500,39700,"Sub-basin 6"
2266,200,4,2000,2200,"Sub-basin 6"
2267,2800,555,10000,12800,"Sub-basin 6"
2268,2900,207,15800,18700,"Sub-basin 6"
2269,200,8,3000,3200,"Sub-basin 6"
2270,100,2,3000,3100,"Sub-basin 6"
2271,400,129,2900,3300,"Sub-basin 6"
2272,300,27,5800,6100,"Sub-basin 6"
2273,200,15,3700,3900,"Sub-basin 6"
2274,100,5,2100,2200,"Sub-basin 6"
2275,300,9,2000,2300,"Sub-basin 6"
2276,200,2,1900,2100,"Sub-basin 6"
2277,600,62,4400,5000,"Sub-basin 6"
2278,1900,268.0025,19700,21600,"Sub-basin 6"
2279,600,24.0005,4100,4700,"Sub-basin 6"
2280,1100,649,5600,6700,"Sub-basin 6"
2281,100,4,1700,1800,"Sub-basin 6"
2282,900,116,5300,6200,"Sub-basin 6"
2283,100,3,700,800,"Sub-basin 6"
2284,100,1,2500,2600,"Sub-basin 6"
2285,200,3,1900,2100,"Sub-basin 6"
2286,1600,157,8100,9700,"Sub-basin 6"
2287,100,6,1900,2000,"Sub-basin 6"
2288,500,30,2000,2500,"Sub-basin 6"
2289,200,4,2200,2400,"Sub-basin 6"
2290,200,18,2500,2700,"Sub-basin 6"
2291,100,2,1700,1800,"Sub-basin 6"
2292,100,2,1100,1200,"Sub-basin 6"
2293,2200,168,16500,18700,"Sub-basin 6"
2294,500,27,3200,3700,"Sub-basin 6"
2295,200,6,2000,2200,"Sub-basin 6"
2296,300,5,5200,5500,"Sub-basin 6"
2297,100,1,1700,1800,"Sub-basin 6"
2298,100,1,1300,1400,"Sub-basin 6"
2299,100,3,1200,1300,"Sub-basin 6"
2300,100,1,1400,1500,"Sub-basin 6"
2301,10000,2125,36200,46200,"Sub-basin 6"
2302,500,47,3700,4200,"Sub-basin 6"
2303,200,20,3700,3900,"Sub-basin 6"
2304,300,17,6800,7100,"Sub-basin 6"
2305,100,5,1000,1100,"Sub-basin 6"
2306,400,42,4200,4600,"Sub-basin 6"
2307,300,12,5200,5500,"Sub-basin 6"
2308,100,3,1700,1800,"Sub-basin 6"
2309,6000,699.0054,43400,49400,"Sub-basin 6"
2310,1900,552,3500,5400,"Sub-basin 6"
2311,600,26,6300,6900,"Sub-basin 6"
2312,200,7,4400,4600,"Sub-basin 6"
2313,100,2,600,700,"Sub-basin 6"
2314,800,155,7400,8200,"Sub-basin 6"
2315,700,46,4200,4900,"Sub-basin 6"
2316,2000,268,10000,12000,"Sub-basin 6"
2317,100,8,1100,1200,"Sub-basin 6"
2318,400,21,4500,4900,"Sub-basin 6"
2319,200,22,4000,4200,"Sub-basin 6"
2320,100,2,1200,1300,"Sub-basin 6"
2321,1500,69,16300,17800,"Sub-basin 6"
2322,100,1,3400,3500,"Sub-basin 6"
2323,400,49,3200,3600,"Sub-basin 6"
2324,100,1,700,800,"Sub-basin 6"
2325,200,13,700,900,"Sub-basin 6"
2326,100,2,1800,1900,"Sub-basin 6"
2327,600,55,2600,3200,"Sub-basin 6"
2328,100,4,3100,3200,"Sub-basin 6"
2329,1100,275,3500,4600,"Sub-basin 6"
2330,2800,475,7300,10100,"Sub-basin 6"
2331,100,1,800,900,"Sub-basin 6"
2332,100,3,1700,1800,"Sub-basin 6"
2333,500,35,4700,5200,"Sub-basin 6"
2334,400,16,4200,4600,"Sub-basin 6"
2335,100,1,1600,1700,"Sub-basin 6"
2336,100,2,1400,1500,"Sub-basin 6"
2337,1800,181,16300,18100,"Sub-basin 6"
2338,200,36,2700,2900,"Sub-basin 6"
2339,100,5,700,800,"Sub-basin 6"
2340,200,5,3300,3500,"Sub-basin 6"
2341,200,4,100,300,"Sub-basin 6"
2342,600,24,7300,7900,"Sub-basin 6"
2343,4000,951,11100,15100,"Sub-basin 6"
2344,8900,1667,28500,37400,"Sub-basin 6"
2345,100,1,1100,1200,"Sub-basin 6"
2346,1800,107,16400,18200,"Sub-basin 6"
2347,1400,112,8900,10300,"Sub-basin 6"
2348,1600,216,14500,16100,"Sub-basin 6"
2349,100,3,2200,2300,"Sub-basin 6"
2350,2100,461,8100,10200,"Sub-basin 6"
2351,500,46,4800,5300,"Sub-basin 6"
2352,100,1,1900,2000,"Sub-basin 6"
2353,3100,171,35700,38800,"Sub-basin 6"
2354,13200,2641,57600,70800,"Sub-basin 6"
2355,500,20,5800,6300,"Sub-basin 6"
2356,100,2,1800,1900,"Sub-basin 6"
2357,600,37,5500,6100,"Sub-basin 6"
2358,2300,455,3100,5400,"Sub-basin 6"
2359,1700,175,10600,12300,"Sub-basin 6"
2360,200,4,2700,2900,"Sub-basin 6"
2361,2100,209,9100,11200,"Sub-basin 6"
2362,400,85,3400,3800,"Sub-basin 6"
2363,400,38,6200,6600,"Sub-basin 6"
2364,700,60,11000,11700,"Sub-basin 6"
2365,800,53,4100,4900,"Sub-basin 6"
2366,600,23,3900,4500,"Sub-basin 6"
2367,247600,272262.16,327200,574800,"Sub-basin 6"
2368,400,48,1900,2300,"Sub-basin 6"
2369,1400,142,6800,8200,"Sub-basin 6"
2370,400,41,4500,4900,"Sub-basin 6"
2371,300,33,2200,2500,"Sub-basin 6"
2372,100,1,2200,2300,"Sub-basin 6"
2373,500,115,3100,3600,"Sub-basin 6"
2374,1200,360,4700,5900,"Sub-basin 6"
2375,400,15,2300,2700,"Sub-basin 6"
2376,400,14,2300,2700,"Sub-basin 6"
2377,2500,120,26200,28700,"Sub-basin 6"
2378,1700,305,13900,15600,"Sub-basin 6"
2379,700,28,6000,6700,"Sub-basin 6"
2380,600,56,4100,4700,"Sub-basin 6"
2381,700,44,8900,9600,"Sub-basin 6"
2382,2200,104,19500,21700,"Sub-basin 6"
2383,900,193,8000,8900,"Sub-basin 6"
2384,200,3,1100,1300,"Sub-basin 6"
2385,400,33,4500,4900,"Sub-basin 6"
2386,200,9,4400,4600,"Sub-basin 6"
2387,1600,95,9800,11400,"Sub-basin 6"
2388,100,2,1400,1500,"Sub-basin 6"
2389,300,14,1500,1800,"Sub-basin 6"
2390,100,5,700,800,"Sub-basin 6"
2391,8000,1402,44800,52800,"Sub-basin 6"
2392,1900,267,7400,9300,"Sub-basin 6"
2393,1300,159,7800,9100,"Sub-basin 6"
2394,100,1,1400,1500,"Sub-basin 6"
2395,300,19,2300,2600,"Sub-basin 6"
2396,700,75,2800,3500,"Sub-basin 6"
2397,200,7,6500,6700,"Sub-basin 6"
2398,200,7,4100,4300,"Sub-basin 6"
2399,700,111,2400,3100,"Sub-basin 6"
2400,700,96,1800,2500,"Sub-basin 6"
2401,200,5,400,600,"Sub-basin 6"
2402,6200,1168,26800,33000,"Sub-basin 6"
2403,100,7,1000,1100,"Sub-basin 6"
2404,100,1,1800,1900,"Sub-basin 6"
2405,1900,100,15700,17600,"Sub-basin 6"
2406,100,2,800,900,"Sub-basin 6"
2407,100,3,900,1000,"Sub-basin 6"
2408,200,4,2100,2300,"Sub-basin 6"
2409,300,21,3500,3800,"Sub-basin 6"
2410,1200,221,15900,17100,"Sub-basin 6"
2411,200,3,6100,6300,"Sub-basin 6"
2412,300,12,3600,3900,"Sub-basin 6"
2413,200,3,2500,2700,"Sub-basin 6"
2414,200,17,1900,2100,"Sub-basin 6"
2415,800,92.0001,5200,6000,"Sub-basin 6"
2416,2800,947.33,13400,16200,"Sub-basin 6"
2417,3200,668,10600,13800,"Sub-basin 6"
2418,600,148,4600,5200,"Sub-basin 6"
2419,7600,1141,19100,26700,"Sub-basin 6"
2420,400,64,3200,3600,"Sub-basin 6"
2421,300,7,2300,2600,"Sub-basin 6"
2422,1600,252,8500,10100,"Sub-basin 6"
2423,3800,931,7900,11700,"Sub-basin 6"
2424,100,2,1000,1100,"Sub-basin 6"
2425,10400,2799,37700,48100,"Sub-basin 6"
2426,1200,44,21700,22900,"Sub-basin 6"
2427,200,6,3800,4000,"Sub-basin 6"
2428,400,20,900,1300,"Sub-basin 6"
2429,300,14,3900,4200,"Sub-basin 6"
2430,100,2,3400,3500,"Sub-basin 6"
2431,300,10,4100,4400,"Sub-basin 6"
2432,600,292,2000,2600,"Sub-basin 6"
2433,200,17,2200,2400,"Sub-basin 6"
2434,1000,77,10900,11900,"Sub-basin 6"
2435,400,44,5200,5600,"Sub-basin 6"
2436,600,70,1100,1700,"Sub-basin 6"
2437,1300,300,4000,5300,"Sub-basin 6"
2438,3300,1784,10600,13900,"Sub-basin 6"
2439,1200,263,2600,3800,"Sub-basin 6"
2440,4800,550,23200,28000,"Sub-basin 6"
2441,300,20,3300,3600,"Sub-basin 6"
2442,100,6,2500,2600,"Sub-basin 6"
2443,400,18,4100,4500,"Sub-basin 6"
2444,700,54,4800,5500,"Sub-basin 6"
2445,1000,65,13300,14300,"Sub-basin 6"
2446,1100,157,6100,7200,"Sub-basin 6"
2447,16900,3499,32200,49100,"Sub-basin 6"
2448,600,84,9100,9700,"Sub-basin 6"
2449,200,17,4000,4200,"Sub-basin 6"
2450,800,138,2000,2800,"Sub-basin 6"
2451,4500,686.0044,27400,31900,"Sub-basin 6"
2452,100,5,1200,1300,"Sub-basin 6"
2453,400,21,2700,3100,"Sub-basin 6"
2454,100,3,1100,1200,"Sub-basin 6"
2455,5200,1194,17800,23000,"Sub-basin 6"
2456,300,13,3600,3900,"Sub-basin 6"
2457,2200,260,8000,10200,"Sub-basin 6"
2458,100,1,3900,4000,"Sub-basin 6"
2459,100,2,1500,1600,"Sub-basin 6"
2460,800,41,7100,7900,"Sub-basin 6"
2461,700,57,3700,4400,"Sub-basin 6"
2462,3300,559,30700,34000,"Sub-basin 6"
2463,100,1,3100,3200,"Sub-basin 6"
2464,1400,1541.4828,3400,4800,"Sub-basin 6"
2465,500,42,4800,5300,"Sub-basin 6"
2466,100,1,1300,1400,"Sub-basin 6"
2467,400,12,2400,2800,"Sub-basin 6"
2468,600,18,5600,6200,"Sub-basin 6"
2469,700,44,9200,9900,"Sub-basin 6"
2470,100,2,3200,3300,"Sub-basin 6"
2471,600,32,14000,14600,"Sub-basin 6"
2472,200,3,4700,4900,"Sub-basin 6"
2473,900,265,5500,6400,"Sub-basin 6"
2474,200,18,2300,2500,"Sub-basin 6"
2475,200,6,2000,2200,"Sub-basin 6"
2476,200,6,5300,5500,"Sub-basin 6"
2477,100,1,2300,2400,"Sub-basin 6"
2478,200,7,4200,4400,"Sub-basin 6"
2479,1400,125,11300,12700,"Sub-basin 6"
2480,1000,38,11900,12900,"Sub-basin 6"
2481,100,1,1600,1700,"Sub-basin 6"
2482,2100,260,3200,5300,"Sub-basin 6"
2483,1700,169,7100,8800,"Sub-basin 6"
2484,500,16,5900,6400,"Sub-basin 6"
2485,33300,11524,58900,92200,"Sub-basin 6"
2486,100,4,900,1000,"Sub-basin 6"
2487,400,55,2500,2900,"Sub-basin 6"
2488,700,82,2100,2800,"Sub-basin 6"
2489,100,1,1600,1700,"Sub-basin 6"
2490,100,6,2500,2600,"Sub-basin 6"
2491,200,8,3800,4000,"Sub-basin 6"
2492,1400,64,11400,12800,"Sub-basin 6"
2493,800,91,9400,10200,"Sub-basin 6"
2494,10500,2288,95900,106400,"Sub-basin 6"
2495,100,5,1300,1400,"Sub-basin 6"
2496,100,2,1600,1700,"Sub-basin 6"
2497,400,28,2400,2800,"Sub-basin 6"
2498,500,46,5500,6000,"Sub-basin 6"
2499,400,32,2400,2800,"Sub-basin 6"
2500,400,12,2500,2900,"Sub-basin 6"
2501,100,1,1700,1800,"Sub-basin 6"
2502,600,66,3400,4000,"Sub-basin 6"
2503,4900,462,22200,27100,"Sub-basin 6"
2504,2400,565,7400,9800,"Sub-basin 6"
2505,1200,162,6700,7900,"Sub-basin 6"
2506,1200,186,15200,16400,"Sub-basin 6"
2507,500,34,3600,4100,"Sub-basin 6"
2508,300,9,1100,1400,"Sub-basin 6"
2509,500,44,3700,4200,"Sub-basin 6"
2510,5400,1599,20000,25400,"Sub-basin 6"
2511,200,5,2800,3000,"Sub-basin 6"
2512,100,4,3000,3100,"Sub-basin 6"
2513,1100,316,8200,9300,"Sub-basin 6"
2514,2200,113,20500,22700,"Sub-basin 6"
2515,100,4,1500,1600,"Sub-basin 6"
2516,1100,213,7700,8800,"Sub-basin 6"
2517,3300,1653,12300,15600,"Sub-basin 6"
2518,100,5,600,700,"Sub-basin 6"
2519,4600,1055,13900,18500,"Sub-basin 6"
2520,400,9,3100,3500,"Sub-basin 6"
2521,1000,88,6700,7700,"Sub-basin 6"
2522,800,80,2700,3500,"Sub-basin 6"
2523,600,67,2300,2900,"Sub-basin 6"
2524,9000,2075.0089,42500,51500,"Sub-basin 6"
2525,100,1,1300,1400,"Sub-basin 6"
2526,400,61,2200,2600,"Sub-basin 6"
2527,300,8,2600,2900,"Sub-basin 6"
2528,400,28,1000,1400,"Sub-basin 6"
2529,2400,499,13700,16100,"Sub-basin 6"
2530,1600,228,9800,11400,"Sub-basin 6"
2531,100,3,900,1000,"Sub-basin 6"
2532,100,2,2800,2900,"Sub-basin 6"
2533,700,97,7000,7700,"Sub-basin 6"
2534,500,56,8700,9200,"Sub-basin 6"
2535,21600,1773.0069,65200,86800,"Sub-basin 6"
2536,100,5,600,700,"Sub-basin 6"
2537,7600,1210.0008,47400,55000,"Sub-basin 6"
2538,1500,48,17400,18900,"Sub-basin 6"
2539,600,136,4200,4800,"Sub-basin 6"
2540,500,75,2100,2600,"Sub-basin 6"
2541,100,7,2200,2300,"Sub-basin 6"
2542,500,68,1400,1900,"Sub-basin 6"
2543,800,70,4600,5400,"Sub-basin 6"
2544,600,82,3400,4000,"Sub-basin 6"
2545,100,3,3000,3100,"Sub-basin 6"
2546,100,5,800,900,"Sub-basin 6"
2547,400,22,2800,3200,"Sub-basin 6"
2548,200,11,1600,1800,"Sub-basin 6"
2549,100,1,600,700,"Sub-basin 6"
2550,100,3,1800,1900,"Sub-basin 6"
2551,200,5,1200,1400,"Sub-basin 6"
2552,200,6,800,1000,"Sub-basin 6"
2553,100,2,500,600,"Sub-basin 6"
2554,100,1,1000,1100,"Sub-basin 6"
2555,1500,248,12900,14400,"Sub-basin 6"
2556,200,2,1800,2000,"Sub-basin 6"
2557,300,19,6900,7200,"Sub-basin 6"
2558,2700,653,13800,16500,"Sub-basin 6"
2559,200,4,4200,4400,"Sub-basin 6"
2560,100,10,900,1000,"Sub-basin 6"
2561,200,3,7700,7900,"Sub-basin 6"
2562,100,2.0001,2900,3000,"Sub-basin 6"
2563,800,333,2500,3300,"Sub-basin 6"
2564,200,18,1100,1300,"Sub-basin 6"
2565,100,3,900,1000,"Sub-basin 6"
2566,300,5.0002,5900,6200,"Sub-basin 6"
2567,100,5,2000,2100,"Sub-basin 6"
2568,100,1,1200,1300,"Sub-basin 6"
2569,18900,8273,34300,53200,"Sub-basin 6"
2570,300,5,300,600,"Sub-basin 6"
2571,3300,877,11600,14900,"Sub-basin 6"
2572,4000,872,35500,39500,"Sub-basin 6"
2573,300,12,2500,2800,"Sub-basin 6"
2574,100,10,900,1000,"Sub-basin 6"
2575,200,4,1200,1400,"Sub-basin 6"
2576,100,1,500,600,"Sub-basin 6"
2577,200,4,700,900,"Sub-basin 6"
2578,100,1,700,800,"Sub-basin 6"
2579,100,4,300,400,"Sub-basin 6"
2580,100,3,1100,1200,"Sub-basin 6"
2581,400,75,2200,2600,"Sub-basin 6"
2582,1700,476,4300,6000,"Sub-basin 6"
2583,44500,21659,63000,107500,"Sub-basin 6"
2584,200,37,2500,2700,"Sub-basin 6"
2585,1100,539,6600,7700,"Sub-basin 6"
2586,1700,539,13100,14800,"Sub-basin 6"
2587,100,2,700,800,"Sub-basin 6"
2588,1800,93,12600,14400,"Sub-basin 6"
2589,200,14,3500,3700,"Sub-basin 6"
2590,200,2,2800,3000,"Sub-basin 6"
2591,300,33.0001,800,1100,"Sub-basin 6"
2592,300,44,3800,4100,"Sub-basin 6"
2593,1200,180,6500,7700,"Sub-basin 6"
2594,400,124,4500,4900,"Sub-basin 6"
2595,500,36,3200,3700,"Sub-basin 6"
2596,400,9,4800,5200,"Sub-basin 6"
2597,400,73,9100,9500,"Sub-basin 6"
2598,100,1,1500,1600,"Sub-basin 6"
2599,100,1,1500,1600,"Sub-basin 6"
2600,900,41,8800,9700,"Sub-basin 6"
2601,100,16,1600,1700,"Sub-basin 6"
2602,1100,273,2500,3600,"Sub-basin 6"
2603,1400,71,17000,18400,"Sub-basin 6"
2604,1200,54,17000,18200,"Sub-basin 6"
2605,100,1.0001,2100,2200,"Sub-basin 6"
2606,300,19,2200,2500,"Sub-basin 6"
2607,100,1,200,300,"Sub-basin 6"
2608,100,8,300,400,"Sub-basin 6"
2609,100,1,1100,1200,"Sub-basin 6"
2610,600,31,2500,3100,"Sub-basin 6"
2611,200,4,1600,1800,"Sub-basin 6"
2612,200,6,1400,1600,"Sub-basin 6"
2613,400,35,2200,2600,"Sub-basin 6"
2614,100,7,400,500,"Sub-basin 6"
2615,100,1,1500,1600,"Sub-basin 6"
2616,100,1,1100,1200,"Sub-basin 6"
2617,4900,611,47500,52400,"Sub-basin 6"
2618,500,53,7800,8300,"Sub-basin 6"
2619,1800,163,23500,25300,"Sub-basin 6"
2620,200,15,2800,3000,"Sub-basin 6"
2621,400,29,4500,4900,"Sub-basin 6"
2622,700,70,3100,3800,"Sub-basin 6"
2623,19600,8228,29900,49500,"Sub-basin 6"
2624,600,25,2600,3200,"Sub-basin 6"
2625,100,3,1800,1900,"Sub-basin 6"
2626,24900,1097.16,54800,79700,"Sub-basin 6"
2627,1100,80,5700,6800,"Sub-basin 6"
2628,600,38,4000,4600,"Sub-basin 6"
2629,500,29,2100,2600,"Sub-basin 6"
2630,100,1,600,700,"Sub-basin 6"
2631,300,22,4400,4700,"Sub-basin 6"
2632,600,60,6900,7500,"Sub-basin 6"
2633,100,2,1000,1100,"Sub-basin 6"
2634,400,15,4200,4600,"Sub-basin 6"
2635,400,48,3400,3800,"Sub-basin 6"
2636,100,4,1700,1800,"Sub-basin 6"
2637,1000,29,4800,5800,"Sub-basin 6"
2638,1000,906,8600,9600,"Sub-basin 6"
2639,800,156,7000,7800,"Sub-basin 6"
2640,600,10,7700,8300,"Sub-basin 6"
2641,800,204,8100,8900,"Sub-basin 6"
2642,500,12,1900,2400,"Sub-basin 6"
2643,200,16,4400,4600,"Sub-basin 6"
2644,1000,223,4500,5500,"Sub-basin 6"
2645,1100,144,6200,7300,"Sub-basin 6"
2646,300,30,2500,2800,"Sub-basin 6"
2647,100,1,1800,1900,"Sub-basin 6"
2648,100,1,1800,1900,"Sub-basin 6"
2649,1400,85,16700,18100,"Sub-basin 6"
2650,200,4,800,1000,"Sub-basin 6"
2651,100,3,1100,1200,"Sub-basin 6"
2652,100,2,1600,1700,"Sub-basin 6"
2653,800,49,6500,7300,"Sub-basin 6"
2654,100,1,3300,3400,"Sub-basin 6"
2655,100,3,1700,1800,"Sub-basin 6"
2656,600,48,9700,10300,"Sub-basin 6"
2657,800,48,5500,6300,"Sub-basin 6"
2658,1400,309,11600,13000,"Sub-basin 6"
2659,600,102,2300,2900,"Sub-basin 6"
2660,100,1,900,1000,"Sub-basin 6"
2661,1100,24,5800,6900,"Sub-basin 6"
2662,100,2,400,500,"Sub-basin 6"
2663,200,9,1800,2000,"Sub-basin 6"
2664,100,2,700,800,"Sub-basin 6"
2665,100,2,2400,2500,"Sub-basin 6"
2666,300,5,1600,1900,"Sub-basin 6"
2667,300,4,3500,3800,"Sub-basin 6"
2668,100,8,2300,2400,"Sub-basin 6"
2669,300,7,6500,6800,"Sub-basin 6"
2670,100,4,1900,2000,"Sub-basin 6"
2671,200,2,2300,2500,"Sub-basin 6"
2672,100,4,500,600,"Sub-basin 6"
2673,300,12,3000,3300,"Sub-basin 6"
2674,200,12,2300,2500,"Sub-basin 6"
2675,300,12,5400,5700,"Sub-basin 6"
2676,100,1,1500,1600,"Sub-basin 6"
2677,1700,32,10800,12500,"Sub-basin 6"
2678,200,5,1000,1200,"Sub-basin 6"
2679,6100,1033,34200,40300,"Sub-basin 6"
2680,1400,53,11400,12800,"Sub-basin 6"
2681,2700,75,10100,12800,"Sub-basin 6"
2682,100,1,2700,2800,"Sub-basin 6"
2683,100,1,600,700,"Sub-basin 6"
2684,400,34,1600,2000,"Sub-basin 6"
2685,100,1,2200,2300,"Sub-basin 6"
2686,4600,239,32200,36800,"Sub-basin 6"
2687,600,65,7900,8500,"Sub-basin 6"
2688,100,1,800,900,"Sub-basin 6"
2689,1200,17,4400,5600,"Sub-basin 6"
2690,700,146,2000,2700,"Sub-basin 6"
2691,300,8,4100,4400,"Sub-basin 6"
2692,600,30,5400,6000,"Sub-basin 6"
2693,100,3,1400,1500,"Sub-basin 6"
2694,500,14,3300,3800,"Sub-basin 6"
2695,600,22,2000,2600,"Sub-basin 6"
2696,5100,1136,15400,20500,"Sub-basin 6"
2697,2600,934,7800,10400,"Sub-basin 6"
2698,200,2,4900,5100,"Sub-basin 6"
2699,1800,1683.2236,9000,10800,"Sub-basin 6"
2700,200,4,3900,4100,"Sub-basin 6"
2701,2100,696,3000,5100,"Sub-basin 6"
2702,1100,134,3900,5000,"Sub-basin 6"
2703,200,5,4600,4800,"Sub-basin 6"
2704,200,12,3200,3400,"Sub-basin 6"
2705,100,2,1600,1700,"Sub-basin 6"
2706,800,62,2400,3200,"Sub-basin 6"
2707,1500,107,10500,12000,"Sub-basin 6"
2708,200,9,2700,2900,"Sub-basin 6"
2709,400,37,1800,2200,"Sub-basin 6"
2710,41200,2626,59100,100300,"Sub-basin 6"
2711,1700,101,15600,17300,"Sub-basin 6"
2712,100,3,1900,2000,"Sub-basin 6"
2713,100,5,2300,2400,"Sub-basin 6"
2714,1400,515,5800,7200,"Sub-basin 6"
2715,100,1,400,500,"Sub-basin 6"
2716,300,11,1500,1800,"Sub-basin 6"
2717,500,39,3800,4300,"Sub-basin 6"
2718,100,1,2400,2500,"Sub-basin 6"
2719,1500,153,11300,12800,"Sub-basin 6"
2720,600,37,7900,8500,"Sub-basin 6"
2721,300,4,500,800,"Sub-basin 6"
2722,200,8,1500,1700,"Sub-basin 6"
2723,100,1,1500,1600,"Sub-basin 6"
2724,100,9,1300,1400,"Sub-basin 6"
2725,100,3,800,900,"Sub-basin 6"
2726,800,189,1800,2600,"Sub-basin 6"
2727,200,16,1700,1900,"Sub-basin 6"
2728,100,2,2300,2400,"Sub-basin 6"
2729,700,30,13900,14600,"Sub-basin 6"
2730,3000,2426.071,5900,8900,"Sub-basin 6"
2731,100,2,300,400,"Sub-basin 6"
2732,600,161,1800,2400,"Sub-basin 6"
2733,163000,40784.8219,419100,582100,"Sub-basin 6"
2734,300,7,6000,6300,"Sub-basin 6"
2735,200,7,3300,3500,"Sub-basin 6"
2736,1500,615,8400,9900,"Sub-basin 6"
2737,1100,22,8800,9900,"Sub-basin 6"
2738,100,1,2400,2500,"Sub-basin 6"
2739,17400,9481,28600,46000,"Sub-basin 6"
2740,100,2,900,1000,"Sub-basin 6"
2741,400,49,2600,3000,"Sub-basin 6"
2742,600,115,1900,2500,"Sub-basin 6"
2743,500,15,5000,5500,"Sub-basin 6"
2744,100,1,1400,1500,"Sub-basin 6"
2745,900,90,8400,9300,"Sub-basin 6"
2746,200,2,400,600,"Sub-basin 6"
2747,1200,89,6900,8100,"Sub-basin 6"
2748,100,5,1600,1700,"Sub-basin 6"
2749,500,10,11500,12000,"Sub-basin 6"
2750,200,9,4500,4700,"Sub-basin 6"
2751,200,3,6200,6400,"Sub-basin 6"
2752,400,28,11200,11600,"Sub-basin 6"
2753,100,3,600,700,"Sub-basin 6"
2754,300,8,1000,1300,"Sub-basin 6"
2755,1200,172,4200,5400,"Sub-basin 6"
2756,100,2,1600,1700,"Sub-basin 6"
2757,1800,405,4800,6600,"Sub-basin 6"
2758,100,3,2600,2700,"Sub-basin 6"
2759,4000,1747,9200,13200,"Sub-basin 6"
2760,1100,104,7600,8700,"Sub-basin 6"
2761,400,63,1500,1900,"Sub-basin 6"
2762,200,2,3800,4000,"Sub-basin 6"
2763,100,2,1100,1200,"Sub-basin 6"
2764,700,39,6100,6800,"Sub-basin 6"
2765,7600,1509,14900,22500,"Sub-basin 6"
2766,500,64,2400,2900,"Sub-basin 6"
2767,100,1,1700,1800,"Sub-basin 6"
2768,147300,102156.99,163200,310500,"Sub-basin 6"
2769,100,3,2000,2100,"Sub-basin 6"
2770,800,40,9600,10400,"Sub-basin 6"
2771,100,5,700,800,"Sub-basin 6"
2772,200,4,1500,1700,"Sub-basin 6"
2773,100,2,1300,1400,"Sub-basin 6"
2774,600,15,8400,9000,"Sub-basin 6"
2775,2100,60,27100,29200,"Sub-basin 6"
2776,400,16,8100,8500,"Sub-basin 6"
2777,600,39,13800,14400,"Sub-basin 6"
2778,100,4,3300,3400,"Sub-basin 6"
2779,400,52,1500,1900,"Sub-basin 6"
2780,200,5,2600,2800,"Sub-basin 6"
2781,200,5,900,1100,"Sub-basin 6"
2782,5100,797,54500,59600,"Sub-basin 6"
2783,100,1,1600,1700,"Sub-basin 6"
2784,100,1,1500,1600,"Sub-basin 6"
2785,100,2,2800,2900,"Sub-basin 6"
2786,400,9,9200,9600,"Sub-basin 6"
2787,200,8,3800,4000,"Sub-basin 6"
2788,100,4,1100,1200,"Sub-basin 6"
2789,400,6,3800,4200,"Sub-basin 6"
2790,300,19,7100,7400,"Sub-basin 6"
2791,100,1,1100,1200,"Sub-basin 6"
2792,100,6,1100,1200,"Sub-basin 6"
2793,100,1,700,800,"Sub-basin 6"
2794,200,4,2500,2700,"Sub-basin 6"
2795,200,5,1200,1400,"Sub-basin 6"
2796,100,2,1400,1500,"Sub-basin 6"
2797,100,1,1100,1200,"Sub-basin 6"
2798,300,14,4400,4700,"Sub-basin 6"
2799,200,6,6900,7100,"Sub-basin 6"
2800,100,2,2400,2500,"Sub-basin 6"
2801,100,2,700,800,"Sub-basin 6"
2802,400,17,4100,4500,"Sub-basin 6"
2803,11500,4226,20800,32300,"Sub-basin 6"
2804,200,4,2800,3000,"Sub-basin 6"
2805,600,35,2000,2600,"Sub-basin 6"
2806,100,4,1200,1300,"Sub-basin 6"
2807,400,11,8100,8500,"Sub-basin 6"
2808,300,33,1700,2000,"Sub-basin 6"
2809,100,2,1300,1400,"Sub-basin 6"
2810,500,14,6300,6800,"Sub-basin 6"
2811,100,1,1000,1100,"Sub-basin 6"
2812,200,8,2300,2500,"Sub-basin 6"
2813,100,2,1700,1800,"Sub-basin 6"
2814,100,1,2500,2600,"Sub-basin 6"
2815,700,28,7100,7800,"Sub-basin 6"
2816,400,74,4500,4900,"Sub-basin 6"
2817,400,21,2300,2700,"Sub-basin 6"
2818,100,7,1400,1500,"Sub-basin 6"
2819,300,6,1800,2100,"Sub-basin 6"
2820,100,1,1700,1800,"Sub-basin 6"
2821,800,79,7400,8200,"Sub-basin 6"
2822,1700,139,21300,23000,"Sub-basin 6"
2823,100,1,3700,3800,"Sub-basin 6"
2824,100,1,400,500,"Sub-basin 6"
2825,2000,560,5900,7900,"Sub-basin 6"
2826,600,77,4400,5000,"Sub-basin 6"
2827,200,6,400,600,"Sub-basin 6"
2828,700,24,9300,10000,"Sub-basin 6"
2829,900,90,8400,9300,"Sub-basin 6"
2830,600,16,5300,5900,"Sub-basin 6"
2831,300,8,4800,5100,"Sub-basin 6"
2832,200,5,2600,2800,"Sub-basin 6"
2833,1500,198,4500,6000,"Sub-basin 6"
2834,300,12,3000,3300,"Sub-basin 6"
2835,7100,1606.5,39000,46100,"Sub-basin 6"
2836,2000,216,28300,30300,"Sub-basin 6"
2837,100,1,1700,1800,"Sub-basin 6"
2838,100,1,1400,1500,"Sub-basin 6"
2839,100,2,2500,2600,"Sub-basin 6"
2840,100,2,2200,2300,"Sub-basin 6"
2841,100,1,1600,1700,"Sub-basin 6"
2842,100,2,1100,1200,"Sub-basin 6"
2843,200,15,2100,2300,"Sub-basin 6"
2844,1500,101,5000,6500,"Sub-basin 6"
2845,200,2,1700,1900,"Sub-basin 6"
2846,300,10,4000,4300,"Sub-basin 6"
2847,100,1,2400,2500,"Sub-basin 6"
2848,500,14,8800,9300,"Sub-basin 6"
2849,600,32,4300,4900,"Sub-basin 6"
2850,5400,2229,13700,19100,"Sub-basin 6"
2851,100,2,600,700,"Sub-basin 6"
2852,500,73,2000,2500,"Sub-basin 6"
2853,200,3,2700,2900,"Sub-basin 6"
2854,100,1,1600,1700,"Sub-basin 6"
2855,400,18,6700,7100,"Sub-basin 6"
2856,400,16,3800,4200,"Sub-basin 6"
2857,100,1,1100,1200,"Sub-basin 6"
2858,100,2,700,800,"Sub-basin 6"
2859,700,40,3800,4500,"Sub-basin 6"
2860,200,2,4700,4900,"Sub-basin 6"
2861,100,2,2000,2100,"Sub-basin 6"
2862,400,9,9900,10300,"Sub-basin 6"
2863,500,33,2900,3400,"Sub-basin 6"
2864,2300,226,18700,21000,"Sub-basin 6"
2865,100,1.0199,700,800,"Sub-basin 6"
2866,100,1,1800,1900,"Sub-basin 6"
2867,3800,664,22500,26300,"Sub-basin 6"
2868,400,13,100,500,"Sub-basin 6"
2869,500,18,5900,6400,"Sub-basin 6"
2870,300,4,1900,2200,"Sub-basin 6"
2871,1000,207,8400,9400,"Sub-basin 6"
2872,2400,395,8900,11300,"Sub-basin 6"
2873,500,32,2000,2500,"Sub-basin 6"
2874,100,3,1800,1900,"Sub-basin 6"
2875,400,14,7100,7500,"Sub-basin 6"
2876,100,3,1600,1700,"Sub-basin 6"
2877,100,3,1200,1300,"Sub-basin 6"
2878,500,11,3800,4300,"Sub-basin 6"
2879,19300,4521,70000,89300,"Sub-basin 6"
2880,1000,129,4600,5600,"Sub-basin 6"
2881,100,1,1100,1200,"Sub-basin 6"
2882,100,1,800,900,"Sub-basin 6"
2883,200,4,2600,2800,"Sub-basin 6"
2884,100,1,2700,2800,"Sub-basin 6"
2885,1500,215,5700,7200,"Sub-basin 6"
2886,400,84,1900,2300,"Sub-basin 6"
2887,200,10,3400,3600,"Sub-basin 6"
2888,1000,134,5000,6000,"Sub-basin 6"
2889,4200,1008,15800,20000,"Sub-basin 6"
2890,100,1,1700,1800,"Sub-basin 6"
2891,100,2,2100,2200,"Sub-basin 6"
2892,100,1,1500,1600,"Sub-basin 6"
2893,300,29,2000,2300,"Sub-basin 6"
2894,1100,232,3900,5000,"Sub-basin 6"
2895,2400,119,9600,12000,"Sub-basin 6"
2896,400,12,4100,4500,"Sub-basin 6"
2897,100,1,2900,3000,"Sub-basin 6"
2898,5900,538.3549,71700,77600,"Sub-basin 6"
2899,300,22,4400,4700,"Sub-basin 6"
2900,600,79,1600,2200,"Sub-basin 6"
2901,8200,2214,20100,28300,"Sub-basin 6"
2902,200,3,3400,3600,"Sub-basin 6"
2903,100,1,700,800,"Sub-basin 6"
2904,100,1,200,300,"Sub-basin 6"
2905,200,4,1200,1400,"Sub-basin 6"
2906,200,16,1200,1400,"Sub-basin 6"
2907,3700,1209,16300,20000,"Sub-basin 6"
2908,2400,249.102,23200,25600,"Sub-basin 6"
2909,300,5,4800,5100,"Sub-basin 6"
2910,2200,81,18900,21100,"Sub-basin 6"
2911,1300,78,18700,20000,"Sub-basin 6"
2912,100,3,1900,2000,"Sub-basin 6"
2913,300,7.008,5300,5600,"Sub-basin 6"
2914,100,3.0006,2600,2700,"Sub-basin 6"
2915,300,16,1200,1500,"Sub-basin 6"
2916,100,2,1000,1100,"Sub-basin 6"
2917,100,1,1900,2000,"Sub-basin 6"
2918,4100,863,14000,18100,"Sub-basin 6"
2919,100,60,800,900,"Sub-basin 6"
2920,100,1,1300,1400,"Sub-basin 6"
2921,300,5,5000,5300,"Sub-basin 6"
2922,600,206,3300,3900,"Sub-basin 6"
2923,500,45,2100,2600,"Sub-basin 6"
2924,400,12,4600,5000,"Sub-basin 6"
2925,600,57,3000,3600,"Sub-basin 6"
2926,2000,498,7700,9700,"Sub-basin 6"
2927,300,14,3200,3500,"Sub-basin 6"
2928,200,9,2600,2800,"Sub-basin 6"
2929,500,19,2500,3000,"Sub-basin 6"
2930,100,1,1600,1700,"Sub-basin 6"
2931,700,52,2700,3400,"Sub-basin 6"
2932,11600,3526,32300,43900,"Sub-basin 6"
2933,200,2,3100,3300,"Sub-basin 6"
2934,100,2,3000,3100,"Sub-basin 6"
2935,200,9,800,1000,"Sub-basin 6"
2936,3300,1371,8400,11700,"Sub-basin 6"
2937,2300,481,8100,10400,"Sub-basin 6"
2938,100,1,1100,1200,"Sub-basin 6"
2939,100,1,2400,2500,"Sub-basin 6"
2940,1100,562,4400,5500,"Sub-basin 6"
2941,400,25,2000,2400,"Sub-basin 6"
2942,100,2,1100,1200,"Sub-basin 6"
2943,11600,5123,14100,25700,"Sub-basin 6"
2944,800,78,3400,4200,"Sub-basin 6"
2945,400,26,2200,2600,"Sub-basin 6"
2946,100,1,3000,3100,"Sub-basin 6"
2947,600,166,3500,4100,"Sub-basin 6"
2948,12500,4921,28400,40900,"Sub-basin 6"
2949,800,126,8300,9100,"Sub-basin 6"
2950,700,43,10900,11600,"Sub-basin 6"
2951,2000,309,6200,8200,"Sub-basin 6"
2952,900,86,5300,6200,"Sub-basin 6"
2953,100,1,1400,1500,"Sub-basin 6"
2954,1700,206,7400,9100,"Sub-basin 6"
2955,5700,1510,14400,20100,"Sub-basin 6"
2956,100,2,800,900,"Sub-basin 6"
2957,100,3,1000,1100,"Sub-basin 6"
2958,8200,4835,10300,18500,"Sub-basin 6"
2959,200,2.004,2600,2800,"Sub-basin 6"
2960,100,1,400,500,"Sub-basin 6"
2961,300,12,2100,2400,"Sub-basin 6"
2962,1700,377,5700,7400,"Sub-basin 6"
2963,5600,1676,13600,19200,"Sub-basin 6"
2964,400,36,4000,4400,"Sub-basin 6"
2965,500,127,3700,4200,"Sub-basin 6"
2966,17500,8787,35900,53400,"Sub-basin 6"
2967,1900,441,12700,14600,"Sub-basin 6"
2968,2600,523,14100,16700,"Sub-basin 6"
2969,700,97,4100,4800,"Sub-basin 6"
2970,400,24,3300,3700,"Sub-basin 6"
2971,200,22,1600,1800,"Sub-basin 6"
2972,2900,452,10300,13200,"Sub-basin 6"
2973,700,95,6200,6900,"Sub-basin 6"
2974,500,23,4100,4600,"Sub-basin 6"
2975,3400,788,23500,26900,"Sub-basin 6"
2976,2400,531,12000,14400,"Sub-basin 6"
2977,3700,1571,7400,11100,"Sub-basin 6"
2978,200,4,2200,2400,"Sub-basin 6"
2979,100,1,2300,2400,"Sub-basin 6"
2980,400,59,3400,3800,"Sub-basin 6"
2981,700,71,2900,3600,"Sub-basin 6"
2982,2900,231,9600,12500,"Sub-basin 6"
2983,1800,102,9600,11400,"Sub-basin 6"
2984,100,2,1300,1400,"Sub-basin 6"
2985,500,55,2500,3000,"Sub-basin 6"
2986,400,23,2500,2900,"Sub-basin 6"
2987,500,18,2300,2800,"Sub-basin 6"
2988,1400,128,7500,8900,"Sub-basin 6"
2989,200,4,2700,2900,"Sub-basin 6"
2990,400,22,1400,1800,"Sub-basin 6"
2991,600,51,2000,2600,"Sub-basin 6"
2992,7500,2223,13600,21100,"Sub-basin 6"
2993,200,4.0032,3900,4100,"Sub-basin 6"
2994,1000,51,9300,10300,"Sub-basin 6"
2995,100,5,1700,1800,"Sub-basin 6"
2996,100,2.0019,2300,2400,"Sub-basin 6"
2997,900,115,5000,5900,"Sub-basin 6"
2998,400,33,1600,2000,"Sub-basin 6"
2999,1200,182,7900,9100,"Sub-basin 6"
3000,100,5,200,300,"Sub-basin 6"
3001,100,3,600,700,"Sub-basin 6"
3002,100,1,2300,2400,"Sub-basin 6"
3003,4500,1480,6400,10900,"Sub-basin 6"
3004,100,1,1300,1400,"Sub-basin 6"
3005,4800,649,7100,11900,"Sub-basin 6"
3006,2400,242.0216,16100,18500,"Sub-basin 6"
3007,200,4.0337,3500,3700,"Sub-basin 6"
3008,400,10.009,3800,4200,"Sub-basin 6"
3009,800,58,3900,4700,"Sub-basin 6"
3010,800,129,2400,3200,"Sub-basin 6"
3011,1500,243,5900,7400,"Sub-basin 6"
3012,1000,188,2900,3900,"Sub-basin 6"
3013,100,2,900,1000,"Sub-basin 6"
3014,1200,116,3900,5100,"Sub-basin 6"
3015,9000,2340,18300,27300,"Sub-basin 6"
3016,100,5,2000,2100,"Sub-basin 6"
3017,100,1.0015,2100,2200,"Sub-basin 6"
3018,1600,269,5200,6800,"Sub-basin 6"
3019,200,2,1400,1600,"Sub-basin 6"
3020,600,86,2100,2700,"Sub-basin 6"
3021,100,1.0014,2700,2800,"Sub-basin 6"
3022,300,13,1900,2200,"Sub-basin 6"
3023,100,1,200,300,"Sub-basin 6"
3024,1100,124,4900,6000,"Sub-basin 6"
3025,400,7.01,6900,7300,"Sub-basin 6"
3026,1300,213,7700,9000,"Sub-basin 6"
3027,200,5,1500,1700,"Sub-basin 6"
3028,1500,390,6000,7500,"Sub-basin 6"
3029,800,82,4300,5100,"Sub-basin 6"
3030,400,88,3200,3600,"Sub-basin 6"
3031,200,9,3600,3800,"Sub-basin 6"
3032,400,8,3500,3900,"Sub-basin 6"
3033,600,83,4900,5500,"Sub-basin 6"
3034,1100,299,3000,4100,"Sub-basin 6"
3035,100,1,500,600,"Sub-basin 6"
3036,200,6,3300,3500,"Sub-basin 6"
3037,100,5,1100,1200,"Sub-basin 6"
3038,8200,2395,13200,21400,"Sub-basin 6"
3039,200,2,1100,1300,"Sub-basin 6"
3040,400,43,4800,5200,"Sub-basin 6"
3041,14800,7052,23100,37900,"Sub-basin 6"
3042,15500,1862.9309,105200,120700,"Sub-basin 6"
3043,2000,276,5000,7000,"Sub-basin 6"
3044,200,20,1000,1200,"Sub-basin 6"
3045,300,17,700,1000,"Sub-basin 6"
3046,6900,1503,15100,22000,"Sub-basin 6"
3047,100,2,600,700,"Sub-basin 6"
3048,800,55,2100,2900,"Sub-basin 6"
3049,6100,3374.5,11700,17800,"Sub-basin 6"
3050,300,10,400,700,"Sub-basin 6"
3051,200,11,700,900,"Sub-basin 6"
3052,200,2,1800,2000,"Sub-basin 6"
3053,100,1,700,800,"Sub-basin 6"
3054,1400,198,5100,6500,"Sub-basin 6"
3055,1400,129,7200,8600,"Sub-basin 6"
3056,2300,429,8700,11000,"Sub-basin 6"
3057,7900,2574,17000,24900,"Sub-basin 6"
3058,300,10.0076,5700,6000,"Sub-basin 6"
3059,6400,1837,11700,18100,"Sub-basin 6"
3060,800,106,2800,3600,"Sub-basin 6"
3061,1800,144,7400,9200,"Sub-basin 6"
3062,900,106,5300,6200,"Sub-basin 6"
3063,600,49,3400,4000,"Sub-basin 6"
3064,2600,877,8400,11000,"Sub-basin 6"
3065,500,66,2800,3300,"Sub-basin 6"
3066,5200,1016,10900,16100,"Sub-basin 6"
3067,1200,138,2100,3300,"Sub-basin 6"
3068,700,195,5200,5900,"Sub-basin 6"
3069,800,43,6200,7000,"Sub-basin 6"
3070,400,12.0061,5100,5500,"Sub-basin 6"
3071,2600,786,6200,8800,"Sub-basin 6"
3072,400,38,2200,2600,"Sub-basin 6"
3073,500,100,3400,3900,"Sub-basin 6"
3074,900,76,2700,3600,"Sub-basin 6"
3075,200,5,1000,1200,"Sub-basin 6"
3076,400,60,1000,1400,"Sub-basin 6"
3077,400,43,1300,1700,"Sub-basin 6"
3078,300,6,700,1000,"Sub-basin 6"
3079,500,77,4200,4700,"Sub-basin 6"
3080,300,10,800,1100,"Sub-basin 6"
3081,800,59.0147,13800,14600,"Sub-basin 6"
3082,100,1,800,900,"Sub-basin 6"
3083,400,61,1000,1400,"Sub-basin 6"
3084,1100,191,3000,4100,"Sub-basin 6"
3085,400,21,5900,6300,"Sub-basin 6"
3086,200,11,1400,1600,"Sub-basin 6"
3087,12400,5047,17800,30200,"Sub-basin 6"
3088,37200,10755,66200,103400,"Sub-basin 6"
3089,1400,143,5900,7300,"Sub-basin 6"
3090,200,5,5400,5600,"Sub-basin 6"
3091,200,8,4400,4600,"Sub-basin 6"
3092,1300,226,6800,8100,"Sub-basin 6"
3093,400,60,2200,2600,"Sub-basin 6"
3094,100,1,200,300,"Sub-basin 6"
3095,900,269,3300,4200,"Sub-basin 6"
3096,600,69,2400,3000,"Sub-basin 6"
3097,700,33.0169,11200,11900,"Sub-basin 6"
3098,3600,1211,13200,16800,"Sub-basin 6"
3099,200,9,900,1100,"Sub-basin 6"
3100,700,172,3600,4300,"Sub-basin 6"
3101,700,131,2200,2900,"Sub-basin 6"
3102,200,2,2400,2600,"Sub-basin 6"
3103,100,1,1100,1200,"Sub-basin 6"
3104,3100,523,11300,14400,"Sub-basin 6"
3105,900,120,3400,4300,"Sub-basin 6"
3106,100,15,1300,1400,"Sub-basin 6"
3107,1000,93,6300,7300,"Sub-basin 6"
3108,100,7,2400,2500,"Sub-basin 6"
3109,400,43,2200,2600,"Sub-basin 6"
3110,6300,2244,17400,23700,"Sub-basin 6"
3111,2600,515,4800,7400,"Sub-basin 6"
3112,100,1,500,600,"Sub-basin 6"
3113,100,4,1400,1500,"Sub-basin 6"
3114,800,107,2300,3100,"Sub-basin 6"
3115,1800,181.0388,17300,19100,"Sub-basin 6"
3116,100,1.0013,2100,2200,"Sub-basin 6"
3117,400,55,2600,3000,"Sub-basin 6"
3118,17100,6416,22400,39500,"Sub-basin 6"
3119,400,44,4800,5200,"Sub-basin 6"
3120,100,2.0016,1700,1800,"Sub-basin 6"
3121,400,20,2500,2900,"Sub-basin 6"
3122,1200,87,7900,9100,"Sub-basin 6"
3123,100,1,900,1000,"Sub-basin 6"
3124,1200,354,6800,8000,"Sub-basin 6"
3125,100,2,1200,1300,"Sub-basin 6"
3126,100,1,400,500,"Sub-basin 6"
3127,100,1.0023,1600,1700,"Sub-basin 6"
3128,200,6,2200,2400,"Sub-basin 6"
3129,400,62,4500,4900,"Sub-basin 6"
3130,500,44,2500,3000,"Sub-basin 6"
3131,400,61,1200,1600,"Sub-basin 6"
3132,600,127,1700,2300,"Sub-basin 6"
3133,1800,580,4000,5800,"Sub-basin 6"
3134,1600,196,5300,6900,"Sub-basin 6"
3135,2600,690,7100,9700,"Sub-basin 6"
3136,600,38,4700,5300,"Sub-basin 6"
3137,300,23,1900,2200,"Sub-basin 6"
3138,400,37,2900,3300,"Sub-basin 6"
3139,100,1,500,600,"Sub-basin 6"
3140,1500,281,3600,5100,"Sub-basin 6"
3141,1300,496,2400,3700,"Sub-basin 6"
3142,1200,213,2800,4000,"Sub-basin 6"
3143,1800,194.0987,26400,28200,"Sub-basin 6"
3144,500,44,4100,4600,"Sub-basin 6"
3145,100,1.0015,1900,2000,"Sub-basin 6"
3146,100,3.0018,4400,4500,"Sub-basin 6"
3147,200,3.0028,6700,6900,"Sub-basin 6"
3148,200,28.0084,5800,6000,"Sub-basin 6"
3149,200,7.0048,6400,6600,"Sub-basin 6"
3150,1200,175,2600,3800,"Sub-basin 6"
3151,25900,2372,92600,118500,"Sub-basin 6"
3152,100,3,500,600,"Sub-basin 6"
3153,300,9.0112,7100,7400,"Sub-basin 6"
3154,200,4.003,4700,4900,"Sub-basin 6"
3155,100,2,1100,1200,"Sub-basin 6"
3156,6000,1074,22700,28700,"Sub-basin 6"
3157,300,16,1000,1300,"Sub-basin 6"
3158,100,1,1300,1400,"Sub-basin 6"
3159,600,47,2100,2700,"Sub-basin 6"
3160,400,70,3300,3700,"Sub-basin 6"
3161,2600,397,10200,12800,"Sub-basin 6"
3162,200,8,1800,2000,"Sub-basin 6"
3163,100,4,800,900,"Sub-basin 6"
3164,2100,206,11600,13700,"Sub-basin 6"
3165,1600,149.0339,20500,22100,"Sub-basin 6"
3166,3400,1270,4700,8100,"Sub-basin 6"
3167,800,60,7500,8300,"Sub-basin 6"
3168,100,1,100,200,"Sub-basin 6"
3169,300,26,2100,2400,"Sub-basin 6"
3170,500,39,1600,2100,"Sub-basin 6"
3171,300,24,1800,2100,"Sub-basin 6"
3172,400,28,1100,1500,"Sub-basin 6"
3173,300,19,1400,1700,"Sub-basin 6"
3174,200,4,5000,5200,"Sub-basin 6"
3175,100,3,2200,2300,"Sub-basin 6"
3176,100,2,900,1000,"Sub-basin 6"
3177,2900,158,15700,18600,"Sub-basin 6"
3178,100,4,1100,1200,"Sub-basin 6"
3179,100,9,1700,1800,"Sub-basin 6"
3180,900,92,3600,4500,"Sub-basin 6"
3181,800,56,10600,11400,"Sub-basin 6"
3182,300,6,1800,2100,"Sub-basin 6"
3183,14600,7068,24700,39300,"Sub-basin 6"
3184,500,63,2000,2500,"Sub-basin 6"
3185,100,10,1500,1600,"Sub-basin 6"
3186,200,4,3700,3900,"Sub-basin 6"
3187,400,28,1800,2200,"Sub-basin 6"
3188,900,148,4900,5800,"Sub-basin 6"
3189,400,73,1900,2300,"Sub-basin 6"
3190,100,1,500,600,"Sub-basin 6"
3191,10500,3156,19700,30200,"Sub-basin 6"
3192,300,11,1300,1600,"Sub-basin 6"
3193,400,40,2000,2400,"Sub-basin 6"
3194,1800,134,18500,20300,"Sub-basin 6"
3195,1300,223,6800,8100,"Sub-basin 6"
3196,700,37,12300,13000,"Sub-basin 6"
3197,700,39,4800,5500,"Sub-basin 6"
3198,300,19,1800,2100,"Sub-basin 6"
3199,900,147,5400,6300,"Sub-basin 6"
3200,200,3,1000,1200,"Sub-basin 6"
3201,400,70,1700,2100,"Sub-basin 6"
3202,100,1,2000,2100,"Sub-basin 6"
3203,200,5.0042,5400,5600,"Sub-basin 6"
3204,100,1.003,1900,2000,"Sub-basin 6"
3205,1100,84,7800,8900,"Sub-basin 6"
3206,100,1,900,1000,"Sub-basin 6"
3207,3800,848,15500,19300,"Sub-basin 6"
3208,200,18,2800,3000,"Sub-basin 6"
3209,1200,232,7200,8400,"Sub-basin 6"
3210,300,27,4700,5000,"Sub-basin 6"
3211,100,3,400,500,"Sub-basin 6"
3212,900,302,5000,5900,"Sub-basin 6"
3213,2900,536,12200,15100,"Sub-basin 6"
3214,100,1,1400,1500,"Sub-basin 6"
3215,200,15,2700,2900,"Sub-basin 6"
3216,200,6,1100,1300,"Sub-basin 6"
3217,2900,439,5600,8500,"Sub-basin 6"
3218,900,124,3800,4700,"Sub-basin 6"
3219,500,74,3900,4400,"Sub-basin 6"
3220,400,6.0049,8700,9100,"Sub-basin 6"
3221,300,11,3000,3300,"Sub-basin 6"
3222,400,19,1800,2200,"Sub-basin 6"
3223,4900,1225,14200,19100,"Sub-basin 6"
3224,100,1,400,500,"Sub-basin 6"
3225,100,6,500,600,"Sub-basin 6"
3226,600,62,3200,3800,"Sub-basin 6"
3227,1000,111,2400,3400,"Sub-basin 6"
3228,100,3,500,600,"Sub-basin 6"
3229,1600,402,4400,6000,"Sub-basin 6"
3230,100,1,600,700,"Sub-basin 6"
3231,200,3,1900,2100,"Sub-basin 6"
3232,10200,1512,17400,27600,"Sub-basin 6"
3233,9000,2195,25000,34000,"Sub-basin 6"
3234,100,4,500,600,"Sub-basin 6"
3235,300,114,1200,1500,"Sub-basin 6"
3236,500,31,1100,1600,"Sub-basin 6"
3237,600,93,4200,4800,"Sub-basin 6"
3238,400,93,2400,2800,"Sub-basin 6"
3239,100,3,1100,1200,"Sub-basin 6"
3240,200,20,6200,6400,"Sub-basin 6"
3241,13000,2561,39800,52800,"Sub-basin 6"
3242,200,30,600,800,"Sub-basin 6"
3243,1000,204,3500,4500,"Sub-basin 6"
3244,41000,15985,48400,89400,"Sub-basin 6"
3245,400,9,6900,7300,"Sub-basin 6"
3246,400,27,3200,3600,"Sub-basin 6"
3247,600,60,3900,4500,"Sub-basin 6"
3248,300,52,2100,2400,"Sub-basin 6"
3249,100,2,100,200,"Sub-basin 6"
3250,200,3.0034,7200,7400,"Sub-basin 6"
3251,800,48,5300,6100,"Sub-basin 6"
3252,900,187,3900,4800,"Sub-basin 6"
3253,18700,7838,25900,44600,"Sub-basin 6"
3254,100,8,1100,1200,"Sub-basin 6"
3255,400,34,1300,1700,"Sub-basin 6"
3256,1000,225,3100,4100,"Sub-basin 6"
3257,200,7,3200,3400,"Sub-basin 6"
3258,100,3,1200,1300,"Sub-basin 6"
3259,100,5,600,700,"Sub-basin 6"
3260,1400,234,4600,6000,"Sub-basin 6"
3261,300,5,1000,1300,"Sub-basin 6"
3262,3000,482,12000,15000,"Sub-basin 6"
3263,600,135,2400,3000,"Sub-basin 6"
3264,2200,587,3200,5400,"Sub-basin 6"
3265,500,57,2500,3000,"Sub-basin 6"
3266,100,2,1300,1400,"Sub-basin 6"
3267,102600,26806,135600,238200,"Sub-basin 6"
3268,800,79,4500,5300,"Sub-basin 6"
3269,100,1,1600,1700,"Sub-basin 6"
3270,300,51,1300,1600,"Sub-basin 6"
3271,100,4,2100,2200,"Sub-basin 6"
3272,1700,269,6300,8000,"Sub-basin 6"
3273,4100,906,12300,16400,"Sub-basin 6"
3274,600,40,4700,5300,"Sub-basin 6"
3275,400,24,2700,3100,"Sub-basin 6"
3276,100,1,400,500,"Sub-basin 6"
3277,100,3,1800,1900,"Sub-basin 6"
3278,100,5,900,1000,"Sub-basin 6"
3279,300,8,400,700,"Sub-basin 6"
3280,300,10.0034,9600,9900,"Sub-basin 6"
3281,100,2,1100,1200,"Sub-basin 6"
3282,200,20,2400,2600,"Sub-basin 6"
3283,1800,339,7000,8800,"Sub-basin 6"
3284,100,3,1100,1200,"Sub-basin 6"
3285,100,2,1400,1500,"Sub-basin 6"
3286,1200,127,3200,4400,"Sub-basin 6"
3287,700,80,5100,5800,"Sub-basin 6"
3288,100,2,600,700,"Sub-basin 6"
3289,200,10,1300,1500,"Sub-basin 6"
3290,400,26,2400,2800,"Sub-basin 6"
3291,1200,335,4800,6000,"Sub-basin 6"
3292,200,3,1600,1800,"Sub-basin 6"
3293,7400,2067,18200,25600,"Sub-basin 6"
3294,13700,2022,29700,43400,"Sub-basin 6"
3295,500,20,3200,3700,"Sub-basin 6"
3296,400,51,2000,2400,"Sub-basin 6"
3297,200,4,1400,1600,"Sub-basin 6"
3298,1700,118,13100,14800,"Sub-basin 6"
3299,200,4,2600,2800,"Sub-basin 6"
3300,700,53,3200,3900,"Sub-basin 6"
3301,3900,627,16800,20700,"Sub-basin 6"
3302,200,9,800,1000,"Sub-basin 6"
3303,200,26,1200,1400,"Sub-basin 6"
3304,300,4,1100,1400,"Sub-basin 6"
3305,2800,681,6100,8900,"Sub-basin 6"
3306,3900,909,6700,10600,"Sub-basin 6"
3307,100,3,3800,3900,"Sub-basin 6"
3308,600,50,6200,6800,"Sub-basin 6"
3309,600,70,1900,2500,"Sub-basin 6"
3310,2000,355,5300,7300,"Sub-basin 6"
3311,900,36,5100,6000,"Sub-basin 6"
3312,900,49,3000,3900,"Sub-basin 6"
3313,300,24,1500,1800,"Sub-basin 6"
3314,100,1,2000,2100,"Sub-basin 6"
3315,600,22,5900,6500,"Sub-basin 6"
3316,1100,98,4700,5800,"Sub-basin 6"
3317,600,56,2600,3200,"Sub-basin 6"
3318,200,6,800,1000,"Sub-basin 6"
3319,800,98,4700,5500,"Sub-basin 6"
3320,4400,1121,12200,16600,"Sub-basin 6"
3321,20400,6918.84,30700,51100,"Sub-basin 6"
3322,1000,50.0209,23100,24100,"Sub-basin 6"
3323,300,20,3100,3400,"Sub-basin 6"
3324,100,2,800,900,"Sub-basin 6"
3325,9800,2986.66,14200,24000,"Sub-basin 6"
3326,200,8,1400,1600,"Sub-basin 6"
3327,200,7,1800,2000,"Sub-basin 6"
3328,700,75,5600,6300,"Sub-basin 6"
3329,1200,80,5300,6500,"Sub-basin 6"
3330,100,1,200,300,"Sub-basin 6"
3331,2800,770.33,8400,11200,"Sub-basin 6"
3332,100,3,1400,1500,"Sub-basin 6"
3333,4400,1004,20300,24700,"Sub-basin 6"
3334,1700,685,3000,4700,"Sub-basin 6"
3335,300,24,1200,1500,"Sub-basin 6"
3336,100,5,2800,2900,"Sub-basin 6"
3337,100,1,400,500,"Sub-basin 6"
3338,1700,138,5400,7100,"Sub-basin 6"
3339,800,123,3000,3800,"Sub-basin 6"
3340,1900,376.66,8600,10500,"Sub-basin 6"
3341,100,1,2300,2400,"Sub-basin 6"
3342,300,18,3200,3500,"Sub-basin 6"
3343,700,54,3600,4300,"Sub-basin 6"
3344,200,9,2500,2700,"Sub-basin 6"
3345,600,32,2300,2900,"Sub-basin 6"
3346,200,4,2500,2700,"Sub-basin 6"
3347,5300,1150,9100,14400,"Sub-basin 6"
3348,1400,380,2000,3400,"Sub-basin 6"
3349,100,2,2600,2700,"Sub-basin 6"
3350,100,1,2200,2300,"Sub-basin 6"
3351,400,18,1700,2100,"Sub-basin 6"
3352,900,384,3200,4100,"Sub-basin 6"
3353,300,4,4400,4700,"Sub-basin 6"
3354,300,16,8100,8400,"Sub-basin 6"
3355,100,3,1800,1900,"Sub-basin 6"
3356,4600,538,36200,40800,"Sub-basin 6"
3357,100,2,1700,1800,"Sub-basin 6"
3358,1400,253,3500,4900,"Sub-basin 6"
3359,700,70,6800,7500,"Sub-basin 6"
3360,3800,443,24500,28300,"Sub-basin 6"
3361,100,3,700,800,"Sub-basin 6"
3362,600,21,5400,6000,"Sub-basin 6"
3363,400,15.16,2700,3100,"Sub-basin 6"
3364,400,24,5200,5600,"Sub-basin 6"
3365,600,21,3400,4000,"Sub-basin 6"
3366,200,5.34,900,1100,"Sub-basin 6"
3367,300,12,1400,1700,"Sub-basin 6"
3368,100,2,800,900,"Sub-basin 6"
3369,300,10,2400,2700,"Sub-basin 6"
3370,100,1,500,600,"Sub-basin 6"
3371,100,2,600,700,"Sub-basin 6"
3372,800,120,4000,4800,"Sub-basin 6"
3373,300,12.013,10100,10400,"Sub-basin 6"
3374,600,59,5300,5900,"Sub-basin 6"
3375,100,4,1600,1700,"Sub-basin 6"
3376,1400,255,8600,10000,"Sub-basin 6"
3377,1700,236,3900,5600,"Sub-basin 6"
3378,400,36,4100,4500,"Sub-basin 6"
3379,500,53,1900,2400,"Sub-basin 6"
3380,400,22,3000,3400,"Sub-basin 6"
3381,200,15,1100,1300,"Sub-basin 6"
3382,1900,161,11900,13800,"Sub-basin 6"
3383,200,6,2500,2700,"Sub-basin 6"
3384,400,70,1300,1700,"Sub-basin 6"
3385,100,3,800,900,"Sub-basin 6"
3386,200,14,1300,1500,"Sub-basin 6"
3387,100,1,800,900,"Sub-basin 6"
3388,3500,406,21000,24500,"Sub-basin 6"
3389,100,2,400,500,"Sub-basin 6"
3390,100,2,1200,1300,"Sub-basin 6"
3391,100,5,1600,1700,"Sub-basin 6"
3392,100,2,800,900,"Sub-basin 6"
3393,100,7,300,400,"Sub-basin 6"
3394,300,14,1900,2200,"Sub-basin 6"
3395,15400,3944,28100,43500,"Sub-basin 6"
3396,200,10.0038,6100,6300,"Sub-basin 6"
3397,200,9,2500,2700,"Sub-basin 6"
3398,15100,3871,85100,100200,"Sub-basin 6"
3399,1200,138,14200,15400,"Sub-basin 6"
3400,100,1,700,800,"Sub-basin 6"
3401,700,77,3200,3900,"Sub-basin 6"
3402,100,1,500,600,"Sub-basin 6"
3403,600,54,6700,7300,"Sub-basin 6"
3404,100,13,900,1000,"Sub-basin 6"
3405,300,9,3800,4100,"Sub-basin 6"
3406,100,20,1100,1200,"Sub-basin 6"
3407,1700,134,11400,13100,"Sub-basin 6"
3408,100,4,1700,1800,"Sub-basin 6"
3409,500,28,8900,9400,"Sub-basin 6"
3410,400,19,3800,4200,"Sub-basin 6"
3411,600,58,3700,4300,"Sub-basin 6"
3412,100,2,1200,1300,"Sub-basin 6"
3413,6300,654,34300,40600,"Sub-basin 6"
3414,100,2,1000,1100,"Sub-basin 6"
3415,100,1,500,600,"Sub-basin 6"
3416,200,15,900,1100,"Sub-basin 6"
3417,13200,2005.7999,184100,197300,"Sub-basin 6"
3418,400,27,3700,4100,"Sub-basin 6"
3419,5600,1674,7900,13500,"Sub-basin 6"
3420,2800,346,5600,8400,"Sub-basin 6"
3421,1500,146,17800,19300,"Sub-basin 6"
3422,700,32,5900,6600,"Sub-basin 6"
3423,900,120,7800,8700,"Sub-basin 6"
3424,200,12,2400,2600,"Sub-basin 6"
3425,300,10,4100,4400,"Sub-basin 6"
3426,100,7,2000,2100,"Sub-basin 6"
3427,600,81,4000,4600,"Sub-basin 6"
3428,200,7,1000,1200,"Sub-basin 6"
3429,100,2,600,700,"Sub-basin 6"
3430,900,46,8300,9200,"Sub-basin 6"
3431,600,38,5900,6500,"Sub-basin 6"
3432,1200,62,5000,6200,"Sub-basin 6"
3433,200,5,900,1100,"Sub-basin 6"
3434,21300,4797,55000,76300,"Sub-basin 6"
3435,2500,621,5300,7800,"Sub-basin 6"
3436,200,17,2000,2200,"Sub-basin 6"
3437,100,5,1900,2000,"Sub-basin 6"
3438,800,67,1000,1800,"Sub-basin 6"
3439,700,83,4000,4700,"Sub-basin 6"
3440,100,1,300,400,"Sub-basin 6"
3441,1400,45,13200,14600,"Sub-basin 6"
3442,200,5,1700,1900,"Sub-basin 6"
3443,500,34,2400,2900,"Sub-basin 6"
3444,2000,348,9200,11200,"Sub-basin 6"
3445,300,23,1900,2200,"Sub-basin 6"
3446,100,1,1800,1900,"Sub-basin 6"
3447,100,1,2100,2200,"Sub-basin 6"
3448,100,4,900,1000,"Sub-basin 6"
3449,400,65,1300,1700,"Sub-basin 6"
3450,200,5,2700,2900,"Sub-basin 6"
3451,100,2,2800,2900,"Sub-basin 6"
3452,900,68,10300,11200,"Sub-basin 6"
3453,200,6,5200,5400,"Sub-basin 6"
3454,100,1,700,800,"Sub-basin 6"
3455,100,4,1500,1600,"Sub-basin 6"
3456,218000,82007.5,186100,404100,"Sub-basin 6"
3457,800,129,2300,3100,"Sub-basin 6"
3458,100,3,1300,1400,"Sub-basin 6"
3459,900,36,5100,6000,"Sub-basin 6"
3460,1100,208,3300,4400,"Sub-basin 6"
3461,100,2,1100,1200,"Sub-basin 6"
3462,1100,371,5800,6900,"Sub-basin 6"
3463,200,2,3900,4100,"Sub-basin 6"
3464,7900,802,49700,57600,"Sub-basin 6"
3465,100,3,2600,2700,"Sub-basin 6"
3466,200,3,2700,2900,"Sub-basin 6"
3467,100,2,1100,1200,"Sub-basin 6"
3468,200,12,2900,3100,"Sub-basin 6"
3469,400,31,4400,4800,"Sub-basin 6"
3470,300,21,4900,5200,"Sub-basin 6"
3471,800,48,3000,3800,"Sub-basin 6"
3472,30800,5182,98700,129500,"Sub-basin 6"
3473,200,2,2000,2200,"Sub-basin 6"
3474,1300,283,3100,4400,"Sub-basin 6"
3475,500,41,5600,6100,"Sub-basin 6"
3476,200,10,3000,3200,"Sub-basin 6"
3477,800,31,5400,6200,"Sub-basin 6"
3478,900,218,2300,3200,"Sub-basin 6"
3479,4100,1301,8300,12400,"Sub-basin 6"
3480,1400,58,10100,11500,"Sub-basin 6"
3481,300,9,2900,3200,"Sub-basin 6"
3482,2700,219,28900,31600,"Sub-basin 6"
3483,300,14,1900,2200,"Sub-basin 6"
3484,1000,322,1800,2800,"Sub-basin 6"
3485,700,39,2800,3500,"Sub-basin 6"
3486,100,2,2200,2300,"Sub-basin 6"
3487,1000,82,12300,13300,"Sub-basin 6"
3488,700,99,2500,3200,"Sub-basin 6"
3489,100,6,2200,2300,"Sub-basin 6"
3490,400,15,5100,5500,"Sub-basin 6"
3491,600,72,5500,6100,"Sub-basin 6"
3492,700,59,4100,4800,"Sub-basin 6"
3493,400,17,1400,1800,"Sub-basin 6"
3494,9300,3522,10200,19500,"Sub-basin 6"
3495,400,39,4100,4500,"Sub-basin 6"
3496,2100,193,22000,24100,"Sub-basin 6"
3497,100,11,2400,2500,"Sub-basin 6"
3498,100,6,1200,1300,"Sub-basin 6"
3499,1000,109,10800,11800,"Sub-basin 6"
3500,300,38,4300,4600,"Sub-basin 6"
3501,100,2,700,800,"Sub-basin 6"
3502,100,4,2600,2700,"Sub-basin 6"
3503,400,4,2400,2800,"Sub-basin 6"
3504,100,2,1300,1400,"Sub-basin 6"
3505,100,4,1200,1300,"Sub-basin 6"
3506,800,25,4000,4800,"Sub-basin 6"
3507,100,5,1400,1500,"Sub-basin 6"
3508,100,3,1500,1600,"Sub-basin 6"
3509,100,10,1000,1100,"Sub-basin 6"
3510,300,24,900,1200,"Sub-basin 6"
3511,800,74,6700,7500,"Sub-basin 6"
3512,400,20,1100,1500,"Sub-basin 6"
3513,400,51,3600,4000,"Sub-basin 6"
3514,200,4,800,1000,"Sub-basin 6"
3515,2000,127,14900,16900,"Sub-basin 6"
3516,5200,995,30500,35700,"Sub-basin 6"
3517,1700,144,9800,11500,"Sub-basin 6"
3518,300,9,800,1100,"Sub-basin 6"
3519,7800,2102,16600,24400,"Sub-basin 6"
3520,600,116,2600,3200,"Sub-basin 6"
3521,300,22,700,1000,"Sub-basin 6"
3522,1700,123,11800,13500,"Sub-basin 6"
3523,200,6,1500,1700,"Sub-basin 6"
3524,100,1,1600,1700,"Sub-basin 6"
3525,100,2,1300,1400,"Sub-basin 6"
3526,1300,168,9200,10500,"Sub-basin 6"
3527,400,18,1200,1600,"Sub-basin 6"
3528,1500,1011,1700,3200,"Sub-basin 6"
3529,200,15,2600,2800,"Sub-basin 6"
3530,100,2,1400,1500,"Sub-basin 6"
3531,100,2,400,500,"Sub-basin 6"
3532,5500,1351,17800,23300,"Sub-basin 6"
3533,200,2,2300,2500,"Sub-basin 6"
3534,10000,3005,12000,22000,"Sub-basin 6"
3535,900,252,2200,3100,"Sub-basin 6"
3536,400,44,3700,4100,"Sub-basin 6"
3537,100,1,1100,1200,"Sub-basin 6"
3538,400,39,3100,3500,"Sub-basin 6"
3539,3000,208,18400,21400,"Sub-basin 6"
3540,1600,268,9400,11000,"Sub-basin 6"
3541,100,4,300,400,"Sub-basin 6"
3542,400,36,3600,4000,"Sub-basin 6"
3543,100,3,1100,1200,"Sub-basin 6"
3544,800,118,3700,4500,"Sub-basin 6"
3545,2400,500,5700,8100,"Sub-basin 6"
3546,400,74,800,1200,"Sub-basin 6"
3547,1000,74,6400,7400,"Sub-basin 6"
3548,100,3,1100,1200,"Sub-basin 6"
3549,100,5,300,400,"Sub-basin 6"
3550,1200,196,7700,8900,"Sub-basin 6"
3551,100,1,300,400,"Sub-basin 6"
3552,300,21,3400,3700,"Sub-basin 6"
3553,100,4,2000,2100,"Sub-basin 6"
3554,100,5,1900,2000,"Sub-basin 6"
3555,200,16,2900,3100,"Sub-basin 6"
3556,100,5,500,600,"Sub-basin 6"
3557,100,1,2700,2800,"Sub-basin 6"
3558,5200,1791,19000,24200,"Sub-basin 6"
3559,3400,583,14400,17800,"Sub-basin 6"
3560,100,5,500,600,"Sub-basin 6"
3561,1900,1135,1700,3600,"Sub-basin 6"
3562,200,5,2200,2400,"Sub-basin 6"
3563,100,2,900,1000,"Sub-basin 6"
3564,2600,374,19300,21900,"Sub-basin 6"
3565,19800,9398,20200,40000,"Sub-basin 6"
3566,400,32,1600,2000,"Sub-basin 6"
3567,100,8,1600,1700,"Sub-basin 6"
3568,100,5,1600,1700,"Sub-basin 6"
3569,600,38,2000,2600,"Sub-basin 6"
3570,500,59,2900,3400,"Sub-basin 6"
3571,600,36,800,1400,"Sub-basin 6"
3572,400,34,5700,6100,"Sub-basin 6"
3573,1300,145,7300,8600,"Sub-basin 6"
3574,800,155,5000,5800,"Sub-basin 6"
3575,2700,501,10800,13500,"Sub-basin 6"
3576,9800,3056,12200,22000,"Sub-basin 6"
3577,200,10,3400,3600,"Sub-basin 6"
3578,600,37,6900,7500,"Sub-basin 6"
3579,1300,225,6300,7600,"Sub-basin 6"
3580,1000,320,800,1800,"Sub-basin 6"
3581,1600,110,18700,20300,"Sub-basin 6"
3582,200,4,5500,5700,"Sub-basin 6"
3583,1700,175,13600,15300,"Sub-basin 6"
3584,400,16,1700,2100,"Sub-basin 6"
3585,600,92,3100,3700,"Sub-basin 6"
3586,10000,1651,69500,79500,"Sub-basin 6"
3587,300,9,4900,5200,"Sub-basin 6"
3588,200,10,5100,5300,"Sub-basin 6"
3589,300,13,1900,2200,"Sub-basin 6"
3590,800,73,3300,4100,"Sub-basin 6"
3591,800,187,4300,5100,"Sub-basin 6"
3592,100,2,1300,1400,"Sub-basin 6"
3593,238200,127192.84,222600,460800,"Sub-basin 6"
3594,100,3,400,500,"Sub-basin 6"
3595,200,6,1200,1400,"Sub-basin 6"
3596,600,83,3100,3700,"Sub-basin 6"
3597,100,1,1700,1800,"Sub-basin 6"
3598,100,5,1700,1800,"Sub-basin 6"
3599,1700,98,11000,12700,"Sub-basin 6"
3600,100,1,600,700,"Sub-basin 6"
3601,200,7,1400,1600,"Sub-basin 6"
3602,2800,557,10700,13500,"Sub-basin 6"
3603,1400,159,19600,21000,"Sub-basin 6"
3604,100,2,600,700,"Sub-basin 6"
3605,400,12,1600,2000,"Sub-basin 6"
3606,113700,42270.67,138300,252000,"Sub-basin 6"
3607,400,23,4800,5200,"Sub-basin 6"
3608,1000,92,4400,5400,"Sub-basin 6"
3609,100,1,700,800,"Sub-basin 6"
3610,600,65,3300,3900,"Sub-basin 6"
3611,1400,133,13900,15300,"Sub-basin 6"
3612,100,1,2000,2100,"Sub-basin 6"
3613,100,5,2000,2100,"Sub-basin 6"
3614,200,2,1600,1800,"Sub-basin 6"
3615,100,1,100,200,"Sub-basin 6"
3616,700,64,2200,2900,"Sub-basin 6"
3617,100,2,1100,1200,"Sub-basin 6"
3618,200,19,1600,1800,"Sub-basin 6"
3619,2000,457,4400,6400,"Sub-basin 6"
3620,600,80,2200,2800,"Sub-basin 6"
3621,200,3,4500,4700,"Sub-basin 6"
3622,100,1,2800,2900,"Sub-basin 6"
3623,300,14,2800,3100,"Sub-basin 6"
3624,100,1,1000,1100,"Sub-basin 6"
3625,100,3,500,600,"Sub-basin 6"
3626,3600,986,20300,23900,"Sub-basin 6"
3627,100,2,1000,1100,"Sub-basin 6"
3628,300,17,2700,3000,"Sub-basin 6"
3629,400,61,1300,1700,"Sub-basin 6"
3630,2000,824,2400,4400,"Sub-basin 6"
3631,100,2,1200,1300,"Sub-basin 6"
3632,300,6,5300,5600,"Sub-basin 6"
3633,500,45,2400,2900,"Sub-basin 6"
3634,1400,174,6200,7600,"Sub-basin 6"
3635,800,93,3900,4700,"Sub-basin 6"
3636,600,51,2500,3100,"Sub-basin 6"
3637,700,89,2100,2800,"Sub-basin 6"
3638,1000,120,3800,4800,"Sub-basin 6"
3639,1300,419,3300,4600,"Sub-basin 6"
3640,100,1,1200,1300,"Sub-basin 6"
3641,100,4,2000,2100,"Sub-basin 6"
3642,3400,953,4400,7800,"Sub-basin 6"
3643,1400,207,9400,10800,"Sub-basin 6"
3644,600,105,1100,1700,"Sub-basin 6"
3645,200,7,3100,3300,"Sub-basin 6"
3646,500,24,4300,4800,"Sub-basin 6"
3647,1100,229,3000,4100,"Sub-basin 6"
3648,100,1,1000,1100,"Sub-basin 6"
3649,200,21,1200,1400,"Sub-basin 6"
3650,100,1,500,600,"Sub-basin 6"
3651,7100,2138,19700,26800,"Sub-basin 6"
3652,2800,337,39700,42500,"Sub-basin 6"
3653,1600,105,23500,25100,"Sub-basin 6"
3654,1000,199,2700,3700,"Sub-basin 6"
3655,1000,165,2900,3900,"Sub-basin 6"
3656,1200,301,5300,6500,"Sub-basin 6"
3657,100,3,700,800,"Sub-basin 6"
3658,1800,378,5700,7500,"Sub-basin 6"
3659,200,8,1900,2100,"Sub-basin 6"
3660,300,45,1400,1700,"Sub-basin 6"
3661,200,3,300,500,"Sub-basin 6"
3662,2000,236,7700,9700,"Sub-basin 6"
3663,2300,518,7400,9700,"Sub-basin 6"
3664,1700,284,6300,8000,"Sub-basin 6"
3665,300,15,4000,4300,"Sub-basin 6"
3666,200,3,1400,1600,"Sub-basin 6"
3667,4100,877,3400,7500,"Sub-basin 6"
3668,800,175,1500,2300,"Sub-basin 6"
3669,100,1,3400,3500,"Sub-basin 6"
3670,600,81,6600,7200,"Sub-basin 6"
3671,400,17,2600,3000,"Sub-basin 6"
3672,100,2,1000,1100,"Sub-basin 6"
3673,100,1,1600,1700,"Sub-basin 6"
3674,100,5,700,800,"Sub-basin 6"
3675,100,1,600,700,"Sub-basin 6"
3676,500,42,1900,2400,"Sub-basin 6"
3677,100,1,1000,1100,"Sub-basin 6"
3678,700,97,2200,2900,"Sub-basin 6"
3679,100,1,1900,2000,"Sub-basin 6"
3680,1400,344,2500,3900,"Sub-basin 6"
3681,200,12,1300,1500,"Sub-basin 6"
3682,800,64,4000,4800,"Sub-basin 6"
3683,3800,1363,7600,11400,"Sub-basin 6"
3684,600,44,8100,8700,"Sub-basin 6"
3685,1200,185,4700,5900,"Sub-basin 6"
3686,800,239,1200,2000,"Sub-basin 6"
3687,1000,374,1600,2600,"Sub-basin 6"
3688,12400,3449,17400,29800,"Sub-basin 6"
3689,300,11,2000,2300,"Sub-basin 6"
3690,100,2,1000,1100,"Sub-basin 6"
3691,400,45,4800,5200,"Sub-basin 6"
3692,100,3,1600,1700,"Sub-basin 6"
3693,700,12,7100,7800,"Sub-basin 6"
3694,1600,397,4600,6200,"Sub-basin 6"
3695,100,2,700,800,"Sub-basin 6"
3696,2300,378,7100,9400,"Sub-basin 6"
3697,1400,392,7200,8600,"Sub-basin 6"
3698,800,54,5000,5800,"Sub-basin 6"
3699,600,154,4300,4900,"Sub-basin 6"
3700,700,129,1700,2400,"Sub-basin 6"
3701,100,31,1200,1300,"Sub-basin 6"
3702,100,5,1400,1500,"Sub-basin 6"
3703,100,3,2000,2100,"Sub-basin 6"
3704,300,37,1900,2200,"Sub-basin 6"
3705,600,35,2000,2600,"Sub-basin 6"
3706,200,97,4400,4600,"Sub-basin 6"
3707,300,116,4400,4700,"Sub-basin 6"
3708,100,2,2400,2500,"Sub-basin 6"
3709,600,78,800,1400,"Sub-basin 6"
3710,800,71,4100,4900,"Sub-basin 6"
3711,200,147,4000,4200,"Sub-basin 6"
3712,200,60,1900,2100,"Sub-basin 6"
3713,49300,14068.67,197300,246600,"Sub-basin 6"
3714,300,5,6200,6500,"Sub-basin 6"
3715,300,11,2300,2600,"Sub-basin 6"
3716,200,3,2000,2200,"Sub-basin 6"
3717,100,1,1400,1500,"Sub-basin 6"
3718,1400,232,12300,13700,"Sub-basin 6"
3719,4500,768,9200,13700,"Sub-basin 6"
3720,200,8,1200,1400,"Sub-basin 6"
3721,100,1,1200,1300,"Sub-basin 6"
3722,200,11,4300,4500,"Sub-basin 6"
3723,2900,212.0699,33300,36200,"Sub-basin 6"
3724,400,118,1400,1800,"Sub-basin 6"
3725,400,41,5500,5900,"Sub-basin 6"
3726,1900,220,10100,12000,"Sub-basin 6"
3727,1300,1037,3600,4900,"Sub-basin 6"
3728,200,18,1400,1600,"Sub-basin 6"
3729,100,2,900,1000,"Sub-basin 6"
3730,1100,271,3500,4600,"Sub-basin 6"
3731,700,48,5600,6300,"Sub-basin 6"
3732,200,11,2100,2300,"Sub-basin 6"
3733,100,1,600,700,"Sub-basin 6"
3734,400,33,800,1200,"Sub-basin 6"
3735,1300,142,4500,5800,"Sub-basin 6"
3736,5000,1453,18900,23900,"Sub-basin 6"
3737,100,1,500,600,"Sub-basin 6"
3738,400,17,7000,7400,"Sub-basin 6"
3739,4200,1241,4300,8500,"Sub-basin 6"
3740,2400,372,6300,8700,"Sub-basin 6"
3741,400,11,1000,1400,"Sub-basin 6"
3742,600,115,1000,1600,"Sub-basin 6"
3743,100,4,1000,1100,"Sub-basin 6"
3744,600,48,8000,8600,"Sub-basin 6"
3745,700,47,6000,6700,"Sub-basin 6"
3746,1000,260,3700,4700,"Sub-basin 6"
3747,100,1,1500,1600,"Sub-basin 6"
3748,100,5,2500,2600,"Sub-basin 6"
3749,100,1,1700,1800,"Sub-basin 6"
3750,500,38,4500,5000,"Sub-basin 6"
3751,300,233,2400,2700,"Sub-basin 6"
3752,400,35,1300,1700,"Sub-basin 6"
3753,800,71,4400,5200,"Sub-basin 6"
3754,600,71,5000,5600,"Sub-basin 6"
3755,100,2,1100,1200,"Sub-basin 6"
3756,500,47,1500,2000,"Sub-basin 6"
3757,700,42.0196,13700,14400,"Sub-basin 6"
3758,900,114,10400,11300,"Sub-basin 6"
3759,100,1,900,1000,"Sub-basin 6"
3760,200,13,1300,1500,"Sub-basin 6"
3761,2700,530,7200,9900,"Sub-basin 6"
3762,1400,517.2604,12300,13700,"Sub-basin 6"
3763,200,12,4400,4600,"Sub-basin 6"
3764,23800,4275.8493,197900,221700,"Sub-basin 6"
3765,300,18,5300,5600,"Sub-basin 6"
3766,300,18,4500,4800,"Sub-basin 6"
3767,900,78,4000,4900,"Sub-basin 6"
3768,100,1,2700,2800,"Sub-basin 6"
3769,900,248,3600,4500,"Sub-basin 6"
3770,200,7,1200,1400,"Sub-basin 6"
3771,3300,707,10800,14100,"Sub-basin 6"
3772,400,53,2600,3000,"Sub-basin 6"
3773,200,3,1500,1700,"Sub-basin 6"
3774,400,20,4800,5200,"Sub-basin 6"
3775,1400,482,3700,5100,"Sub-basin 6"
3776,400,20,2400,2800,"Sub-basin 6"
3777,400,28,1400,1800,"Sub-basin 6"
3778,600,79,3500,4100,"Sub-basin 6"
3779,100,1.0019,2000,2100,"Sub-basin 6"
3780,200,7,1100,1300,"Sub-basin 6"
3781,300,11,2600,2900,"Sub-basin 6"
3782,3500,820,8100,11600,"Sub-basin 6"
3783,100,1,900,1000,"Sub-basin 6"
3784,100,1,3000,3100,"Sub-basin 6"
3785,200,10,5200,5400,"Sub-basin 6"
3786,300,16,6500,6800,"Sub-basin 6"
3787,300,26,1100,1400,"Sub-basin 6"
3788,1000,76,2800,3800,"Sub-basin 6"
3789,100,0.5,900,1000,"Sub-basin 6"
3790,100,1,1100,1200,"Sub-basin 6"
3791,11700,1971.66,57100,68800,"Sub-basin 6"
3792,100,1,1200,1300,"Sub-basin 6"
3793,400,30,2300,2700,"Sub-basin 6"
3794,400,88,1500,1900,"Sub-basin 6"
3795,900,74,4900,5800,"Sub-basin 6"
3796,700,90,2900,3600,"Sub-basin 6"
3797,1200,194,3700,4900,"Sub-basin 6"
3798,400,40,1100,1500,"Sub-basin 6"
3799,400,19,8000,8400,"Sub-basin 6"
3800,200,8,1900,2100,"Sub-basin 6"
3801,100,1,900,1000,"Sub-basin 6"
3802,200,6,1100,1300,"Sub-basin 6"
3803,1300,389,4000,5300,"Sub-basin 6"
3804,34600,8440,71200,105800,"Sub-basin 6"
3805,600,30,4800,5400,"Sub-basin 6"
3806,600,160,1200,1800,"Sub-basin 6"
3807,1000,209,3900,4900,"Sub-basin 6"
3808,700,140,3000,3700,"Sub-basin 6"
3809,100,1,2800,2900,"Sub-basin 6"
3810,100,7,2000,2100,"Sub-basin 6"
3811,17600,4944,28300,45900,"Sub-basin 6"
3812,100,6,500,600,"Sub-basin 6"
3813,500,17,2600,3100,"Sub-basin 6"
3814,100,2,1100,1200,"Sub-basin 6"
3815,100,1,1500,1600,"Sub-basin 6"
3816,1600,323,3800,5400,"Sub-basin 6"
3817,100,1,1900,2000,"Sub-basin 6"
3818,200,18,2000,2200,"Sub-basin 6"
3819,6000,1413,9100,15100,"Sub-basin 6"
3820,100,1,900,1000,"Sub-basin 6"
3821,2400,463,6700,9100,"Sub-basin 6"
3822,200,5,3100,3300,"Sub-basin 6"
3823,800,141,1900,2700,"Sub-basin 6"
3824,1100,71,5000,6100,"Sub-basin 6"
3825,1000,130,1600,2600,"Sub-basin 6"
3826,100,2,3300,3400,"Sub-basin 6"
3827,100,3,700,800,"Sub-basin 6"
3828,500,29,3400,3900,"Sub-basin 6"
3829,900,62,11700,12600,"Sub-basin 6"
3830,900,103,8100,9000,"Sub-basin 6"
3831,600,97,2500,3100,"Sub-basin 6"
3832,1800,624,3800,5600,"Sub-basin 6"
3833,400,66,3400,3800,"Sub-basin 6"
3834,200,5,800,1000,"Sub-basin 6"
3835,200,4,5900,6100,"Sub-basin 6"
3836,3100,710,12400,15500,"Sub-basin 6"
3837,1300,270,4100,5400,"Sub-basin 6"
3838,400,30,2400,2800,"Sub-basin 6"
3839,200,4,4600,4800,"Sub-basin 6"
3840,100,2,900,1000,"Sub-basin 6"
3841,500,13,4700,5200,"Sub-basin 6"
3842,100,2,1700,1800,"Sub-basin 6"
3843,300,17,3300,3600,"Sub-basin 6"
3844,100,2,1400,1500,"Sub-basin 6"
3845,200,10,7700,7900,"Sub-basin 6"
3846,900,108,2700,3600,"Sub-basin 6"
3847,1200,274,3200,4400,"Sub-basin 6"
3848,3300,531,8600,11900,"Sub-basin 6"
3849,500,34,700,1200,"Sub-basin 6"
3850,200,15,900,1100,"Sub-basin 6"
3851,600,25,2300,2900,"Sub-basin 6"
3852,100,1,700,800,"Sub-basin 6"
3853,100,4,500,600,"Sub-basin 6"
3854,18900,10104,17700,36600,"Sub-basin 6"
3855,90400,26390,109800,200200,"Sub-basin 6"
3856,2100,586,6500,8600,"Sub-basin 6"
3857,12700,3760,18300,31000,"Sub-basin 6"
3858,400,7,7900,8300,"Sub-basin 6"
3859,1100,166,3400,4500,"Sub-basin 6"
3860,200,7,2000,2200,"Sub-basin 6"
3861,100,2,2700,2800,"Sub-basin 6"
3862,200,5,3900,4100,"Sub-basin 6"
3863,600,78,2700,3300,"Sub-basin 6"
3864,300,6,600,900,"Sub-basin 6"
3865,200,2,1200,1400,"Sub-basin 6"
3866,400,122,2300,2700,"Sub-basin 6"
3867,300,4,3100,3400,"Sub-basin 6"
3868,1800,219,9200,11000,"Sub-basin 6"
3869,3900,554,16500,20400,"Sub-basin 6"
3870,5000,2126,8800,13800,"Sub-basin 6"
3871,2500,989,5300,7800,"Sub-basin 6"
3872,100,8,700,800,"Sub-basin 6"
3873,100,3,1100,1200,"Sub-basin 6"
3874,3100,220,14700,17800,"Sub-basin 6"
3875,100,2,1500,1600,"Sub-basin 6"
3876,1000,108,4000,5000,"Sub-basin 6"
3877,3200,1394,6200,9400,"Sub-basin 6"
3878,6300,2393,9700,16000,"Sub-basin 6"
3879,100,1,100,200,"Sub-basin 6"
3880,800,265,2900,3700,"Sub-basin 6"
3881,300,9,4800,5100,"Sub-basin 6"
3882,100,1,1400,1500,"Sub-basin 6"
3883,100,2,400,500,"Sub-basin 6"
3884,700,119,2000,2700,"Sub-basin 6"
3885,100,5,600,700,"Sub-basin 6"
3886,800,60,2600,3400,"Sub-basin 6"
3887,100,1,800,900,"Sub-basin 6"
3888,600,25,2600,3200,"Sub-basin 6"
3889,1500,153,10000,11500,"Sub-basin 6"
3890,400,52,2600,3000,"Sub-basin 6"
3891,700,142,3800,4500,"Sub-basin 6"
3892,100,1,1000,1100,"Sub-basin 6"
3893,100,2,200,300,"Sub-basin 6"
3894,400,29,6500,6900,"Sub-basin 6"
3895,200,4,1200,1400,"Sub-basin 6"
3896,2300,326,5300,7600,"Sub-basin 6"
3897,200,10,1100,1300,"Sub-basin 6"
3898,100,2,900,1000,"Sub-basin 6"
3899,600,42,3100,3700,"Sub-basin 6"
3900,100,1,400,500,"Sub-basin 6"
3901,1000,142,1300,2300,"Sub-basin 6"
3902,400,27,1600,2000,"Sub-basin 6"
3903,300,7,1400,1700,"Sub-basin 6"
3904,200,2,2900,3100,"Sub-basin 6"
3905,1600,391,4100,5700,"Sub-basin 6"
3906,600,64,2100,2700,"Sub-basin 6"
3907,100,1,600,700,"Sub-basin 6"
3908,100,6,800,900,"Sub-basin 6"
3909,3500,687,20900,24400,"Sub-basin 6"
3910,400,60,2100,2500,"Sub-basin 6"
3911,100,2,1100,1200,"Sub-basin 6"
3912,4200,373,40800,45000,"Sub-basin 6"
3913,200,9,2500,2700,"Sub-basin 6"
3914,200,7,3400,3600,"Sub-basin 6"
3915,1100,122,3500,4600,"Sub-basin 6"
3916,100,7,1500,1600,"Sub-basin 6"
3917,2100,370.17,8200,10300,"Sub-basin 6"
3918,100,4,1100,1200,"Sub-basin 6"
3919,600,99,4000,4600,"Sub-basin 6"
3920,3600,1010,10000,13600,"Sub-basin 6"
3921,200,2,400,600,"Sub-basin 6"
3922,3700,860,15100,18800,"Sub-basin 6"
3923,4000,1867,12800,16800,"Sub-basin 6"
3924,400,22,4400,4800,"Sub-basin 6"
3925,600,42,3600,4200,"Sub-basin 6"
3926,500,30,3400,3900,"Sub-basin 6"
3927,200,17,1800,2000,"Sub-basin 6"
3928,100,1,1700,1800,"Sub-basin 6"
3929,1000,58,10800,11800,"Sub-basin 6"
3930,500,54,1600,2100,"Sub-basin 6"
3931,200,6,1300,1500,"Sub-basin 6"
3932,700,70,6400,7100,"Sub-basin 6"
3933,800,79,1900,2700,"Sub-basin 6"
3934,3000,566,5800,8800,"Sub-basin 6"
3935,100,2,700,800,"Sub-basin 6"
3936,300,28,800,1100,"Sub-basin 6"
3937,2000,661,6900,8900,"Sub-basin 6"
3938,800,77,3600,4400,"Sub-basin 6"
3939,1400,107,5200,6600,"Sub-basin 6"
3940,100,4,1000,1100,"Sub-basin 6"
3941,6900,3828,17700,24600,"Sub-basin 6"
3942,1100,50,8600,9700,"Sub-basin 6"
3943,400,53,2300,2700,"Sub-basin 6"
3944,200,4,2300,2500,"Sub-basin 6"
3945,200,10,1500,1700,"Sub-basin 6"
3946,800,99,5500,6300,"Sub-basin 6"
3947,100,4,2800,2900,"Sub-basin 6"
3948,100,1,600,700,"Sub-basin 6"
3949,200,2,1800,2000,"Sub-basin 6"
3950,1100,112,2900,4000,"Sub-basin 6"
3951,100,1,2300,2400,"Sub-basin 6"
3952,200,4,4400,4600,"Sub-basin 6"
3953,200,3.007,3200,3400,"Sub-basin 6"
3954,500,26,2200,2700,"Sub-basin 6"
3955,2300,688,4700,7000,"Sub-basin 6"
3956,100,2,1500,1600,"Sub-basin 6"
3957,200,5.006,4900,5100,"Sub-basin 6"
3958,5100,1683,6400,11500,"Sub-basin 6"
3959,1200,388,7400,8600,"Sub-basin 6"
3960,200,13,3200,3400,"Sub-basin 6"
3961,900,58,4100,5000,"Sub-basin 6"
3962,100,2,1200,1300,"Sub-basin 6"
3963,300,14,1700,2000,"Sub-basin 6"
3964,500,104,2100,2600,"Sub-basin 6"
3965,1200,184,5700,6900,"Sub-basin 6"
3966,400,21,5300,5700,"Sub-basin 6"
3967,1200,90,9600,10800,"Sub-basin 6"
3968,100,2,3700,3800,"Sub-basin 6"
3969,200,6,1800,2000,"Sub-basin 6"
3970,100,4,1500,1600,"Sub-basin 6"
3971,100,1,1400,1500,"Sub-basin 6"
3972,200,17,1700,1900,"Sub-basin 6"
3973,100,1.0013,1600,1700,"Sub-basin 6"
3974,700,85,3300,4000,"Sub-basin 6"
3975,600,65,2300,2900,"Sub-basin 6"
3976,700,126,2600,3300,"Sub-basin 6"
3977,200,2,2400,2600,"Sub-basin 6"
3978,800,65,7000,7800,"Sub-basin 6"
3979,1600,369,14100,15700,"Sub-basin 6"
3980,200,5,2600,2800,"Sub-basin 6"
3981,100,2,2500,2600,"Sub-basin 6"
3982,100,1.0014,1700,1800,"Sub-basin 6"
3983,3300,1033,11900,15200,"Sub-basin 6"
3984,7600,1899,6100,13700,"Sub-basin 6"
3985,100,1,2500,2600,"Sub-basin 6"
3986,100,4,1600,1700,"Sub-basin 6"
3987,800,205,11900,12700,"Sub-basin 6"
3988,100,3,1300,1400,"Sub-basin 6"
3989,300,13,6700,7000,"Sub-basin 6"
3990,100,6,1100,1200,"Sub-basin 6"
3991,100,1,2900,3000,"Sub-basin 6"
3992,200,6,1400,1600,"Sub-basin 6"
3993,100,1,800,900,"Sub-basin 6"
3994,300,15,2200,2500,"Sub-basin 6"
3995,1500,223,5600,7100,"Sub-basin 6"
3996,400,33,4500,4900,"Sub-basin 6"
3997,2400,217,9400,11800,"Sub-basin 6"
3998,400,34,1500,1900,"Sub-basin 6"
3999,400,26,3900,4300,"Sub-basin 6"
4000,200,15.0022,4200,4400,"Sub-basin 6"
4001,100,1,1100,1200,"Sub-basin 6"
4002,500,21,3700,4200,"Sub-basin 6"
4003,400,25,2300,2700,"Sub-basin 6"
4004,1100,346,2400,3500,"Sub-basin 6"
4005,100,2,2400,2500,"Sub-basin 6"
4006,200,3,4600,4800,"Sub-basin 6"
4007,200,3,4300,4500,"Sub-basin 6"
4008,100,3,1700,1800,"Sub-basin 6"
4009,100,1,600,700,"Sub-basin 6"
4010,200,3,700,900,"Sub-basin 6"
4011,100,1,2700,2800,"Sub-basin 6"
4012,100,3,200,300,"Sub-basin 6"
4013,100,2,1000,1100,"Sub-basin 6"
4014,1400,231,3300,4700,"Sub-basin 6"
4015,3900,928,6500,10400,"Sub-basin 6"
4016,500,19,5100,5600,"Sub-basin 6"
4017,1100,91.0433,12800,13900,"Sub-basin 6"
4018,13000,2116,75400,88400,"Sub-basin 6"
4019,100,3,2000,2100,"Sub-basin 6"
4020,2900,569,6200,9100,"Sub-basin 6"
4021,100,1,200,300,"Sub-basin 6"
4022,1200,261,10900,12100,"Sub-basin 6"
4023,100,9,1200,1300,"Sub-basin 6"
4024,700,30,4000,4700,"Sub-basin 6"
4025,200,4,900,1100,"Sub-basin 6"
4026,100,5,1200,1300,"Sub-basin 6"
4027,4400,879,11300,15700,"Sub-basin 6"
4028,6700,1706,17100,23800,"Sub-basin 6"
4029,3600,1236,4000,7600,"Sub-basin 6"
4030,600,20,16600,17200,"Sub-basin 6"
4031,100,3,1100,1200,"Sub-basin 6"
4032,400,17,1700,2100,"Sub-basin 6"
4033,100,1,2200,2300,"Sub-basin 6"
4034,200,4,2600,2800,"Sub-basin 6"
4035,200,6,2500,2700,"Sub-basin 6"
4036,100,7,400,500,"Sub-basin 6"
4037,400,53,1800,2200,"Sub-basin 6"
4038,400,13,3000,3400,"Sub-basin 6"
4039,100,1,500,600,"Sub-basin 6"
4040,200,4,3900,4100,"Sub-basin 6"
4041,200,4,3800,4000,"Sub-basin 6"
4042,1900,371,5000,6900,"Sub-basin 6"
4043,100,2,800,900,"Sub-basin 6"
4044,100,1,2500,2600,"Sub-basin 6"
4045,200,5,5300,5500,"Sub-basin 6"
4046,100,4,1800,1900,"Sub-basin 6"
4047,100,3,2600,2700,"Sub-basin 6"
4048,800,32,6600,7400,"Sub-basin 6"
4049,13000,2880,16700,29700,"Sub-basin 6"
4050,2200,930,5200,7400,"Sub-basin 6"
4051,100,2,4400,4500,"Sub-basin 6"
4052,100,1.0021,3000,3100,"Sub-basin 6"
4053,100,1,1100,1200,"Sub-basin 6"
4054,8200,1651,15000,23200,"Sub-basin 6"
4055,2700,461,6000,8700,"Sub-basin 6"
4056,200,3,4800,5000,"Sub-basin 6"
4057,300,8,8400,8700,"Sub-basin 6"
4058,100,3,3400,3500,"Sub-basin 6"
4059,800,208,10100,10900,"Sub-basin 6"
4060,100,1,700,800,"Sub-basin 6"
4061,1300,70,9400,10700,"Sub-basin 6"
4062,200,6,4700,4900,"Sub-basin 6"
4063,100,7,2100,2200,"Sub-basin 6"
4064,4300,618,42600,46900,"Sub-basin 6"
4065,400,81,2200,2600,"Sub-basin 6"
4066,700,45.0247,17300,18000,"Sub-basin 6"
4067,1200,102,14100,15300,"Sub-basin 6"
4068,1100,177,4700,5800,"Sub-basin 6"
4069,300,44,1400,1700,"Sub-basin 6"
4070,100,2,700,800,"Sub-basin 6"
4071,1500,67,14800,16300,"Sub-basin 6"
4072,100,1,2300,2400,"Sub-basin 6"
4073,100,3,2000,2100,"Sub-basin 6"
4074,11900,6400.67,38700,50600,"Sub-basin 6"
4075,1400,275,5300,6700,"Sub-basin 6"
4076,300,16,2900,3200,"Sub-basin 6"
4077,500,43,3800,4300,"Sub-basin 6"
4078,100,9,3200,3300,"Sub-basin 6"
4079,300,4,7200,7500,"Sub-basin 6"
4080,400,47,7200,7600,"Sub-basin 6"
4081,200,9,3700,3900,"Sub-basin 6"
4082,2300,729,2800,5100,"Sub-basin 6"
4083,800,57,10100,10900,"Sub-basin 6"
4084,200,5,5800,6000,"Sub-basin 6"
4085,2300,172,34400,36700,"Sub-basin 6"
4086,600,51,2400,3000,"Sub-basin 6"
4087,300,6,4000,4300,"Sub-basin 6"
4088,1100,106,24300,25400,"Sub-basin 6"
4089,800,87,2200,3000,"Sub-basin 6"
4090,200,6,3600,3800,"Sub-basin 6"
4091,200,7,6500,6700,"Sub-basin 6"
4092,400,27,6000,6400,"Sub-basin 6"
4093,700,100,6600,7300,"Sub-basin 6"
4094,500,123.0089,7800,8300,"Sub-basin 6"
4095,1100,285,12900,14000,"Sub-basin 6"
4096,700,45,9900,10600,"Sub-basin 6"
4097,200,9,1400,1600,"Sub-basin 6"
4098,200,13,1800,2000,"Sub-basin 6"
4099,100,1,0,100,"Sub-basin 6"
4100,300,14,5900,6200,"Sub-basin 6"
4101,200,37,4700,4900,"Sub-basin 6"
4102,2200,494,7200,9400,"Sub-basin 6"
4103,200,18,1600,1800,"Sub-basin 6"
4104,1200,143,4200,5400,"Sub-basin 6"
4105,100,1,4200,4300,"Sub-basin 6"
4106,400,26,7400,7800,"Sub-basin 6"
4107,400,50,3600,4000,"Sub-basin 6"
4108,100,2,1000,1100,"Sub-basin 6"
4109,100,1,1700,1800,"Sub-basin 6"
4110,200,6,400,600,"Sub-basin 6"
4111,1700,378,3900,5600,"Sub-basin 6"
4112,600,108,3000,3600,"Sub-basin 6"
4113,600,45,6200,6800,"Sub-basin 6"
4114,100,4,500,600,"Sub-basin 6"
4115,3200,1306,7800,11000,"Sub-basin 6"
4116,200,4,700,900,"Sub-basin 6"
4117,1700,423,2600,4300,"Sub-basin 6"
4118,2900,204,20700,23600,"Sub-basin 6"
4119,200,6,2700,2900,"Sub-basin 6"
4120,1700,170,26400,28100,"Sub-basin 6"
4121,100,2,3000,3100,"Sub-basin 6"
4122,100,1,2200,2300,"Sub-basin 6"
4123,2800,562,7100,9900,"Sub-basin 6"
4124,100,2,3100,3200,"Sub-basin 6"
4125,300,19,7900,8200,"Sub-basin 6"
4126,200,11,2200,2400,"Sub-basin 6"
4127,300,24,2300,2600,"Sub-basin 6"
4128,500,29,700,1200,"Sub-basin 6"
4129,100,1,4100,4200,"Sub-basin 6"
4130,100,1,200,300,"Sub-basin 6"
4131,2100,316,4900,7000,"Sub-basin 6"
4132,1400,345,3000,4400,"Sub-basin 6"
4133,400,149,1700,2100,"Sub-basin 6"
4134,1300,203,3600,4900,"Sub-basin 6"
4135,100,2,1100,1200,"Sub-basin 6"
4136,2200,183,21500,23700,"Sub-basin 6"
4137,100,1,3200,3300,"Sub-basin 6"
4138,100,1,4500,4600,"Sub-basin 6"
4139,800,48,13600,14400,"Sub-basin 6"
4140,7400,1481,20200,27600,"Sub-basin 6"
4141,100,4,0,100,"Sub-basin 6"
4142,100,6,1700,1800,"Sub-basin 6"
4143,100,2,1500,1600,"Sub-basin 6"
4144,100,2.0022,4200,4300,"Sub-basin 6"
4145,600,61,2100,2700,"Sub-basin 6"
4146,400,7,700,1100,"Sub-basin 6"
4147,100,2,800,900,"Sub-basin 6"
4148,100,2,900,1000,"Sub-basin 6"
4149,200,7,100,300,"Sub-basin 6"
4150,100,2,4200,4300,"Sub-basin 6"
4151,100,5,2600,2700,"Sub-basin 6"
4152,500,36,7500,8000,"Sub-basin 6"
4153,200,4,1400,1600,"Sub-basin 6"
4154,100,1,3600,3700,"Sub-basin 6"
4155,1700,538,7200,8900,"Sub-basin 6"
4156,800,48,24900,25700,"Sub-basin 6"
4157,200,5,4300,4500,"Sub-basin 6"
4158,100,1.0031,4600,4700,"Sub-basin 6"
4159,2600,846,6000,8600,"Sub-basin 6"
4160,400,92,2300,2700,"Sub-basin 6"
4161,100,1,800,900,"Sub-basin 6"
4162,400,18,14100,14500,"Sub-basin 6"
4163,500,21,6900,7400,"Sub-basin 6"
4164,100,2,3400,3500,"Sub-basin 6"
4165,1000,159,3400,4400,"Sub-basin 6"
4166,100,1,3000,3100,"Sub-basin 6"
4167,100,1,2600,2700,"Sub-basin 6"
4168,100,1,1000,1100,"Sub-basin 6"
4169,300,13,2000,2300,"Sub-basin 6"
4170,300,21,2500,2800,"Sub-basin 6"
4171,400,23,3300,3700,"Sub-basin 6"
4172,400,12,4100,4500,"Sub-basin 6"
4173,100,1,2600,2700,"Sub-basin 6"
4174,200,5,5100,5300,"Sub-basin 6"
4175,500,61,10200,10700,"Sub-basin 6"
4176,700,29.0259,21400,22100,"Sub-basin 6"
4177,2100,753,5800,7900,"Sub-basin 6"
4178,700,27,1200,1900,"Sub-basin 6"
4179,400,13,4100,4500,"Sub-basin 6"
4180,600,27,15800,16400,"Sub-basin 6"
4181,2900,250,26400,29300,"Sub-basin 6"
4182,100,5,3600,3700,"Sub-basin 6"
4183,300,9,1400,1700,"Sub-basin 6"
4184,1000,84,3200,4200,"Sub-basin 6"
4185,400,33,2600,3000,"Sub-basin 6"
4186,200,3,5200,5400,"Sub-basin 6"
4187,1000,79,27200,28200,"Sub-basin 6"
4188,400,42,4100,4500,"Sub-basin 6"
4189,300,13,5500,5800,"Sub-basin 6"
4190,100,1,1600,1700,"Sub-basin 6"
4191,100,1,1000,1100,"Sub-basin 6"
4192,200,17,4800,5000,"Sub-basin 6"
4193,400,10,4700,5100,"Sub-basin 6"
4194,500,18,4600,5100,"Sub-basin 6"
4195,1300,146,10500,11800,"Sub-basin 6"
4196,400,15,3600,4000,"Sub-basin 6"
4197,300,11,2300,2600,"Sub-basin 6"
4198,200,11,2400,2600,"Sub-basin 6"
4199,300,6,4000,4300,"Sub-basin 6"
4200,100,2,2100,2200,"Sub-basin 6"
4201,200,5,5000,5200,"Sub-basin 6"
4202,200,3,2100,2300,"Sub-basin 6"
4203,100,2,2200,2300,"Sub-basin 6"
4204,200,3,4600,4800,"Sub-basin 6"
4205,200,3,3100,3300,"Sub-basin 6"
4206,500,42,2500,3000,"Sub-basin 6"
4207,200,20,1700,1900,"Sub-basin 6"
4208,100,2,1900,2000,"Sub-basin 6"
4209,100,3,2200,2300,"Sub-basin 6"
4210,300,5,9900,10200,"Sub-basin 6"
4211,300,7,6800,7100,"Sub-basin 6"
4212,900,54,9900,10800,"Sub-basin 6"
4213,100,2,700,800,"Sub-basin 6"
4214,200,10,3200,3400,"Sub-basin 6"
4215,100,4,1700,1800,"Sub-basin 6"
4216,400,8,8400,8800,"Sub-basin 6"
4217,400,53,3700,4100,"Sub-basin 6"
4218,200,4,2200,2400,"Sub-basin 6"
4219,300,18,3400,3700,"Sub-basin 6"
4220,200,8,2600,2800,"Sub-basin 6"
4221,100,4,2600,2700,"Sub-basin 6"
4222,300,11,11200,11500,"Sub-basin 6"
4223,1100,93,9500,10600,"Sub-basin 6"
4224,200,3,2200,2400,"Sub-basin 6"
4225,300,15,2300,2600,"Sub-basin 6"
4226,900,41,5900,6800,"Sub-basin 6"
4227,100,1,2100,2200,"Sub-basin 6"
4228,600,29,5700,6300,"Sub-basin 6"
4229,800,107,3300,4100,"Sub-basin 6"
4230,500,14,8600,9100,"Sub-basin 6"
4231,200,2.0054,7500,7700,"Sub-basin 6"
4232,100,8,1000,1100,"Sub-basin 6"
4233,500,46,2700,3200,"Sub-basin 6"
4234,100,2,4400,4500,"Sub-basin 6"
4235,200,5,1100,1300,"Sub-basin 6"
4236,200,4,1600,1800,"Sub-basin 6"
4237,300,14,2700,3000,"Sub-basin 6"
4238,1700,106,27500,29200,"Sub-basin 6"
4239,600,16,9300,9900,"Sub-basin 6"
4240,100,4,3500,3600,"Sub-basin 6"
4241,100,5,1200,1300,"Sub-basin 6"
4242,4700,387,18400,23100,"Sub-basin 6"
4243,300,6,2300,2600,"Sub-basin 6"
4244,200,4,2800,3000,"Sub-basin 6"
4245,100,3,2300,2400,"Sub-basin 6"
4246,600,36,7300,7900,"Sub-basin 6"
4247,1900,175,31800,33700,"Sub-basin 6"
4248,200,2,6200,6400,"Sub-basin 6"
4249,400,12,900,1300,"Sub-basin 6"
4250,100,3,2900,3000,"Sub-basin 6"
4251,100,1,1300,1400,"Sub-basin 6"
4252,100,2,2700,2800,"Sub-basin 6"
4253,200,4,7100,7300,"Sub-basin 6"
4254,100,1,3900,4000,"Sub-basin 6"
4255,200,10,2000,2200,"Sub-basin 6"
4256,200,8,3100,3300,"Sub-basin 6"
4257,100,1,4400,4500,"Sub-basin 6"
4258,3400,822,10500,13900,"Sub-basin 6"
4259,200,7,2600,2800,"Sub-basin 6"
4260,700,41,12300,13000,"Sub-basin 6"
4261,100,3,2400,2500,"Sub-basin 6"
4262,200,8,4200,4400,"Sub-basin 6"
4263,200,11.0053,8200,8400,"Sub-basin 6"
4264,200,3,2800,3000,"Sub-basin 6"
4265,100,4,1700,1800,"Sub-basin 6"
4266,2200,241,17300,19500,"Sub-basin 6"
4267,400,25,4900,5300,"Sub-basin 6"
4268,800,49,3400,4200,"Sub-basin 6"
4269,200,2,3200,3400,"Sub-basin 6"
4270,800,287,2300,3100,"Sub-basin 6"
4271,3500,310,54100,57600,"Sub-basin 6"
4272,300,15,6900,7200,"Sub-basin 6"
4273,300,3,6300,6600,"Sub-basin 6"
4274,800,45,4000,4800,"Sub-basin 6"
4275,100,1,3000,3100,"Sub-basin 6"
4276,200,7,3300,3500,"Sub-basin 6"
4277,100,1,2900,3000,"Sub-basin 6"
4278,200,3,5800,6000,"Sub-basin 6"
4279,800,69,7600,8400,"Sub-basin 6"
4280,600,194,2300,2900,"Sub-basin 6"
4281,500,28,4600,5100,"Sub-basin 6"
4282,100,1,2300,2400,"Sub-basin 6"
4283,100,1,4800,4900,"Sub-basin 6"
4284,800,58,9000,9800,"Sub-basin 6"
4285,200,6.0063,8000,8200,"Sub-basin 6"
4286,100,1,900,1000,"Sub-basin 6"
4287,300,10,3200,3500,"Sub-basin 6"
4288,100,1,2000,2100,"Sub-basin 6"
4289,600,31,4500,5100,"Sub-basin 6"
4290,600,34,5700,6300,"Sub-basin 6"
4291,100,2,1100,1200,"Sub-basin 6"
4292,200,4,1700,1900,"Sub-basin 6"
4293,200,7,2700,2900,"Sub-basin 6"
4294,4400,242,27000,31400,"Sub-basin 6"
4295,400,12,2000,2400,"Sub-basin 6"
4296,400,12,4100,4500,"Sub-basin 6"
4297,600,25,4100,4700,"Sub-basin 6"
4298,100,4,5100,5200,"Sub-basin 6"
4299,1400,124,16600,18000,"Sub-basin 6"
4300,600,36,9800,10400,"Sub-basin 6"
4301,300,6,3200,3500,"Sub-basin 6"
4302,400,20,2600,3000,"Sub-basin 6"
4303,500,25,7100,7600,"Sub-basin 6"
4304,1000,55,7700,8700,"Sub-basin 6"
4305,300,16,2600,2900,"Sub-basin 6"
4306,1000,36,6800,7800,"Sub-basin 6"
4307,200,7,1900,2100,"Sub-basin 6"
4308,100,1,1200,1300,"Sub-basin 6"
4309,100,2,800,900,"Sub-basin 6"
4310,100,1,3000,3100,"Sub-basin 6"
4311,2200,797,3400,5600,"Sub-basin 6"
4312,100,1,1300,1400,"Sub-basin 6"
4313,1100,70,2400,3500,"Sub-basin 6"
4314,3100,220,17800,20900,"Sub-basin 6"
4315,200,5,2300,2500,"Sub-basin 6"
4316,900,68,7500,8400,"Sub-basin 6"
4317,2800,340,41200,44000,"Sub-basin 6"
4318,9100,2714,129500,138600,"Sub-basin 6"
4319,400,10,6800,7200,"Sub-basin 6"
4320,500,16.0168,15600,16100,"Sub-basin 6"
4321,200,17,1500,1700,"Sub-basin 6"
4322,500,22,6000,6500,"Sub-basin 6"
4323,900,47,8600,9500,"Sub-basin 6"
4324,2900,902,9900,12800,"Sub-basin 6"
4325,200,4,2200,2400,"Sub-basin 6"
4326,1000,126,4600,5600,"Sub-basin 6"
4327,100,1,4200,4300,"Sub-basin 6"
4328,900,95,8100,9000,"Sub-basin 6"
4329,300,13,5800,6100,"Sub-basin 6"
4330,100,4,700,800,"Sub-basin 6"
4331,100,3,4200,4300,"Sub-basin 6"
4332,500,30,4600,5100,"Sub-basin 6"
4333,1700,152,27300,29000,"Sub-basin 6"
4334,100,1,1000,1100,"Sub-basin 6"
4335,400,22,1300,1700,"Sub-basin 6"
4336,1400,63,8100,9500,"Sub-basin 6"
4337,100,3,2700,2800,"Sub-basin 6"
4338,400,12,7500,7900,"Sub-basin 6"
4339,400,22,4500,4900,"Sub-basin 6"
4340,1800,186.34,12100,13900,"Sub-basin 6"
4341,100,2,2300,2400,"Sub-basin 6"
4342,100,1,2800,2900,"Sub-basin 6"
4343,400,25,5600,6000,"Sub-basin 6"
4344,100,3,3700,3800,"Sub-basin 6"
4345,1200,82.33,12000,13200,"Sub-basin 6"
4346,100,1,1400,1500,"Sub-basin 6"
4347,400,20,6000,6400,"Sub-basin 6"
4348,100,2,600,700,"Sub-basin 6"
4349,200,2,3700,3900,"Sub-basin 6"
4350,100,2,3200,3300,"Sub-basin 6"
4351,100,2,2600,2700,"Sub-basin 6"
4352,400,10.0111,14000,14400,"Sub-basin 6"
4353,300,16,3000,3300,"Sub-basin 6"
4354,300,11,4500,4800,"Sub-basin 6"
4355,1100,99,10300,11400,"Sub-basin 6"
4356,200,5,4400,4600,"Sub-basin 6"
4357,2300,239,13900,16200,"Sub-basin 6"
4358,200,4,5200,5400,"Sub-basin 6"
4359,1800,144,17000,18800,"Sub-basin 6"
4360,200,3,1500,1700,"Sub-basin 6"
4361,200,6,5600,5800,"Sub-basin 6"
4362,1600,143,6600,8200,"Sub-basin 6"
4363,100,1,2600,2700,"Sub-basin 6"
4364,100,2,1100,1200,"Sub-basin 6"
4365,200,10,3700,3900,"Sub-basin 6"
4366,1800,186,19700,21500,"Sub-basin 6"
4367,100,3,3400,3500,"Sub-basin 6"
4368,100,2,2800,2900,"Sub-basin 6"
4369,10900,1410,72600,83500,"Sub-basin 6"
4370,900,79,6000,6900,"Sub-basin 6"
4371,200,3,3600,3800,"Sub-basin 6"
4372,500,12,4200,4700,"Sub-basin 6"
4373,400,12,3500,3900,"Sub-basin 6"
4374,400,12.0092,13700,14100,"Sub-basin 6"
4375,200,7,1500,1700,"Sub-basin 6"
4376,400,34,700,1100,"Sub-basin 6"
4377,1800,147,9200,11000,"Sub-basin 6"
4378,300,10,1600,1900,"Sub-basin 6"
4379,19300,4733,100900,120200,"Sub-basin 6"
4380,500,39,19000,19500,"Sub-basin 6"
4381,100,1,2500,2600,"Sub-basin 6"
4382,1000,75,11200,12200,"Sub-basin 6"
4383,600,24,7600,8200,"Sub-basin 6"
4384,100,4,1000,1100,"Sub-basin 6"
4385,400,35,1700,2100,"Sub-basin 6"
4386,1200,88,5000,6200,"Sub-basin 6"
4387,100,4,2600,2700,"Sub-basin 6"
4388,100,2,3200,3300,"Sub-basin 6"
4389,1600,191,15600,17200,"Sub-basin 6"
4390,300,7,6500,6800,"Sub-basin 6"
4391,100,1,1300,1400,"Sub-basin 6"
4392,500,16,9300,9800,"Sub-basin 6"
4393,1000,126,3900,4900,"Sub-basin 6"
4394,900,63,5700,6600,"Sub-basin 6"
4395,200,10,4300,4500,"Sub-basin 6"
4396,400,9,7000,7400,"Sub-basin 6"
4397,1100,95,17200,18300,"Sub-basin 6"
4398,200,4,2500,2700,"Sub-basin 6"
4399,200,6.0054,7600,7800,"Sub-basin 6"
4400,2600,659,10900,13500,"Sub-basin 6"
4401,800,107,2400,3200,"Sub-basin 6"
4402,100,3,800,900,"Sub-basin 6"
4403,200,2,1300,1500,"Sub-basin 6"
4404,200,9,2200,2400,"Sub-basin 6"
4405,200,3,3200,3400,"Sub-basin 6"
4406,100,4,1600,1700,"Sub-basin 6"
4407,200,12,4200,4400,"Sub-basin 6"
4408,100,1,3000,3100,"Sub-basin 6"
4409,100,1,700,800,"Sub-basin 6"
4410,100,1,1500,1600,"Sub-basin 6"
4411,3900,435,25900,29800,"Sub-basin 6"
4412,200,4,4200,4400,"Sub-basin 6"
4413,700,185.0198,15300,16000,"Sub-basin 6"
4414,100,3.0015,2700,2800,"Sub-basin 6"
4415,1800,270,16500,18300,"Sub-basin 6"
4416,1200,207,5900,7100,"Sub-basin 6"
4417,100,3,800,900,"Sub-basin 6"
4418,1000,88,12400,13400,"Sub-basin 6"
4419,400,32,5700,6100,"Sub-basin 6"
4420,100,7,3000,3100,"Sub-basin 6"
4421,1200,113,4300,5500,"Sub-basin 6"
4422,200,5,1100,1300,"Sub-basin 6"
4423,13600,4775,66800,80400,"Sub-basin 6"
4424,100,1,2800,2900,"Sub-basin 6"
4425,1100,122,5200,6300,"Sub-basin 6"
4426,100,1,1600,1700,"Sub-basin 6"
4427,100,5,2400,2500,"Sub-basin 6"
4428,300,3,1400,1700,"Sub-basin 6"
4429,200,5,2100,2300,"Sub-basin 6"
4430,1200,62,11500,12700,"Sub-basin 6"
4431,200,14,4600,4800,"Sub-basin 6"
4432,4300,506,56700,61000,"Sub-basin 6"
4433,700,57,10200,10900,"Sub-basin 6"
4434,300,27,800,1100,"Sub-basin 6"
4435,1300,1933,4900,6200,"Sub-basin 6"
4436,1200,169,11200,12400,"Sub-basin 6"
4437,100,2,1600,1700,"Sub-basin 6"
4438,400,32,3900,4300,"Sub-basin 6"
4439,900,69,8900,9800,"Sub-basin 6"
4440,1100,42,9400,10500,"Sub-basin 6"
4441,100,3,1300,1400,"Sub-basin 6"
4442,1300,59,8500,9800,"Sub-basin 6"
4443,400,12,3200,3600,"Sub-basin 6"
4444,100,2.0016,2900,3000,"Sub-basin 6"
4445,200,5,1300,1500,"Sub-basin 6"
4446,4900,851,19700,24600,"Sub-basin 6"
4447,400,13,4100,4500,"Sub-basin 6"
4448,4300,371,28300,32600,"Sub-basin 6"
4449,400,5,6500,6900,"Sub-basin 6"
4450,100,1,1600,1700,"Sub-basin 6"
4451,100,1,500,600,"Sub-basin 6"
4452,1200,85,7300,8500,"Sub-basin 6"
4453,600,48,2400,3000,"Sub-basin 6"
4454,700,43,5200,5900,"Sub-basin 6"
4455,100,5,1000,1100,"Sub-basin 6"
4456,600,41,5900,6500,"Sub-basin 6"
4457,400,11,3200,3600,"Sub-basin 6"
4458,400,11,6600,7000,"Sub-basin 6"
4459,200,6,2200,2400,"Sub-basin 6"
4460,1200,115,10600,11800,"Sub-basin 6"
4461,400,8,2200,2600,"Sub-basin 6"
4462,300,5,3300,3600,"Sub-basin 6"
4463,200,4,1800,2000,"Sub-basin 6"
4464,500,40,5700,6200,"Sub-basin 6"
4465,100,5,1600,1700,"Sub-basin 6"
4466,100,3,800,900,"Sub-basin 6"
4467,1700,113,7100,8800,"Sub-basin 6"
4468,100,1.0008,3200,3300,"Sub-basin 6"
4469,100,1,1800,1900,"Sub-basin 6"
4470,100,1,1000,1100,"Sub-basin 6"
4471,100,1,1300,1400,"Sub-basin 6"
4472,400,16,2300,2700,"Sub-basin 6"
4473,22600,3314,118400,141000,"Sub-basin 6"
4474,100,1.0008,3600,3700,"Sub-basin 6"
4475,500,16,5000,5500,"Sub-basin 6"
4476,1600,124,16700,18300,"Sub-basin 6"
4477,1000,39,6100,7100,"Sub-basin 6"
4478,100,1,2500,2600,"Sub-basin 6"
4479,400,29,7900,8300,"Sub-basin 6"
4480,900,83,4200,5100,"Sub-basin 6"
4481,400,25,3300,3700,"Sub-basin 6"
4482,600,28,2700,3300,"Sub-basin 6"
4483,2400,323,20400,22800,"Sub-basin 6"
4484,200,4,2600,2800,"Sub-basin 6"
4485,1000,63,9700,10700,"Sub-basin 6"
4486,200,11,3500,3700,"Sub-basin 6"
4487,200,14,700,900,"Sub-basin 6"
4488,300,7,4300,4600,"Sub-basin 6"
4489,700,56,7500,8200,"Sub-basin 6"
4490,100,1,1500,1600,"Sub-basin 6"
4491,100,1,2000,2100,"Sub-basin 6"
4492,100,3,1100,1200,"Sub-basin 6"
4493,100,2,500,600,"Sub-basin 6"
4494,600,29,2200,2800,"Sub-basin 6"
4495,100,3,500,600,"Sub-basin 6"
4496,400,16,4700,5100,"Sub-basin 6"
4497,200,3,1900,2100,"Sub-basin 6"
4498,300,11,2700,3000,"Sub-basin 6"
4499,200,4,6100,6300,"Sub-basin 6"
4500,100,2,600,700,"Sub-basin 6"
4501,400,39,600,1000,"Sub-basin 6"
4502,1700,123,9700,11400,"Sub-basin 6"
4503,800,52,4300,5100,"Sub-basin 6"
4504,100,2.0007,4400,4500,"Sub-basin 6"
4505,100,1,200,300,"Sub-basin 6"
4506,100,1,800,900,"Sub-basin 6"
4507,2100,251,9100,11200,"Sub-basin 6"
4508,700,33,5300,6000,"Sub-basin 6"
4509,200,6,2600,2800,"Sub-basin 6"
4510,200,5,2100,2300,"Sub-basin 6"
4511,100,2,1500,1600,"Sub-basin 6"
4512,100,1,800,900,"Sub-basin 6"
4513,200,5,600,800,"Sub-basin 6"
4514,400,17,2300,2700,"Sub-basin 6"
4515,300,4,2800,3100,"Sub-basin 6"
4516,300,10,5800,6100,"Sub-basin 6"
4517,100,1,1300,1400,"Sub-basin 6"
4518,200,2,2800,3000,"Sub-basin 6"
4519,800,76,5400,6200,"Sub-basin 6"
4520,300,9,4200,4500,"Sub-basin 6"
4521,300,7.0084,8900,9200,"Sub-basin 6"
4522,100,1,2700,2800,"Sub-basin 6"
4523,1000,185,1700,2700,"Sub-basin 6"
4524,1000,47,5800,6800,"Sub-basin 6"
4525,400,6,2600,3000,"Sub-basin 6"
4526,100,3,800,900,"Sub-basin 6"
4527,1000,61,10100,11100,"Sub-basin 6"
4528,600,52,2500,3100,"Sub-basin 6"
4529,400,10,4700,5100,"Sub-basin 6"
4530,400,34,2800,3200,"Sub-basin 6"
4531,100,3,1400,1500,"Sub-basin 6"
4532,1500,646,9500,11000,"Sub-basin 6"
4533,100,3,1000,1100,"Sub-basin 6"
4534,100,1,1000,1100,"Sub-basin 6"
4535,100,1,900,1000,"Sub-basin 6"
4536,100,3,1500,1600,"Sub-basin 6"
4537,2300,192,4900,7200,"Sub-basin 6"
4538,1300,110,7800,9100,"Sub-basin 6"
4539,900,70,2500,3400,"Sub-basin 6"
4540,700,48,4500,5200,"Sub-basin 6"
4541,1100,49,9000,10100,"Sub-basin 6"
4542,600,38,3800,4400,"Sub-basin 6"
4543,200,10,4400,4600,"Sub-basin 6"
4544,400,25,1900,2300,"Sub-basin 6"
4545,800,104,5000,5800,"Sub-basin 6"
4546,200,17,2100,2300,"Sub-basin 6"
4547,300,165,2500,2800,"Sub-basin 6"
4548,200,3,3400,3600,"Sub-basin 6"
4549,100,1,1200,1300,"Sub-basin 6"
4550,100,3,1000,1100,"Sub-basin 6"
4551,700,82,7900,8600,"Sub-basin 6"
4552,300,24,2500,2800,"Sub-basin 6"
4553,200,3,3700,3900,"Sub-basin 6"
4554,900,88,7600,8500,"Sub-basin 6"
4555,200,5,2800,3000,"Sub-basin 6"
4556,400,23,2300,2700,"Sub-basin 6"
4557,200,7,900,1100,"Sub-basin 6"
4558,500,38,3400,3900,"Sub-basin 6"
4559,200,5,1700,1900,"Sub-basin 6"
4560,100,2,1000,1100,"Sub-basin 6"
4561,400,14,2100,2500,"Sub-basin 6"
4562,100,1,2100,2200,"Sub-basin 6"
4563,400,24,4700,5100,"Sub-basin 6"
4564,1300,62.0482,32700,34000,"Sub-basin 6"
4565,100,2,3400,3500,"Sub-basin 6"
4566,4900,920,13500,18400,"Sub-basin 6"
4567,200,6,2700,2900,"Sub-basin 6"
4568,500,38,2200,2700,"Sub-basin 6"
4569,1100,79.5,6000,7100,"Sub-basin 6"
4570,700,41,7400,8100,"Sub-basin 6"
4571,100,4,1800,1900,"Sub-basin 6"
4572,500,19,4600,5100,"Sub-basin 6"
4573,400,12,1600,2000,"Sub-basin 6"
4574,2900,277,19700,22600,"Sub-basin 6"
4575,1000,188,2900,3900,"Sub-basin 6"
4576,800,85,4800,5600,"Sub-basin 6"
4577,300,16,3400,3700,"Sub-basin 6"
4578,300,8,2700,3000,"Sub-basin 6"
4579,500,37,3200,3700,"Sub-basin 6"
4580,100,4,1100,1200,"Sub-basin 6"
4581,800,30,4400,5200,"Sub-basin 6"
4582,100,8,1600,1700,"Sub-basin 6"
4583,700,55,3300,4000,"Sub-basin 6"
4584,200,19,2400,2600,"Sub-basin 6"
4585,200,6,4400,4600,"Sub-basin 6"
4586,900,86,7000,7900,"Sub-basin 6"
4587,400,25,3000,3400,"Sub-basin 6"
4588,900,94,5800,6700,"Sub-basin 6"
4589,800,78,3600,4400,"Sub-basin 6"
4590,400,24,2700,3100,"Sub-basin 6"
4591,1500,227,8900,10400,"Sub-basin 6"
4592,400,26,4300,4700,"Sub-basin 6"
4593,4800,2008,17500,22300,"Sub-basin 6"
4594,1800,374,8900,10700,"Sub-basin 6"
4595,1300,147,5400,6700,"Sub-basin 6"
4596,1700,248,12600,14300,"Sub-basin 6"
4597,200,6,3800,4000,"Sub-basin 6"
4598,200,3,2900,3100,"Sub-basin 6"
4599,400,41,2300,2700,"Sub-basin 6"
4600,1600,170,7000,8600,"Sub-basin 6"
4601,300,7,2000,2300,"Sub-basin 6"
4602,100,1,1400,1500,"Sub-basin 6"
4603,100,1,1200,1300,"Sub-basin 6"
4604,1200,141,7000,8200,"Sub-basin 6"
4605,300,8,2800,3100,"Sub-basin 6"
4606,500,23,7900,8400,"Sub-basin 6"
4607,400,18,4900,5300,"Sub-basin 6"
4608,1000,185,6900,7900,"Sub-basin 6"
4609,500,22,800,1300,"Sub-basin 6"
4610,500,31,2700,3200,"Sub-basin 6"
4611,200,11,2000,2200,"Sub-basin 6"
4612,300,3,2200,2500,"Sub-basin 6"
4613,1300,154,7700,9000,"Sub-basin 6"
4614,100,1,2000,2100,"Sub-basin 6"
4615,2800,371,11700,14500,"Sub-basin 6"
4616,100,1,700,800,"Sub-basin 6"
4617,200,5,2100,2300,"Sub-basin 6"
4618,100,4,1700,1800,"Sub-basin 6"
4619,100,2,500,600,"Sub-basin 6"
4620,100,2,600,700,"Sub-basin 6"
4621,1300,105,8700,10000,"Sub-basin 6"
4622,600,18,4100,4700,"Sub-basin 6"
4623,3700,904,9400,13100,"Sub-basin 6"
4624,400,6,1400,1800,"Sub-basin 6"
4625,200,6,3300,3500,"Sub-basin 6"
4626,100,2,1700,1800,"Sub-basin 6"
4627,400,22,3500,3900,"Sub-basin 6"
4628,200,13,2600,2800,"Sub-basin 6"
4629,1500,84,9600,11100,"Sub-basin 6"
4630,900,82,7500,8400,"Sub-basin 6"
4631,3700,991,8900,12600,"Sub-basin 6"
4632,400,20,3300,3700,"Sub-basin 6"
4633,2200,201,10200,12400,"Sub-basin 6"
4634,1600,244,6500,8100,"Sub-basin 6"
4635,2100,354,7800,9900,"Sub-basin 6"
4636,400,30,3600,4000,"Sub-basin 6"
4637,300,11,2100,2400,"Sub-basin 6"
4638,2400,293,14400,16800,"Sub-basin 6"
4639,900,70,9200,10100,"Sub-basin 6"
4640,1500,204,8700,10200,"Sub-basin 6"
4641,800,48,4100,4900,"Sub-basin 6"
4642,18600,2644.33,94700,113300,"Sub-basin 6"
4643,100,1.0026,5200,5300,"Sub-basin 6"
4644,100,1,900,1000,"Sub-basin 6"
4645,2200,551,2300,4500,"Sub-basin 6"
4646,1000,99,5900,6900,"Sub-basin 6"
4647,4300,1080,7100,11400,"Sub-basin 6"
4648,1900,129,11100,13000,"Sub-basin 6"
4649,1400,86,5400,6800,"Sub-basin 6"
4650,14900,2810,42700,57600,"Sub-basin 6"
4651,600,66,4400,5000,"Sub-basin 6"
4652,200,7.5,1600,1800,"Sub-basin 6"
4653,1200,142,3600,4800,"Sub-basin 6"
4654,4400,597,20600,25000,"Sub-basin 6"
4655,1400,186,8300,9700,"Sub-basin 6"
4656,3300,602,14400,17700,"Sub-basin 6"
4657,1000,38,4600,5600,"Sub-basin 6"
4658,600,12,3800,4400,"Sub-basin 6"
4659,400,7,1500,1900,"Sub-basin 6"
4660,200,8,1900,2100,"Sub-basin 6"
4661,100,1,1100,1200,"Sub-basin 6"
4662,1300,150,4200,5500,"Sub-basin 6"
4663,200,24,1500,1700,"Sub-basin 6"
4664,300,11,2300,2600,"Sub-basin 6"
4665,1600,235,7900,9500,"Sub-basin 6"
4666,100,4.0011,4600,4700,"Sub-basin 6"
4667,900,34,9800,10700,"Sub-basin 6"
4668,200,6,2200,2400,"Sub-basin 6"
4669,800,79,5300,6100,"Sub-basin 6"
4670,300,8,2000,2300,"Sub-basin 6"
4671,100,3,1400,1500,"Sub-basin 6"
4672,400,50,3100,3500,"Sub-basin 6"
4673,600,52.0012,18500,19100,"Sub-basin 6"
4674,11700,4911,39700,51400,"Sub-basin 6"
4675,400,13,4500,4900,"Sub-basin 6"
4676,1800,164,10700,12500,"Sub-basin 6"
4677,1000,65,8200,9200,"Sub-basin 6"
4678,200,13,1400,1600,"Sub-basin 6"
4679,1300,149,7100,8400,"Sub-basin 6"
4680,100,1,2500,2600,"Sub-basin 6"
4681,2600,335,7100,9700,"Sub-basin 6"
4682,200,11,1600,1800,"Sub-basin 6"
4683,14600,4262,19400,34000,"Sub-basin 6"
4684,100,2,900,1000,"Sub-basin 6"
4685,100,5.0014,3100,3200,"Sub-basin 6"
4686,700,56,5700,6400,"Sub-basin 6"
4687,3000,369,17200,20200,"Sub-basin 6"
4688,100,1,1000,1100,"Sub-basin 6"
4689,500,58,4000,4500,"Sub-basin 6"
4690,200,3,1400,1600,"Sub-basin 6"
4691,100,1,600,700,"Sub-basin 6"
4692,1000,36,8700,9700,"Sub-basin 6"
4693,300,10,1900,2200,"Sub-basin 6"
4694,200,5,1100,1300,"Sub-basin 6"
4695,200,5,1700,1900,"Sub-basin 6"
4696,1200,145,4200,5400,"Sub-basin 6"
4697,2200,435,4900,7100,"Sub-basin 6"
4698,2000,248,8000,10000,"Sub-basin 6"
4699,100,4,1200,1300,"Sub-basin 6"
4700,100,5,1800,1900,"Sub-basin 6"
4701,800,91,3700,4500,"Sub-basin 6"
4702,2800,943,7200,10000,"Sub-basin 6"
4703,100,2,1200,1300,"Sub-basin 6"
4704,100,1,1300,1400,"Sub-basin 6"
4705,300,17,2700,3000,"Sub-basin 6"
4706,400,31,1000,1400,"Sub-basin 6"
4707,200,7,1600,1800,"Sub-basin 6"
4708,2200,143,13200,15400,"Sub-basin 6"
4709,600,28,7600,8200,"Sub-basin 6"
4710,6900,728,36800,43700,"Sub-basin 6"
4711,400,22,1900,2300,"Sub-basin 6"
4712,1100,106,8400,9500,"Sub-basin 6"
4713,600,20,3600,4200,"Sub-basin 6"
4714,700,22,6100,6800,"Sub-basin 6"
4715,400,19,3000,3400,"Sub-basin 6"
4716,100,2,600,700,"Sub-basin 6"
4717,16900,7375,29700,46600,"Sub-basin 6"
4718,300,72,1900,2200,"Sub-basin 6"
4719,700,38,4300,5000,"Sub-basin 6"
4720,500,39,3100,3600,"Sub-basin 6"
4721,5300,456,33700,39000,"Sub-basin 6"
4722,400,37,4600,5000,"Sub-basin 6"
4723,600,58,5700,6300,"Sub-basin 6"
4724,600,70,2500,3100,"Sub-basin 6"
4725,2800,259,20800,23600,"Sub-basin 6"
4726,800,128,1400,2200,"Sub-basin 6"
4727,100,2,2200,2300,"Sub-basin 6"
4728,300,8,3300,3600,"Sub-basin 6"
4729,800,75,2000,2800,"Sub-basin 6"
4730,1300,88,6600,7900,"Sub-basin 6"
4731,1100,67,8400,9500,"Sub-basin 6"
4732,100,1,2200,2300,"Sub-basin 6"
4733,300,6,2800,3100,"Sub-basin 6"
4734,200,4,3400,3600,"Sub-basin 6"
4735,100,2,1200,1300,"Sub-basin 6"
4736,200,4,3100,3300,"Sub-basin 6"
4737,1000,42,4600,5600,"Sub-basin 6"
4738,100,2,1200,1300,"Sub-basin 6"
4739,100,1,1300,1400,"Sub-basin 6"
4740,400,13,3200,3600,"Sub-basin 6"
4741,1400,186,10900,12300,"Sub-basin 6"
4742,400,17.0042,11000,11400,"Sub-basin 6"
4743,100,1,1600,1700,"Sub-basin 6"
4744,200,6,3000,3200,"Sub-basin 6"
4745,300,17,2900,3200,"Sub-basin 6"
4746,3900,411,22300,26200,"Sub-basin 6"
4747,900,78,5000,5900,"Sub-basin 6"
4748,600,47,2500,3100,"Sub-basin 6"
4749,1500,205,6000,7500,"Sub-basin 6"
4750,100,2,1000,1100,"Sub-basin 6"
4751,100,1,1600,1700,"Sub-basin 6"
4752,300,11,700,1000,"Sub-basin 6"
4753,1600,209,5100,6700,"Sub-basin 6"
4754,5800,1413,12600,18400,"Sub-basin 6"
4755,400,22,1800,2200,"Sub-basin 6"
4756,400,13,4000,4400,"Sub-basin 6"
4757,200,7,1500,1700,"Sub-basin 6"
4758,700,49,7400,8100,"Sub-basin 6"
4759,300,10,3900,4200,"Sub-basin 6"
4760,200,3,3600,3800,"Sub-basin 6"
4761,300,23,2800,3100,"Sub-basin 6"
4762,800,44,2700,3500,"Sub-basin 6"
4763,600,40,1800,2400,"Sub-basin 6"
4764,100,1,1000,1100,"Sub-basin 6"
4765,100,7,2800,2900,"Sub-basin 6"
4766,1700,186,12900,14600,"Sub-basin 6"
4767,100,1,1700,1800,"Sub-basin 6"
4768,400,12,3600,4000,"Sub-basin 6"
4769,800,94,2900,3700,"Sub-basin 6"
4770,200,14,1500,1700,"Sub-basin 6"
4771,400,18,3900,4300,"Sub-basin 6"
4772,300,14,2700,3000,"Sub-basin 6"
4773,400,16.0056,8000,8400,"Sub-basin 6"
4774,200,5,3400,3600,"Sub-basin 6"
4775,700,38,6300,7000,"Sub-basin 6"
4776,200,3,3100,3300,"Sub-basin 6"
4777,100,2,1600,1700,"Sub-basin 6"
4778,100,1,900,1000,"Sub-basin 6"
4779,400,10,5400,5800,"Sub-basin 6"
4780,200,11,1900,2100,"Sub-basin 6"
4781,700,45,7900,8600,"Sub-basin 6"
4782,1000,103,3200,4200,"Sub-basin 6"
4783,100,1,800,900,"Sub-basin 6"
4784,100,1,500,600,"Sub-basin 6"
4785,200,3,2100,2300,"Sub-basin 6"
4786,10600,3292,13300,23900,"Sub-basin 6"
4787,300,10,2900,3200,"Sub-basin 6"
4788,100,1,1700,1800,"Sub-basin 6"
4789,600,16,4400,5000,"Sub-basin 6"
4790,700,24,5200,5900,"Sub-basin 6"
4791,500,12,3000,3500,"Sub-basin 6"
4792,1000,77,3400,4400,"Sub-basin 6"
4793,900,78,2200,3100,"Sub-basin 6"
4794,700,41,2500,3200,"Sub-basin 6"
4795,400,23,3700,4100,"Sub-basin 6"
4796,100,3,1300,1400,"Sub-basin 6"
4797,600,39,6300,6900,"Sub-basin 6"
4798,100,1.0003,4800,4900,"Sub-basin 6"
4799,700,44,3800,4500,"Sub-basin 6"
4800,300,20,1900,2200,"Sub-basin 6"
4801,200,16,1800,2000,"Sub-basin 6"
4802,300,5,2300,2600,"Sub-basin 6"
4803,800,33,7800,8600,"Sub-basin 6"
4804,200,4.0026,7800,8000,"Sub-basin 6"
4805,2600,256,17000,19600,"Sub-basin 6"
4806,100,2,1700,1800,"Sub-basin 6"
4807,100,4,900,1000,"Sub-basin 6"
4808,100,4,900,1000,"Sub-basin 6"
4809,900,90,3000,3900,"Sub-basin 6"
4810,200,3,1000,1200,"Sub-basin 6"
4811,200,4,1700,1900,"Sub-basin 6"
4812,1700,130,9500,11200,"Sub-basin 6"
4813,100,1,1800,1900,"Sub-basin 6"
4814,2800,505,6600,9400,"Sub-basin 6"
4815,200,2,800,1000,"Sub-basin 6"
4816,1700,325,6600,8300,"Sub-basin 6"
4817,2900,588,15400,18300,"Sub-basin 6"
4818,500,26,5100,5600,"Sub-basin 6"
4819,300,29,3900,4200,"Sub-basin 6"
4820,500,12,4200,4700,"Sub-basin 6"
4821,100,1.0004,5000,5100,"Sub-basin 6"
4822,200,6,4500,4700,"Sub-basin 6"
4823,7700,2157,12200,19900,"Sub-basin 6"
4824,100,1,800,900,"Sub-basin 6"
4825,400,27,1700,2100,"Sub-basin 6"
4826,900,151,3300,4200,"Sub-basin 6"
4827,100,2,1300,1400,"Sub-basin 6"
4828,400,35,3000,3400,"Sub-basin 6"
4829,200,5,2300,2500,"Sub-basin 6"
4830,100,1,1300,1400,"Sub-basin 6"
4831,10700,2112,28100,38800,"Sub-basin 6"
4832,200,3,2200,2400,"Sub-basin 6"
4833,1300,166,5000,6300,"Sub-basin 6"
4834,100,1,1400,1500,"Sub-basin 6"
4835,500,26,6900,7400,"Sub-basin 6"
4836,100,1,1800,1900,"Sub-basin 6"
4837,900,39,6500,7400,"Sub-basin 6"
4838,200,2,1900,2100,"Sub-basin 6"
4839,300,18,3000,3300,"Sub-basin 6"
4840,400,17,3100,3500,"Sub-basin 6"
4841,1000,45,10400,11400,"Sub-basin 6"
4842,100,3.0011,5700,5800,"Sub-basin 6"
4843,100,3,2200,2300,"Sub-basin 6"
4844,400,22,3200,3600,"Sub-basin 6"
4845,100,2,100,200,"Sub-basin 6"
4846,100,1,2300,2400,"Sub-basin 6"
4847,1500,105,8900,10400,"Sub-basin 6"
4848,100,3,1800,1900,"Sub-basin 6"
4849,100,1,900,1000,"Sub-basin 6"
4850,600,34,6300,6900,"Sub-basin 6"
4851,500,14,1300,1800,"Sub-basin 6"
4852,600,68,3200,3800,"Sub-basin 6"
4853,3300,253,17300,20600,"Sub-basin 6"
4854,200,2,3300,3500,"Sub-basin 6"
4855,200,8,2100,2300,"Sub-basin 6"
4856,10700,4166,9600,20300,"Sub-basin 6"
4857,100,4,500,600,"Sub-basin 6"
4858,100,2,700,800,"Sub-basin 6"
4859,400,14,3700,4100,"Sub-basin 6"
4860,200,5,2200,2400,"Sub-basin 6"
4861,300,13,2800,3100,"Sub-basin 6"
4862,2900,325,12000,14900,"Sub-basin 6"
4863,200,4,2000,2200,"Sub-basin 6"
4864,400,21,4200,4600,"Sub-basin 6"
4865,1500,193,4000,5500,"Sub-basin 6"
4866,400,21,2300,2700,"Sub-basin 6"
4867,900,61,6100,7000,"Sub-basin 6"
4868,200,9,3100,3300,"Sub-basin 6"
4869,400,24,6000,6400,"Sub-basin 6"
4870,600,37,2700,3300,"Sub-basin 6"
4871,300,6,2100,2400,"Sub-basin 6"
4872,300,14,2200,2500,"Sub-basin 6"
4873,2000,120,7300,9300,"Sub-basin 6"
4874,400,16,5300,5700,"Sub-basin 6"
4875,600,32,4200,4800,"Sub-basin 6"
4876,1100,110,7000,8100,"Sub-basin 6"
4877,700,47,6300,7000,"Sub-basin 6"
4878,13600,1773,24700,38300,"Sub-basin 6"
4879,600,29,4400,5000,"Sub-basin 6"
4880,100,2,1100,1200,"Sub-basin 6"
4881,300,10,5300,5600,"Sub-basin 6"
4882,1000,81,8400,9400,"Sub-basin 6"
4883,200,3,1900,2100,"Sub-basin 6"
4884,100,5,1000,1100,"Sub-basin 6"
4885,600,39,5000,5600,"Sub-basin 6"
4886,800,59,4200,5000,"Sub-basin 6"
4887,100,4,600,700,"Sub-basin 6"
4888,800,82,5000,5800,"Sub-basin 6"
4889,100,1,1000,1100,"Sub-basin 6"
4890,7600,2374,11300,18900,"Sub-basin 6"
4891,800,105,10100,10900,"Sub-basin 6"
4892,900,65,6000,6900,"Sub-basin 6"
4893,100,2,1100,1200,"Sub-basin 6"
4894,900,75,3500,4400,"Sub-basin 6"
4895,1100,43,5300,6400,"Sub-basin 6"
4896,1600,171,8900,10500,"Sub-basin 6"
4897,1000,90,5100,6100,"Sub-basin 6"
4898,100,8,1000,1100,"Sub-basin 6"
4899,100,1,1600,1700,"Sub-basin 6"
4900,100,4,4000,4100,"Sub-basin 6"
4901,900,68.0229,16500,17400,"Sub-basin 6"
4902,1000,139,4800,5800,"Sub-basin 6"
4903,400,17,1300,1700,"Sub-basin 6"
4904,1000,141,1100,2100,"Sub-basin 6"
4905,600,31,5700,6300,"Sub-basin 6"
4906,1000,77,3700,4700,"Sub-basin 6"
4907,500,38,2200,2700,"Sub-basin 6"
4908,200,10,3100,3300,"Sub-basin 6"
4909,24800,3615.68,107200,132000,"Sub-basin 6"
4910,500,24,3600,4100,"Sub-basin 6"
4911,300,23,2200,2500,"Sub-basin 6"
4912,300,18,2200,2500,"Sub-basin 6"
4913,200,4,1600,1800,"Sub-basin 6"
4914,2900,329.99,7200,10100,"Sub-basin 6"
4915,500,26,10900,11400,"Sub-basin 6"
4916,6500,1987,4800,11300,"Sub-basin 6"
4917,2800,291,11200,14000,"Sub-basin 6"
4918,1100,76,3900,5000,"Sub-basin 6"
4919,300,10,2600,2900,"Sub-basin 6"
4920,300,4,500,800,"Sub-basin 6"
4921,300,12,2900,3200,"Sub-basin 6"
4922,100,1,200,300,"Sub-basin 6"
4923,4700,1289,17500,22200,"Sub-basin 6"
4924,100,1,1000,1100,"Sub-basin 6"
4925,1900,153,8800,10700,"Sub-basin 6"
4926,800,82,9900,10700,"Sub-basin 6"
4927,100,13,2900,3000,"Sub-basin 6"
4928,900,102,3100,4000,"Sub-basin 6"
4929,200,10,3200,3400,"Sub-basin 6"
4930,100,2,500,600,"Sub-basin 6"
4931,100,2,500,600,"Sub-basin 6"
4932,9700,2580,24600,34300,"Sub-basin 6"
4933,3900,607,14900,18800,"Sub-basin 6"
4934,1100,48,8700,9800,"Sub-basin 6"
4935,100,1,1200,1300,"Sub-basin 6"
4936,400,29,3400,3800,"Sub-basin 6"
4937,200,13,900,1100,"Sub-basin 6"
4938,1500,127,8000,9500,"Sub-basin 6"
4939,200,3,1100,1300,"Sub-basin 6"
4940,1200,128,4100,5300,"Sub-basin 6"
4941,100,1,1000,1100,"Sub-basin 6"
4942,100,3,800,900,"Sub-basin 6"
4943,300,10,2300,2600,"Sub-basin 6"
4944,200,2,2300,2500,"Sub-basin 6"
4945,500,37,12700,13200,"Sub-basin 6"
4946,400,81,700,1100,"Sub-basin 6"
4947,300,36,2200,2500,"Sub-basin 6"
4948,400,58,3600,4000,"Sub-basin 6"
4949,400,13,5000,5400,"Sub-basin 6"
4950,100,1,1100,1200,"Sub-basin 6"
4951,100,2,1400,1500,"Sub-basin 6"
4952,200,9,3200,3400,"Sub-basin 6"
4953,800,102,2300,3100,"Sub-basin 6"
4954,100,2,1700,1800,"Sub-basin 6"
4955,1000,70,11300,12300,"Sub-basin 6"
4956,100,3,1100,1200,"Sub-basin 6"
4957,1200,131,5700,6900,"Sub-basin 6"
4958,1400,172,9400,10800,"Sub-basin 6"
4959,3700,890,10000,13700,"Sub-basin 6"
4960,400,22,3200,3600,"Sub-basin 6"
4961,2000,489,5000,7000,"Sub-basin 6"
4962,500,162,2100,2600,"Sub-basin 6"
4963,100,1,1000,1100,"Sub-basin 6"
4964,2100,448,9800,11900,"Sub-basin 6"
4965,100,2,1300,1400,"Sub-basin 6"
4966,300,22,2500,2800,"Sub-basin 6"
4967,900,148,5700,6600,"Sub-basin 6"
4968,400,32,2000,2400,"Sub-basin 6"
4969,3900,345,32200,36100,"Sub-basin 6"
4970,500,25.0131,14700,15200,"Sub-basin 6"
4971,1500,236,9400,10900,"Sub-basin 6"
4972,5100,3628,6700,11800,"Sub-basin 6"
4973,500,29,6800,7300,"Sub-basin 6"
4974,100,4,2100,2200,"Sub-basin 6"
4975,300,9,7600,7900,"Sub-basin 6"
4976,9300,2071,45100,54400,"Sub-basin 6"
4977,200,18,1100,1300,"Sub-basin 6"
4978,200,7,2300,2500,"Sub-basin 6"
4979,9300,2458,21100,30400,"Sub-basin 6"
4980,500,18,3300,3800,"Sub-basin 6"
4981,800,42,5000,5800,"Sub-basin 6"
4982,100,1,800,900,"Sub-basin 6"
4983,4600,785,29300,33900,"Sub-basin 6"
4984,3400,1249,12300,15700,"Sub-basin 6"
4985,200,2,3300,3500,"Sub-basin 6"
4986,100,3,5400,5500,"Sub-basin 6"
4987,300,11,1400,1700,"Sub-basin 6"
4988,400,13,3800,4200,"Sub-basin 6"
4989,100,2,1500,1600,"Sub-basin 6"
4990,200,3,2300,2500,"Sub-basin 6"
4991,1000,45,9400,10400,"Sub-basin 6"
4992,100,3,2300,2400,"Sub-basin 6"
4993,100,2,2200,2300,"Sub-basin 6"
4994,100,2,1600,1700,"Sub-basin 6"
4995,5200,881,20500,25700,"Sub-basin 6"
4996,300,14,2300,2600,"Sub-basin 6"
4997,200,2,2700,2900,"Sub-basin 6"
4998,9600,2219.17,46300,55900,"Sub-basin 6"
4999,600,24,5700,6300,"Sub-basin 6"
5000,100,2.0019,4200,4300,"Sub-basin 6"
5001,200,45,1600,1800,"Sub-basin 6"
5002,1300,122,5600,6900,"Sub-basin 6"
5003,200,3,1800,2000,"Sub-basin 6"
5004,3600,593,15600,19200,"Sub-basin 6"
5005,300,6,2600,2900,"Sub-basin 6"
5006,800,60,7500,8300,"Sub-basin 6"
5007,200,12,2900,3100,"Sub-basin 6"
5008,300,6,2500,2800,"Sub-basin 6"
5009,100,1,1600,1700,"Sub-basin 6"
5010,1000,99,6700,7700,"Sub-basin 6"
5011,200,6,2900,3100,"Sub-basin 6"
5012,600,77,900,1500,"Sub-basin 6"
5013,600,20,2600,3200,"Sub-basin 6"
5014,100,1,1100,1200,"Sub-basin 6"
5015,300,13,4100,4400,"Sub-basin 6"
5016,800,63,4000,4800,"Sub-basin 6"
5017,100,2,1100,1200,"Sub-basin 6"
5018,700,28,2800,3500,"Sub-basin 6"
5019,600,41,5500,6100,"Sub-basin 6"
5020,400,20,8700,9100,"Sub-basin 6"
5021,400,12.0238,10800,11200,"Sub-basin 6"
5022,100,2,2200,2300,"Sub-basin 6"
5023,200,6,1800,2000,"Sub-basin 6"
5024,400,20,3100,3500,"Sub-basin 6"
5025,3500,260,15500,19000,"Sub-basin 6"
5026,500,33,3600,4100,"Sub-basin 6"
5027,400,17,4100,4500,"Sub-basin 6"
5028,100,1.0021,3800,3900,"Sub-basin 6"
5029,300,12,1500,1800,"Sub-basin 6"
5030,400,52,2700,3100,"Sub-basin 6"
5031,100,1,1000,1100,"Sub-basin 6"
5032,1200,109,3100,4300,"Sub-basin 6"
5033,400,31,4200,4600,"Sub-basin 6"
5034,100,5,600,700,"Sub-basin 6"
5035,100,3.0017,3800,3900,"Sub-basin 6"
5036,500,120,1800,2300,"Sub-basin 6"
5037,1100,238,2500,3600,"Sub-basin 6"
5038,200,8,3000,3200,"Sub-basin 6"
5039,100,2,1400,1500,"Sub-basin 6"
5040,2500,341,25000,27500,"Sub-basin 6"
5041,100,2,2000,2100,"Sub-basin 6"
5042,900,54.67,9100,10000,"Sub-basin 6"
5043,1100,105.67,5800,6900,"Sub-basin 6"
5044,5100,984,9600,14700,"Sub-basin 6"
5045,400,19.68,1500,1900,"Sub-basin 6"
5046,400,20,5600,6000,"Sub-basin 6"
5047,600,59.17,12300,12900,"Sub-basin 6"
5048,200,18,2300,2500,"Sub-basin 6"
5049,1700,103,12600,14300,"Sub-basin 6"
5050,600,51,3100,3700,"Sub-basin 6"
5051,4600,848,11900,16500,"Sub-basin 6"
5052,100,2,1200,1300,"Sub-basin 6"
5053,300,12,4200,4500,"Sub-basin 6"
5054,100,3,2100,2200,"Sub-basin 6"
5055,100,2,700,800,"Sub-basin 6"
5056,100,2,1900,2000,"Sub-basin 6"
5057,800,68,9800,10600,"Sub-basin 6"
5058,100,5,900,1000,"Sub-basin 6"
5059,700,54,2200,2900,"Sub-basin 6"
5060,200,5,2400,2600,"Sub-basin 6"
5061,400,19,2900,3300,"Sub-basin 6"
5062,100,1.0017,3200,3300,"Sub-basin 6"
5063,900,44,16800,17700,"Sub-basin 6"
5064,700,58,5500,6200,"Sub-basin 6"
5065,900,150,4400,5300,"Sub-basin 6"
5066,1400,75,4300,5700,"Sub-basin 6"
5067,100,1,1400,1500,"Sub-basin 6"
5068,1100,64,5700,6800,"Sub-basin 6"
5069,600,74,3700,4300,"Sub-basin 6"
5070,100,1,2200,2300,"Sub-basin 6"
5071,800,39,14000,14800,"Sub-basin 6"
5072,500,36,3100,3600,"Sub-basin 6"
5073,400,12.0107,11100,11500,"Sub-basin 6"
5074,1300,102,9100,10400,"Sub-basin 6"
5075,100,3,900,1000,"Sub-basin 6"
5076,100,3,700,800,"Sub-basin 6"
5077,200,6,500,700,"Sub-basin 6"
5078,100,3,400,500,"Sub-basin 6"
5079,1400,139,3600,5000,"Sub-basin 6"
5080,100,1,400,500,"Sub-basin 6"
5081,1300,177,3500,4800,"Sub-basin 6"
5082,100,1,1600,1700,"Sub-basin 6"
5083,1700,154,12400,14100,"Sub-basin 6"
5084,600,40,5600,6200,"Sub-basin 6"
5085,300,10,1500,1800,"Sub-basin 6"
5086,200,4,3300,3500,"Sub-basin 6"
5087,1300,75,14000,15300,"Sub-basin 6"
5088,100,3,900,1000,"Sub-basin 6"
5089,7200,871,15900,23100,"Sub-basin 6"
5090,300,10,500,800,"Sub-basin 6"
5091,100,1,2200,2300,"Sub-basin 6"
5092,100,2,400,500,"Sub-basin 6"
5093,200,2,2400,2600,"Sub-basin 6"
5094,200,8,1100,1300,"Sub-basin 6"
5095,200,6,4100,4300,"Sub-basin 6"
5096,1100,331,4400,5500,"Sub-basin 6"
5097,1700,144,14600,16300,"Sub-basin 6"
5098,200,9,7200,7400,"Sub-basin 6"
5099,900,53,5200,6100,"Sub-basin 6"
5100,100,2,700,800,"Sub-basin 6"
5101,200,14,1900,2100,"Sub-basin 6"
5102,900,59,3800,4700,"Sub-basin 6"
5103,100,1,1900,2000,"Sub-basin 6"
5104,100,4,600,700,"Sub-basin 6"
5105,200,11,3800,4000,"Sub-basin 6"
5106,1600,341,11500,13100,"Sub-basin 6"
5107,100,2,500,600,"Sub-basin 6"
5108,200,8,900,1100,"Sub-basin 6"
5109,300,12,1500,1800,"Sub-basin 6"
5110,200,13,1200,1400,"Sub-basin 6"
5111,200,4,4300,4500,"Sub-basin 6"
5112,300,10,600,900,"Sub-basin 6"
5113,800,23,4900,5700,"Sub-basin 6"
5114,200,4,1800,2000,"Sub-basin 6"
5115,100,1,700,800,"Sub-basin 6"
5116,300,11,1700,2000,"Sub-basin 6"
5117,200,4,2100,2300,"Sub-basin 6"
5118,100,2,1100,1200,"Sub-basin 6"
5119,500,16,3400,3900,"Sub-basin 6"
5120,1200,96,8700,9900,"Sub-basin 6"
5121,700,54,6000,6700,"Sub-basin 6"
5122,1200,805,5200,6400,"Sub-basin 6"
5123,200,7,3600,3800,"Sub-basin 6"
5124,100,1,1900,2000,"Sub-basin 6"
5125,700,48,7400,8100,"Sub-basin 6"
5126,100,2,1700,1800,"Sub-basin 6"
5127,100,2,1100,1200,"Sub-basin 6"
5128,500,13,3700,4200,"Sub-basin 6"
5129,200,9,1000,1200,"Sub-basin 6"
5130,200,7,800,1000,"Sub-basin 6"
5131,200,3,2200,2400,"Sub-basin 6"
5132,100,1,1500,1600,"Sub-basin 6"
5133,200,11,2600,2800,"Sub-basin 6"
5134,400,27,1800,2200,"Sub-basin 6"
5135,500,34,11500,12000,"Sub-basin 6"
5136,400,14,5300,5700,"Sub-basin 6"
5137,100,4.0008,3700,3800,"Sub-basin 6"
5138,100,1,2800,2900,"Sub-basin 6"
5139,600,103,3900,4500,"Sub-basin 6"
5140,500,29,1800,2300,"Sub-basin 6"
5141,1300,131,4700,6000,"Sub-basin 6"
5142,200,4,1200,1400,"Sub-basin 6"
5143,300,18,1300,1600,"Sub-basin 6"
5144,100,2,600,700,"Sub-basin 6"
5145,100,7,1900,2000,"Sub-basin 6"
5146,100,1,1700,1800,"Sub-basin 6"
5147,400,33,1900,2300,"Sub-basin 6"
5148,300,8,6000,6300,"Sub-basin 6"
5149,2900,973,5600,8500,"Sub-basin 6"
5150,300,18,1600,1900,"Sub-basin 6"
5151,200,3,1800,2000,"Sub-basin 6"
5152,100,1,600,700,"Sub-basin 6"
5153,200,9,2400,2600,"Sub-basin 6"
5154,1300,133,8500,9800,"Sub-basin 6"
5155,100,2,1900,2000,"Sub-basin 6"
5156,500,66,5600,6100,"Sub-basin 6"
5157,100,10,1600,1700,"Sub-basin 6"
5158,600,29,2300,2900,"Sub-basin 6"
5159,700,41,5900,6600,"Sub-basin 6"
5160,100,1,1600,1700,"Sub-basin 6"
5161,3000,345,8400,11400,"Sub-basin 6"
5162,400,15,2900,3300,"Sub-basin 6"
5163,500,24,3700,4200,"Sub-basin 6"
5164,100,2,1000,1100,"Sub-basin 6"
5165,1800,339,2800,4600,"Sub-basin 6"
5166,700,62,3800,4500,"Sub-basin 6"
5167,100,1,1600,1700,"Sub-basin 6"
5168,100,1,1800,1900,"Sub-basin 6"
5169,900,37,2800,3700,"Sub-basin 6"
5170,900,75,11300,12200,"Sub-basin 6"
5171,200,22,1700,1900,"Sub-basin 6"
5172,2300,297,5800,8100,"Sub-basin 6"
5173,900,61,6500,7400,"Sub-basin 6"
5174,200,14,3900,4100,"Sub-basin 6"
5175,400,30,1600,2000,"Sub-basin 6"
5176,100,5,1700,1800,"Sub-basin 6"
5177,200,6,2800,3000,"Sub-basin 6"
5178,100,1,1500,1600,"Sub-basin 6"
5179,100,1,2100,2200,"Sub-basin 6"
5180,200,9,3000,3200,"Sub-basin 6"
5181,500,22,4200,4700,"Sub-basin 6"
5182,2200,231,7800,10000,"Sub-basin 6"
5183,200,3,2000,2200,"Sub-basin 6"
5184,200,2,1000,1200,"Sub-basin 6"
5185,400,37,4000,4400,"Sub-basin 6"
5186,200,6,2100,2300,"Sub-basin 6"
5187,500,15,3800,4300,"Sub-basin 6"
5188,100,3,1500,1600,"Sub-basin 6"
5189,400,17,3000,3400,"Sub-basin 6"
5190,200,10,1800,2000,"Sub-basin 6"
5191,100,2,1500,1600,"Sub-basin 6"
5192,200,10,3700,3900,"Sub-basin 6"
5193,200,11,3800,4000,"Sub-basin 6"
5194,700,27.0224,21800,22500,"Sub-basin 6"
5195,200,5,1500,1700,"Sub-basin 6"
5196,1000,86,1900,2900,"Sub-basin 6"
5197,300,18,1800,2100,"Sub-basin 6"
5198,100,3,600,700,"Sub-basin 6"
5199,400,41,3800,4200,"Sub-basin 6"
5200,100,2,1200,1300,"Sub-basin 6"
5201,100,3,2300,2400,"Sub-basin 6"
5202,200,5,2500,2700,"Sub-basin 6"
5203,100,4,1900,2000,"Sub-basin 6"
5204,100,1,900,1000,"Sub-basin 6"
5205,600,39,5900,6500,"Sub-basin 6"
5206,200,6,1900,2100,"Sub-basin 6"
5207,400,27,4100,4500,"Sub-basin 6"
5208,100,1,1500,1600,"Sub-basin 6"
5209,700,62,2900,3600,"Sub-basin 6"
5210,100,2,600,700,"Sub-basin 6"
5211,100,1,600,700,"Sub-basin 6"
5212,1400,118,13300,14700,"Sub-basin 6"
5213,500,13,7800,8300,"Sub-basin 6"
5214,200,23,2200,2400,"Sub-basin 6"
5215,300,10,3800,4100,"Sub-basin 6"
5216,100,1,2400,2500,"Sub-basin 6"
5217,100,2,1300,1400,"Sub-basin 6"
5218,900,101,22000,22900,"Sub-basin 6"
5219,500,19,1700,2200,"Sub-basin 6"
5220,700,60,3200,3900,"Sub-basin 6"
5221,200,4,1800,2000,"Sub-basin 6"
5222,200,3,2500,2700,"Sub-basin 6"
5223,1300,207,5900,7200,"Sub-basin 6"
5224,600,40,3000,3600,"Sub-basin 6"
5225,4300,1253,9600,13900,"Sub-basin 6"
5226,9900,3772,19300,29200,"Sub-basin 6"
5227,400,41,1800,2200,"Sub-basin 6"
5228,200,14,2400,2600,"Sub-basin 6"
5229,500,20,5300,5800,"Sub-basin 6"
5230,200,9,1300,1500,"Sub-basin 6"
5231,600,101,1600,2200,"Sub-basin 6"
5232,100,13,800,900,"Sub-basin 6"
5233,1600,268,7900,9500,"Sub-basin 6"
5234,200,6,1700,1900,"Sub-basin 6"
5235,500,17,5500,6000,"Sub-basin 6"
5236,100,1,1100,1200,"Sub-basin 6"
5237,100,2,1500,1600,"Sub-basin 6"
5238,600,43,11100,11700,"Sub-basin 6"
5239,1000,66,5900,6900,"Sub-basin 6"
5240,600,19,5600,6200,"Sub-basin 6"
5241,100,3,1600,1700,"Sub-basin 6"
5242,200,10,1500,1700,"Sub-basin 6"
5243,100,1,2300,2400,"Sub-basin 6"
5244,100,1,2200,2300,"Sub-basin 6"
5245,900,210,2000,2900,"Sub-basin 6"
5246,2700,743,4700,7400,"Sub-basin 6"
5247,600,103,2600,3200,"Sub-basin 6"
5248,100,6,4800,4900,"Sub-basin 6"
5249,1100,105,7300,8400,"Sub-basin 6"
5250,100,2,1500,1600,"Sub-basin 6"
5251,1900,579,3700,5600,"Sub-basin 6"
5252,1100,96,8800,9900,"Sub-basin 6"
5253,100,1,2400,2500,"Sub-basin 6"
5254,300,27,2400,2700,"Sub-basin 6"
5255,3900,474,20400,24300,"Sub-basin 6"
5256,200,14.004,7200,7400,"Sub-basin 6"
5257,200,5,3200,3400,"Sub-basin 6"
5258,100,2,900,1000,"Sub-basin 6"
5259,100,4,400,500,"Sub-basin 6"
5260,3000,577,11000,14000,"Sub-basin 6"
5261,2800,1001,7400,10200,"Sub-basin 6"
5262,400,15,1700,2100,"Sub-basin 6"
5263,300,18,1900,2200,"Sub-basin 6"
5264,600,19,4500,5100,"Sub-basin 6"
5265,200,7,2100,2300,"Sub-basin 6"
5266,200,6,5000,5200,"Sub-basin 6"
5267,300,7,5700,6000,"Sub-basin 6"
5268,300,12,3200,3500,"Sub-basin 6"
5269,2100,183,13900,16000,"Sub-basin 6"
5270,100,1,400,500,"Sub-basin 6"
5271,100,2,800,900,"Sub-basin 6"
5272,100,2,1000,1100,"Sub-basin 6"
5273,300,7,2300,2600,"Sub-basin 6"
5274,300,22.0052,5800,6100,"Sub-basin 6"
5275,100,2,1100,1200,"Sub-basin 6"
5276,100,1,1300,1400,"Sub-basin 6"
5277,200,5,1300,1500,"Sub-basin 6"
5278,100,14,1600,1700,"Sub-basin 6"
5279,1100,75,8600,9700,"Sub-basin 6"
5280,800,63,5300,6100,"Sub-basin 6"
5281,100,1,600,700,"Sub-basin 6"
5282,800,137,2800,3600,"Sub-basin 6"
5283,400,82,1600,2000,"Sub-basin 6"
5284,100,4,1700,1800,"Sub-basin 6"
5285,100,2,1300,1400,"Sub-basin 6"
5286,100,1,2000,2100,"Sub-basin 6"
5287,400,30,8100,8500,"Sub-basin 6"
5288,200,10,2900,3100,"Sub-basin 6"
5289,100,4,1700,1800,"Sub-basin 6"
5290,200,4,2500,2700,"Sub-basin 6"
5291,900,60,3500,4400,"Sub-basin 6"
5292,400,15,3000,3400,"Sub-basin 6"
5293,100,1,900,1000,"Sub-basin 6"
5294,4100,540,22300,26400,"Sub-basin 6"
5295,100,6,1500,1600,"Sub-basin 6"
5296,300,18,9300,9600,"Sub-basin 6"
5297,4900,700.5922,107900,112800,"Sub-basin 6"
5298,3100,198,23400,26500,"Sub-basin 6"
5299,1200,109,4000,5200,"Sub-basin 6"
5300,2600,742,5300,7900,"Sub-basin 6"
5301,7000,2112,27900,34900,"Sub-basin 6"
5302,100,2,1300,1400,"Sub-basin 6"
5303,100,1,1000,1100,"Sub-basin 6"
5304,400,10,4700,5100,"Sub-basin 6"
5305,200,5,1900,2100,"Sub-basin 6"
5306,100,1,1600,1700,"Sub-basin 6"
5307,300,13,3800,4100,"Sub-basin 6"
5308,1600,166,7100,8700,"Sub-basin 6"
5309,100,3,1300,1400,"Sub-basin 6"
5310,1800,100,11700,13500,"Sub-basin 6"
5311,1500,82,7800,9300,"Sub-basin 6"
5312,7400,3776,29000,36400,"Sub-basin 6"
5313,100,1,1200,1300,"Sub-basin 6"
5314,200,2,1900,2100,"Sub-basin 6"
5315,200,9,2000,2200,"Sub-basin 6"
5316,100,1,2500,2600,"Sub-basin 6"
5317,400,30,4300,4700,"Sub-basin 6"
5318,500,14,1900,2400,"Sub-basin 6"
5319,200,7,3500,3700,"Sub-basin 6"
5320,100,1,2400,2500,"Sub-basin 6"
5321,100,2,1300,1400,"Sub-basin 6"
5322,4000,327.83,27000,31000,"Sub-basin 6"
5323,300,17,1900,2200,"Sub-basin 6"
5324,200,5,2100,2300,"Sub-basin 6"
5325,5800,475,33000,38800,"Sub-basin 6"
5326,100,4,900,1000,"Sub-basin 6"
5327,300,18,2600,2900,"Sub-basin 6"
5328,900,39,11800,12700,"Sub-basin 6"
5329,300,8,5200,5500,"Sub-basin 6"
5330,1000,109,2200,3200,"Sub-basin 6"
5331,7300,1207,9800,17100,"Sub-basin 6"
5332,100,3,1400,1500,"Sub-basin 6"
5333,100,1,1800,1900,"Sub-basin 6"
5334,100,2,1200,1300,"Sub-basin 6"
5335,300,15,7000,7300,"Sub-basin 6"
5336,400,31,2200,2600,"Sub-basin 6"
5337,1100,272,2500,3600,"Sub-basin 6"
5338,800,171,5800,6600,"Sub-basin 6"
5339,100,2,1600,1700,"Sub-basin 6"
5340,100,2,1000,1100,"Sub-basin 6"
5341,1700,870,4700,6400,"Sub-basin 6"
5342,600,10,5100,5700,"Sub-basin 6"
5343,1200,124,4900,6100,"Sub-basin 6"
5344,400,10,4300,4700,"Sub-basin 6"
5345,100,1,2400,2500,"Sub-basin 6"
5346,100,2,1600,1700,"Sub-basin 6"
5347,1000,108,3600,4600,"Sub-basin 6"
5348,4100,2277,8100,12200,"Sub-basin 6"
5349,700,28,7500,8200,"Sub-basin 6"
5350,1100,63,8700,9800,"Sub-basin 6"
5351,100,2,900,1000,"Sub-basin 6"
5352,2500,190,18800,21300,"Sub-basin 6"
5353,700,50,6300,7000,"Sub-basin 6"
5354,400,68,2400,2800,"Sub-basin 6"
5355,900,90,6700,7600,"Sub-basin 6"
5356,100,4,1700,1800,"Sub-basin 6"
5357,300,8,3200,3500,"Sub-basin 6"
5358,500,19,4700,5200,"Sub-basin 6"
5359,500,24,3300,3800,"Sub-basin 6"
5360,900,72,4000,4900,"Sub-basin 6"
5361,300,6,3000,3300,"Sub-basin 6"
5362,2200,154,11500,13700,"Sub-basin 6"
5363,100,1,1300,1400,"Sub-basin 6"
5364,200,5,3700,3900,"Sub-basin 6"
5365,400,63,6900,7300,"Sub-basin 6"
5366,3400,316,33200,36600,"Sub-basin 6"
5367,300,16,3600,3900,"Sub-basin 6"
5368,400,24,3000,3400,"Sub-basin 6"
5369,300,9,5300,5600,"Sub-basin 6"
5370,600,23,11500,12100,"Sub-basin 6"
5371,100,2,1100,1200,"Sub-basin 6"
5372,3000,401,19100,22100,"Sub-basin 6"
5373,1400,266,4200,5600,"Sub-basin 6"
5374,7200,1758,19300,26500,"Sub-basin 6"
5375,200,5,2800,3000,"Sub-basin 6"
5376,200,6,2300,2500,"Sub-basin 6"
5377,100,1,900,1000,"Sub-basin 6"
5378,200,7,3400,3600,"Sub-basin 6"
5379,300,9,4500,4800,"Sub-basin 6"
5380,800,88,5000,5800,"Sub-basin 6"
5381,500,65,1400,1900,"Sub-basin 6"
5382,900,59,7500,8400,"Sub-basin 6"
5383,100,1,1400,1500,"Sub-basin 6"
5384,100,2,800,900,"Sub-basin 6"
5385,100,2,1100,1200,"Sub-basin 6"
5386,700,111,7900,8600,"Sub-basin 6"
5387,1100,63,9400,10500,"Sub-basin 6"
5388,200,7,2900,3100,"Sub-basin 6"
5389,52400,13795,154600,207000,"Sub-basin 6"
5390,100,8,1200,1300,"Sub-basin 6"
5391,700,127,4000,4700,"Sub-basin 6"
5392,600,33,3600,4200,"Sub-basin 6"
5393,200,4,1700,1900,"Sub-basin 6"
5394,100,1,1700,1800,"Sub-basin 6"
5395,1200,55,8600,9800,"Sub-basin 6"
5396,400,58,3000,3400,"Sub-basin 6"
5397,500,14,4900,5400,"Sub-basin 6"
5398,100,3,1700,1800,"Sub-basin 6"
5399,100,4,1600,1700,"Sub-basin 6"
5400,1400,52,16200,17600,"Sub-basin 6"
5401,2800,239,29800,32600,"Sub-basin 6"
5402,200,5,1300,1500,"Sub-basin 6"
5403,200,7,3000,3200,"Sub-basin 6"
5404,100,1,3300,3400,"Sub-basin 6"
5405,100,1,1700,1800,"Sub-basin 6"
5406,6200,2241,20000,26200,"Sub-basin 6"
5407,1000,59,6000,7000,"Sub-basin 6"
5408,500,20,2800,3300,"Sub-basin 6"
5409,100,3,2200,2300,"Sub-basin 6"
5410,700,90,1900,2600,"Sub-basin 6"
5411,500,20,5400,5900,"Sub-basin 6"
5412,400,38,2600,3000,"Sub-basin 6"
5413,100,1,1300,1400,"Sub-basin 6"
5414,200,3,2500,2700,"Sub-basin 6"
5415,300,11,2800,3100,"Sub-basin 6"
5416,100,6,1500,1600,"Sub-basin 6"
5417,100,1,1600,1700,"Sub-basin 6"
5418,100,1,1400,1500,"Sub-basin 6"
5419,100,1,500,600,"Sub-basin 6"
5420,300,11,2800,3100,"Sub-basin 6"
5421,100,3,1200,1300,"Sub-basin 6"
5422,900,117,9000,9900,"Sub-basin 6"
5423,200,5,3000,3200,"Sub-basin 6"
5424,400,16,6000,6400,"Sub-basin 6"
5425,100,1,500,600,"Sub-basin 6"
5426,200,12,2700,2900,"Sub-basin 6"
5427,400,32,3600,4000,"Sub-basin 6"
5428,600,42,1500,2100,"Sub-basin 6"
5429,200,4,1900,2100,"Sub-basin 6"
5430,300,8,2400,2700,"Sub-basin 6"
5431,1000,37,10700,11700,"Sub-basin 6"
5432,100,1,3200,3300,"Sub-basin 6"
5433,700,36,9700,10400,"Sub-basin 6"
5434,100,2,1100,1200,"Sub-basin 6"
5435,600,86,2500,3100,"Sub-basin 6"
5436,1300,126,6200,7500,"Sub-basin 6"
5437,300,7,6700,7000,"Sub-basin 6"
5438,100,1,1200,1300,"Sub-basin 6"
5439,600,56,6100,6700,"Sub-basin 6"
5440,800,62,4600,5400,"Sub-basin 6"
5441,100,1,2100,2200,"Sub-basin 6"
5442,200,4,2400,2600,"Sub-basin 6"
5443,600,13,7600,8200,"Sub-basin 6"
5444,1000,94,7500,8500,"Sub-basin 6"
5445,200,3,5100,5300,"Sub-basin 6"
5446,100,2,2900,3000,"Sub-basin 6"
5447,6500,926,22700,29200,"Sub-basin 6"
5448,2300,437,8600,10900,"Sub-basin 6"
5449,500,44,2100,2600,"Sub-basin 6"
5450,700,11,11100,11800,"Sub-basin 6"
5451,200,4,4700,4900,"Sub-basin 6"
5452,500,9,6300,6800,"Sub-basin 6"
5453,1100,25,12700,13800,"Sub-basin 6"
5454,700,86,2100,2800,"Sub-basin 6"
5455,200,5,1400,1600,"Sub-basin 6"
5456,22500,3458,82200,104700,"Sub-basin 6"
5457,300,9,2600,2900,"Sub-basin 6"
5458,2200,1484.589,4300,6500,"Sub-basin 6"
5459,100,1,2600,2700,"Sub-basin 6"
5460,400,21,6300,6700,"Sub-basin 6"
5461,700,28,8100,8800,"Sub-basin 6"
5462,700,31,9200,9900,"Sub-basin 6"
5463,100,4,2000,2100,"Sub-basin 6"
5464,900,100,3100,4000,"Sub-basin 6"
5465,200,7,2200,2400,"Sub-basin 6"
5466,700,75,2700,3400,"Sub-basin 6"
5467,100,1,1000,1100,"Sub-basin 6"
5468,100,2,2100,2200,"Sub-basin 6"
5469,2700,173,20600,23300,"Sub-basin 6"
5470,100,11,1200,1300,"Sub-basin 6"
5471,700,43,2700,3400,"Sub-basin 6"
5472,1100,76,8300,9400,"Sub-basin 6"
5473,400,24,7600,8000,"Sub-basin 6"
5474,400,12,4200,4600,"Sub-basin 6"
5475,100,1,1000,1100,"Sub-basin 6"
5476,100,2,800,900,"Sub-basin 6"
5477,300,6,1000,1300,"Sub-basin 6"
5478,800,31,6000,6800,"Sub-basin 6"
5479,200,3,1200,1400,"Sub-basin 6"
5480,600,30,7400,8000,"Sub-basin 6"
5481,100,3,2000,2100,"Sub-basin 6"
5482,100,1,1400,1500,"Sub-basin 6"
5483,1900,104,10100,12000,"Sub-basin 6"
5484,1000,62,3300,4300,"Sub-basin 6"
5485,100,3,1400,1500,"Sub-basin 6"
5486,1200,38,9500,10700,"Sub-basin 6"
5487,1300,200,9400,10700,"Sub-basin 6"
5488,100,1,1400,1500,"Sub-basin 6"
5489,500,18,3500,4000,"Sub-basin 6"
5490,200,10,1000,1200,"Sub-basin 6"
5491,500,27,4100,4600,"Sub-basin 6"
5492,23000,4938,30000,53000,"Sub-basin 6"
5493,100,1,1300,1400,"Sub-basin 6"
5494,1400,225,14100,15500,"Sub-basin 6"
5495,1800,302,10500,12300,"Sub-basin 6"
5496,300,15,2800,3100,"Sub-basin 6"
5497,4800,1731,21600,26400,"Sub-basin 6"
5498,200,6,600,800,"Sub-basin 6"
5499,800,50,3700,4500,"Sub-basin 6"
5500,400,13,7800,8200,"Sub-basin 6"
5501,200,8,4200,4400,"Sub-basin 6"
5502,6200,527,41100,47300,"Sub-basin 6"
5503,7700,1056,24900,32600,"Sub-basin 6"
5504,400,17,2600,3000,"Sub-basin 6"
5505,100,1,800,900,"Sub-basin 6"
5506,200,6,1500,1700,"Sub-basin 6"
5507,1100,257,3500,4600,"Sub-basin 6"
5508,100,1,1400,1500,"Sub-basin 6"
5509,200,21,3400,3600,"Sub-basin 6"
5510,3100,495,8700,11800,"Sub-basin 6"
5511,1000,169,5800,6800,"Sub-basin 6"
5512,700,273,3200,3900,"Sub-basin 6"
5513,500,28,3800,4300,"Sub-basin 6"
5514,600,31,1700,2300,"Sub-basin 6"
5515,200,7,1700,1900,"Sub-basin 6"
5516,200,8,1800,2000,"Sub-basin 6"
5517,1200,242,4600,5800,"Sub-basin 6"
5518,200,6,2300,2500,"Sub-basin 6"
5519,100,2,1400,1500,"Sub-basin 6"
5520,800,49,1800,2600,"Sub-basin 6"
5521,800,118,2100,2900,"Sub-basin 6"
5522,100,1,2200,2300,"Sub-basin 6"
5523,1100,113,7700,8800,"Sub-basin 6"
5524,100,2,1800,1900,"Sub-basin 6"
5525,200,7,3600,3800,"Sub-basin 6"
5526,400,59,2100,2500,"Sub-basin 6"
5527,400,14,2200,2600,"Sub-basin 6"
5528,1800,176,15100,16900,"Sub-basin 6"
5529,400,25,4500,4900,"Sub-basin 6"
5530,500,108.0087,7300,7800,"Sub-basin 6"
5531,300,5,3100,3400,"Sub-basin 6"
5532,200,3,1500,1700,"Sub-basin 6"
5533,100,4,100,200,"Sub-basin 6"
5534,100,3,1400,1500,"Sub-basin 6"
5535,300,16,2500,2800,"Sub-basin 6"
5536,200,2,900,1100,"Sub-basin 6"
5537,800,52,5400,6200,"Sub-basin 6"
5538,200,5,3900,4100,"Sub-basin 6"
5539,100,1,2900,3000,"Sub-basin 6"
5540,1400,117,11100,12500,"Sub-basin 6"
5541,100,1,700,800,"Sub-basin 6"
5542,900,146,11300,12200,"Sub-basin 6"
5543,100,4,2400,2500,"Sub-basin 6"
5544,1200,79,7700,8900,"Sub-basin 6"
5545,100,1,1700,1800,"Sub-basin 6"
5546,100,1,3000,3100,"Sub-basin 6"
5547,200,15,1800,2000,"Sub-basin 6"
5548,200,10,1200,1400,"Sub-basin 6"
5549,100,1,1100,1200,"Sub-basin 6"
5550,500,39,2400,2900,"Sub-basin 6"
5551,2400,1435.4472,3900,6300,"Sub-basin 6"
5552,3600,1170,7000,10600,"Sub-basin 6"
5553,100,3,1700,1800,"Sub-basin 6"
5554,2800,1069,4300,7100,"Sub-basin 6"
5555,200,8,1500,1700,"Sub-basin 6"
5556,1800,808,3600,5400,"Sub-basin 6"
5557,2500,452,11100,13600,"Sub-basin 6"
5558,900,44,10700,11600,"Sub-basin 6"
5559,200,8.0017,4300,4500,"Sub-basin 6"
5560,200,8,1400,1600,"Sub-basin 6"
5561,600,167,1300,1900,"Sub-basin 6"
5562,200,6,1700,1900,"Sub-basin 6"
5563,100,1,1000,1100,"Sub-basin 6"
5564,100,3,1000,1100,"Sub-basin 6"
5565,1000,98,5700,6700,"Sub-basin 6"
5566,100,2,300,400,"Sub-basin 6"
5567,200,12,2100,2300,"Sub-basin 6"
5568,400,9,3400,3800,"Sub-basin 6"
5569,100,2,1300,1400,"Sub-basin 6"
5570,1500,577,2400,3900,"Sub-basin 6"
5571,2200,2128,9100,11300,"Sub-basin 6"
5572,1700,75,12800,14500,"Sub-basin 6"
5573,100,3,4100,4200,"Sub-basin 6"
5574,200,3,6000,6200,"Sub-basin 6"
5575,100,4,2000,2100,"Sub-basin 6"
5576,100,1,1200,1300,"Sub-basin 6"
5577,9200,2170,17300,26500,"Sub-basin 6"
5578,100,1,3600,3700,"Sub-basin 6"
5579,1300,140,9600,10900,"Sub-basin 6"
5580,100,11.0016,4500,4600,"Sub-basin 6"
5581,200,7,2900,3100,"Sub-basin 6"
5582,100,7,1200,1300,"Sub-basin 6"
5583,200,9,1700,1900,"Sub-basin 6"
5584,1100,150,3200,4300,"Sub-basin 6"
5585,3400,1185,5200,8600,"Sub-basin 6"
5586,3100,1327,5500,8600,"Sub-basin 6"
5587,200,9,3400,3600,"Sub-basin 6"
5588,2000,160,13800,15800,"Sub-basin 6"
5589,100,1,1600,1700,"Sub-basin 6"
5590,2500,720.0546,40000,42500,"Sub-basin 6"
5591,100,2,4100,4200,"Sub-basin 6"
5592,900,53,10200,11100,"Sub-basin 6"
5593,200,3,1900,2100,"Sub-basin 6"
5594,100,3,1500,1600,"Sub-basin 6"
5595,1000,66.0169,12700,13700,"Sub-basin 6"
5596,300,7,3700,4000,"Sub-basin 6"
5597,400,7,8000,8400,"Sub-basin 6"
5598,900,170.0161,14000,14900,"Sub-basin 6"
5599,400,46,8900,9300,"Sub-basin 6"
5600,200,10,2500,2700,"Sub-basin 6"
5601,25100,7575,33100,58200,"Sub-basin 6"
5602,3100,800,9800,12900,"Sub-basin 6"
5603,100,9,3000,3100,"Sub-basin 6"
5604,100,4.0018,4500,4600,"Sub-basin 6"
5605,1300,58.0178,19300,20600,"Sub-basin 6"
5606,100,1,2000,2100,"Sub-basin 6"
5607,1500,112,12500,14000,"Sub-basin 6"
5608,600,20,5500,6100,"Sub-basin 6"
5609,100,1,300,400,"Sub-basin 6"
5610,400,130,2100,2500,"Sub-basin 6"
5611,100,2.0022,2300,2400,"Sub-basin 6"
5612,400,20,6600,7000,"Sub-basin 6"
5613,400,9,4000,4400,"Sub-basin 6"
5614,100,4,1400,1500,"Sub-basin 6"
5615,100,5,2400,2500,"Sub-basin 6"
5616,200,7,1200,1400,"Sub-basin 6"
5617,200,6,1300,1500,"Sub-basin 6"
5618,500,30,3800,4300,"Sub-basin 6"
5619,100,2,1300,1400,"Sub-basin 6"
5620,200,5,3600,3800,"Sub-basin 6"
5621,200,3.0048,5300,5500,"Sub-basin 6"
5622,500,13,4100,4600,"Sub-basin 6"
5623,400,6,5600,6000,"Sub-basin 6"
5624,400,12,800,1200,"Sub-basin 6"
5625,500,76,2100,2600,"Sub-basin 6"
5626,100,1,300,400,"Sub-basin 6"
5627,100,2,1100,1200,"Sub-basin 6"
5628,1400,228,6000,7400,"Sub-basin 6"
5629,300,14,2000,2300,"Sub-basin 6"
5630,100,1,1200,1300,"Sub-basin 6"
5631,200,30,3400,3600,"Sub-basin 6"
5632,400,17,4400,4800,"Sub-basin 6"
5633,400,34,5300,5700,"Sub-basin 6"
5634,500,29,3200,3700,"Sub-basin 6"
5635,900,199,2900,3800,"Sub-basin 6"
5636,1000,137,2000,3000,"Sub-basin 6"
5637,6900,2846.2181,36200,43100,"Sub-basin 6"
5638,300,12.0084,8900,9200,"Sub-basin 6"
5639,100,1,2000,2100,"Sub-basin 6"
5640,300,6,4200,4500,"Sub-basin 6"
5641,1100,130,4000,5100,"Sub-basin 6"
5642,100,1,1100,1200,"Sub-basin 6"
5643,800,152,6100,6900,"Sub-basin 6"
5644,100,1.0001,5200,5300,"Sub-basin 6"
5645,100,2.0018,3400,3500,"Sub-basin 6"
5646,500,24,6400,6900,"Sub-basin 6"
5647,100,1,1700,1800,"Sub-basin 6"
5648,200,8,900,1100,"Sub-basin 6"
5649,400,41,2400,2800,"Sub-basin 6"
5650,400,49,3100,3500,"Sub-basin 6"
5651,100,1.0016,2900,3000,"Sub-basin 6"
5652,700,57,9300,10000,"Sub-basin 6"
5653,200,3,7300,7500,"Sub-basin 6"
5654,100,6.0011,4100,4200,"Sub-basin 6"
5655,100,3,1000,1100,"Sub-basin 6"
5656,400,17,2400,2800,"Sub-basin 6"
5657,300,9,1900,2200,"Sub-basin 6"
5658,400,10,4400,4800,"Sub-basin 6"
5659,100,1.0016,1900,2000,"Sub-basin 6"
5660,100,1.0016,3500,3600,"Sub-basin 6"
5661,300,12.0022,9600,9900,"Sub-basin 6"
5662,200,4.0037,8700,8900,"Sub-basin 6"
5663,2000,130,14000,16000,"Sub-basin 6"
5664,200,6,1900,2100,"Sub-basin 6"
5665,200,5,6600,6800,"Sub-basin 6"
5666,200,4,3800,4000,"Sub-basin 6"
5667,100,2.0012,2900,3000,"Sub-basin 6"
5668,3400,234,29200,32600,"Sub-basin 6"
5669,3000,408,14700,17700,"Sub-basin 6"
5670,300,17,2100,2400,"Sub-basin 6"
5671,200,47,2500,2700,"Sub-basin 6"
5672,700,49.0337,16200,16900,"Sub-basin 6"
5673,800,47,16000,16800,"Sub-basin 6"
5674,600,28,6000,6600,"Sub-basin 6"
5675,400,47.0052,4300,4700,"Sub-basin 6"
5676,600,97,2000,2600,"Sub-basin 6"
5677,400,30,2800,3200,"Sub-basin 6"
5678,100,1,2400,2500,"Sub-basin 6"
5679,200,5,5300,5500,"Sub-basin 6"
5680,1200,178,5300,6500,"Sub-basin 6"
5681,500,14,2000,2500,"Sub-basin 6"
5682,100,1.0015,2600,2700,"Sub-basin 6"
5683,1800,240,5300,7100,"Sub-basin 6"
5684,900,212,2400,3300,"Sub-basin 6"
5685,800,46,3200,4000,"Sub-basin 6"
5686,100,2,1300,1400,"Sub-basin 6"
5687,600,19,11700,12300,"Sub-basin 6"
5688,7300,1137.5663,70700,78000,"Sub-basin 6"
5689,200,2,3200,3400,"Sub-basin 6"
5690,200,9,2500,2700,"Sub-basin 6"
5691,100,5,800,900,"Sub-basin 6"
5692,2700,610,20700,23400,"Sub-basin 6"
5693,700,48,11100,11800,"Sub-basin 6"
5694,500,12,8500,9000,"Sub-basin 6"
5695,400,6,4400,4800,"Sub-basin 6"
5696,600,90,2500,3100,"Sub-basin 6"
5697,300,21,3100,3400,"Sub-basin 6"
5698,100,2,1900,2000,"Sub-basin 6"
5699,200,6,2700,2900,"Sub-basin 6"
5700,200,17,4400,4600,"Sub-basin 6"
5701,100,3,2900,3000,"Sub-basin 6"
5702,100,7.0011,2200,2300,"Sub-basin 6"
5703,1400,114.035,18300,19700,"Sub-basin 6"
5704,400,12,7200,7600,"Sub-basin 6"
5705,100,1,1300,1400,"Sub-basin 6"
5706,200,2,2100,2300,"Sub-basin 6"
5707,300,29,1900,2200,"Sub-basin 6"
5708,600,54,2400,3000,"Sub-basin 6"
5709,200,17,1600,1800,"Sub-basin 6"
5710,4200,893,26300,30500,"Sub-basin 6"
5711,100,4.0009,3000,3100,"Sub-basin 6"
5712,100,1,600,700,"Sub-basin 6"
5713,500,29,5400,5900,"Sub-basin 6"
5714,300,5,2300,2600,"Sub-basin 6"
5715,700,48,7200,7900,"Sub-basin 6"
5716,100,1,3300,3400,"Sub-basin 6"
5717,600,20,8200,8800,"Sub-basin 6"
5718,100,4,2800,2900,"Sub-basin 6"
5719,100,1.0023,2800,2900,"Sub-basin 6"
5720,100,1,1800,1900,"Sub-basin 6"
5721,100,2,1700,1800,"Sub-basin 6"
5722,200,2,2700,2900,"Sub-basin 6"
5723,400,21,2300,2700,"Sub-basin 6"
5724,100,6,2800,2900,"Sub-basin 6"
5725,100,3,1200,1300,"Sub-basin 6"
5726,100,1,4100,4200,"Sub-basin 6"
5727,100,1,3400,3500,"Sub-basin 6"
5728,2600,183.2927,39300,41900,"Sub-basin 6"
5729,100,1.0182,5200,5300,"Sub-basin 6"
5730,300,12,5800,6100,"Sub-basin 6"
5731,3500,812.2921,25100,28600,"Sub-basin 6"
5732,2100,160,13300,15400,"Sub-basin 6"
5733,300,5,1100,1400,"Sub-basin 6"
5734,1100,132,4000,5100,"Sub-basin 6"
5735,3900,1038,14100,18000,"Sub-basin 6"
5736,600,32,8000,8600,"Sub-basin 6"
5737,500,16.0036,4200,4700,"Sub-basin 6"
5738,200,37.0054,6000,6200,"Sub-basin 6"
5739,1300,56,8100,9400,"Sub-basin 6"
5740,100,3,900,1000,"Sub-basin 6"
5741,200,2,1700,1900,"Sub-basin 6"
5742,100,2,2400,2500,"Sub-basin 6"
5743,100,22.0013,2700,2800,"Sub-basin 6"
5744,200,6,3500,3700,"Sub-basin 6"
5745,500,26,9600,10100,"Sub-basin 6"
5746,200,10,2700,2900,"Sub-basin 6"
5747,300,8,3200,3500,"Sub-basin 6"
5748,21100,7011.17,38000,59100,"Sub-basin 6"
5749,100,3,1100,1200,"Sub-basin 6"
5750,600,89,2700,3300,"Sub-basin 6"
5751,100,4,1300,1400,"Sub-basin 6"
5752,300,19,6400,6700,"Sub-basin 6"
5753,1700,111,13500,15200,"Sub-basin 6"
5754,1000,35.0127,7100,8100,"Sub-basin 6"
5755,3300,441.0702,11100,14400,"Sub-basin 6"
5756,100,1,1300,1400,"Sub-basin 6"
5757,500,52,2600,3100,"Sub-basin 6"
5758,100,1,3900,4000,"Sub-basin 6"
5759,1500,144.0315,21600,23100,"Sub-basin 6"
5760,600,149,1800,2400,"Sub-basin 6"
5761,200,10,3200,3400,"Sub-basin 6"
5762,300,5,2900,3200,"Sub-basin 6"
5763,8900,1737,20600,29500,"Sub-basin 6"
5764,100,2,1200,1300,"Sub-basin 6"
5765,1100,127,9600,10700,"Sub-basin 6"
5766,600,63,4800,5400,"Sub-basin 6"
5767,100,12.0003,1100,1200,"Sub-basin 6"
5768,100,1,2200,2300,"Sub-basin 6"
5769,400,8,7200,7600,"Sub-basin 6"
5770,400,8,2900,3300,"Sub-basin 6"
5771,100,1,900,1000,"Sub-basin 6"
5772,1800,199.0743,44000,45800,"Sub-basin 6"
5773,100,1,2800,2900,"Sub-basin 6"
5774,100,1.0006,1800,1900,"Sub-basin 6"
5775,100,1,2100,2200,"Sub-basin 6"
5776,200,4,2100,2300,"Sub-basin 6"
5777,100,8,1100,1200,"Sub-basin 6"
5778,500,34,5100,5600,"Sub-basin 6"
5779,100,3,900,1000,"Sub-basin 6"
5780,400,28,3500,3900,"Sub-basin 6"
5781,2700,377,23500,26200,"Sub-basin 6"
5782,800,70,5400,6200,"Sub-basin 6"
5783,1600,216,10600,12200,"Sub-basin 6"
5784,700,93,3500,4200,"Sub-basin 6"
5785,200,5,2200,2400,"Sub-basin 6"
5786,100,2,2400,2500,"Sub-basin 6"
5787,2100,210,14700,16800,"Sub-basin 6"
5788,3400,1176,20200,23600,"Sub-basin 6"
5789,300,12,4700,5000,"Sub-basin 6"
5790,200,4,3500,3700,"Sub-basin 6"
5791,900,79,2800,3700,"Sub-basin 6"
5792,1100,83,7000,8100,"Sub-basin 6"
5793,4700,593,17800,22500,"Sub-basin 6"
5794,3200,517,19000,22200,"Sub-basin 6"
5795,2300,463.1013,30000,32300,"Sub-basin 6"
5796,400,14.0128,12700,13100,"Sub-basin 6"
5797,600,24,2700,3300,"Sub-basin 6"
5798,2300,173,18300,20600,"Sub-basin 6"
5799,200,3,3500,3700,"Sub-basin 6"
5800,100,1,1500,1600,"Sub-basin 6"
5801,1600,439,3000,4600,"Sub-basin 6"
5802,100,8,1500,1600,"Sub-basin 6"
5803,2500,534,11700,14200,"Sub-basin 6"
5804,100,1,700,800,"Sub-basin 6"
5805,300,7,3500,3800,"Sub-basin 6"
5806,200,2,3400,3600,"Sub-basin 6"
5807,800,17,11500,12300,"Sub-basin 6"
5808,1200,109,9700,10900,"Sub-basin 6"
5809,300,53.0078,8300,8600,"Sub-basin 6"
5810,200,16,3700,3900,"Sub-basin 6"
5811,1500,859,14000,15500,"Sub-basin 6"
5812,8700,2276,23700,32400,"Sub-basin 6"
5813,200,5,0,200,"Sub-basin 6"
5814,200,5,2000,2200,"Sub-basin 6"
5815,1200,120,7200,8400,"Sub-basin 6"
5816,100,1,3600,3700,"Sub-basin 6"
5817,100,1.0022,2900,3000,"Sub-basin 6"
5818,200,9,4100,4300,"Sub-basin 6"
5819,100,1,2000,2100,"Sub-basin 6"
5820,600,23,9200,9800,"Sub-basin 6"
5821,100,1,1000,1100,"Sub-basin 6"
5822,300,13,5400,5700,"Sub-basin 6"
5823,200,3,4700,4900,"Sub-basin 6"
5824,4300,381,13700,18000,"Sub-basin 6"
5825,300,19,2400,2700,"Sub-basin 6"
5826,500,10,7900,8400,"Sub-basin 6"
5827,100,2,1800,1900,"Sub-basin 6"
5828,100,3,1900,2000,"Sub-basin 6"
5829,700,42,3900,4600,"Sub-basin 6"
5830,400,38,2400,2800,"Sub-basin 6"
5831,5300,961,16000,21300,"Sub-basin 6"
5832,900,61.0379,20700,21600,"Sub-basin 6"
5833,300,10,2100,2400,"Sub-basin 6"
5834,5900,979,33600,39500,"Sub-basin 6"
5835,1400,49,18700,20100,"Sub-basin 6"
5836,100,5,1500,1600,"Sub-basin 6"
5837,100,1,2400,2500,"Sub-basin 6"
5838,600,19,4000,4600,"Sub-basin 6"
5839,100,2,1900,2000,"Sub-basin 6"
5840,1000,324,3800,4800,"Sub-basin 6"
5841,1100,256,6800,7900,"Sub-basin 6"
5842,600,13,5200,5800,"Sub-basin 6"
5843,1300,188,8000,9300,"Sub-basin 6"
5844,2200,351,7900,10100,"Sub-basin 6"
5845,400,59,1900,2300,"Sub-basin 6"
5846,1200,139,7400,8600,"Sub-basin 6"
5847,1000,58,5500,6500,"Sub-basin 6"
5848,400,36,3900,4300,"Sub-basin 6"
5849,3900,639,17300,21200,"Sub-basin 6"
5850,100,2,2600,2700,"Sub-basin 6"
5851,1100,102,3800,4900,"Sub-basin 6"
5852,300,8,2900,3200,"Sub-basin 6"
5853,400,20,1500,1900,"Sub-basin 6"
5854,100,4,2000,2100,"Sub-basin 6"
5855,100,1,1700,1800,"Sub-basin 6"
5856,400,65,4000,4400,"Sub-basin 6"
5857,300,32,2100,2400,"Sub-basin 6"
5858,1400,228,4500,5900,"Sub-basin 6"
5859,2900,591,14300,17200,"Sub-basin 6"
5860,2800,546,5500,8300,"Sub-basin 6"
5861,100,1,1600,1700,"Sub-basin 6"
5862,100,3,300,400,"Sub-basin 6"
5863,300,12,2100,2400,"Sub-basin 6"
5864,1000,34,8600,9600,"Sub-basin 6"
5865,100,1,600,700,"Sub-basin 6"
5866,1000,63,2000,3000,"Sub-basin 6"
5867,3400,313,8400,11800,"Sub-basin 6"
5868,600,32,4200,4800,"Sub-basin 6"
5869,200,5,2200,2400,"Sub-basin 6"
5870,100,1.0018,2500,2600,"Sub-basin 6"
5871,1600,377,8300,9900,"Sub-basin 6"
5872,200,3,1900,2100,"Sub-basin 6"
5873,200,7,2100,2300,"Sub-basin 6"
5874,800,100,4200,5000,"Sub-basin 6"
5875,5200,828,13300,18500,"Sub-basin 6"
5876,100,1,1200,1300,"Sub-basin 6"
5877,2700,297,19100,21800,"Sub-basin 6"
5878,200,11,1100,1300,"Sub-basin 6"
5879,600,43,15400,16000,"Sub-basin 6"
5880,1000,52,10300,11300,"Sub-basin 6"
5881,7000,1589,16200,23200,"Sub-basin 6"
5882,1100,125,4000,5100,"Sub-basin 6"
5883,900,129,2200,3100,"Sub-basin 6"
5884,2200,173,18700,20900,"Sub-basin 6"
5885,900,49,12200,13100,"Sub-basin 6"
5886,500,81,2300,2800,"Sub-basin 6"
5887,100,4,700,800,"Sub-basin 6"
5888,900,86,4800,5700,"Sub-basin 6"
5889,400,12,3400,3800,"Sub-basin 6"
5890,1900,81,24200,26100,"Sub-basin 6"
5891,200,7,2500,2700,"Sub-basin 6"
5892,500,11,2600,3100,"Sub-basin 6"
5893,1100,159,4800,5900,"Sub-basin 6"
5894,1600,101,14200,15800,"Sub-basin 6"
5895,1500,223,3500,5000,"Sub-basin 6"
5896,100,6.0018,2400,2500,"Sub-basin 6"
5897,100,4,700,800,"Sub-basin 6"
5898,500,17,2800,3300,"Sub-basin 6"
5899,200,5,3800,4000,"Sub-basin 6"
5900,100,1,600,700,"Sub-basin 6"
5901,700,76,5400,6100,"Sub-basin 6"
5902,500,22,7200,7700,"Sub-basin 6"
5903,1300,152,5600,6900,"Sub-basin 6"
5904,300,11,1000,1300,"Sub-basin 6"
5905,200,28,2200,2400,"Sub-basin 6"
5906,200,12,1500,1700,"Sub-basin 6"
5907,2000,192,6000,8000,"Sub-basin 6"
5908,1700,76,8900,10600,"Sub-basin 6"
5909,100,1,800,900,"Sub-basin 6"
5910,200,7.0055,4400,4600,"Sub-basin 6"
5911,700,146,1500,2200,"Sub-basin 6"
5912,3100,190,26800,29900,"Sub-basin 6"
5913,1500,211,2900,4400,"Sub-basin 6"
5914,1300,188,2000,3300,"Sub-basin 6"
5915,100,1,700,800,"Sub-basin 6"
5916,1200,196,9500,10700,"Sub-basin 6"
5917,1000,61,8600,9600,"Sub-basin 6"
5918,2000,548,5900,7900,"Sub-basin 6"
5919,4500,1240,9600,14100,"Sub-basin 6"
5920,200,6,2300,2500,"Sub-basin 6"
5921,200,2.0045,3400,3600,"Sub-basin 6"
5922,100,1,1100,1200,"Sub-basin 6"
5923,3200,188,39600,42800,"Sub-basin 6"
5924,500,27,4900,5400,"Sub-basin 6"
5925,6200,2451,11900,18100,"Sub-basin 6"
5926,300,13,1500,1800,"Sub-basin 6"
5927,100,1,300,400,"Sub-basin 6"
5928,400,11,6200,6600,"Sub-basin 6"
5929,500,17,3800,4300,"Sub-basin 6"
5930,1100,107,7700,8800,"Sub-basin 6"
5931,800,43,2200,3000,"Sub-basin 6"
5932,3400,338,21100,24500,"Sub-basin 6"
5933,2000,164,11200,13200,"Sub-basin 6"
5934,600,20,16100,16700,"Sub-basin 6"
5935,100,1,500,600,"Sub-basin 6"
5936,200,14,1400,1600,"Sub-basin 6"
5937,800,35,2900,3700,"Sub-basin 6"
5938,100,2,800,900,"Sub-basin 6"
5939,100,4,700,800,"Sub-basin 6"
5940,400,14,2000,2400,"Sub-basin 6"
5941,200,19,1700,1900,"Sub-basin 6"
5942,100,5,700,800,"Sub-basin 6"
5943,200,13.0035,7000,7200,"Sub-basin 6"
5944,500,128,1400,1900,"Sub-basin 6"
5945,1300,690,4400,5700,"Sub-basin 6"
5946,1700,167,6600,8300,"Sub-basin 6"
5947,3200,557,3200,6400,"Sub-basin 6"
5948,600,43,1600,2200,"Sub-basin 6"
5949,1000,98,6700,7700,"Sub-basin 6"
5950,100,3,800,900,"Sub-basin 6"
5951,300,20,500,800,"Sub-basin 6"
5952,1700,235,3800,5500,"Sub-basin 6"
5953,200,3,2400,2600,"Sub-basin 6"
5954,200,3,1800,2000,"Sub-basin 6"
5955,2000,313,8600,10600,"Sub-basin 6"
5956,200,8,2000,2200,"Sub-basin 6"
5957,500,23,1100,1600,"Sub-basin 6"
5958,100,5,600,700,"Sub-basin 6"
5959,100,6,3000,3100,"Sub-basin 6"
5960,900,52,5100,6000,"Sub-basin 6"
5961,4300,1001,8800,13100,"Sub-basin 6"
5962,59100,25656,82200,141300,"Sub-basin 6"
5963,400,129,1300,1700,"Sub-basin 6"
5964,200,2,5500,5700,"Sub-basin 6"
5965,200,8.0073,5900,6100,"Sub-basin 6"
5966,100,3,1800,1900,"Sub-basin 6"
5967,5000,890,39000,44000,"Sub-basin 6"
5968,400,18,3600,4000,"Sub-basin 6"
5969,300,20,3800,4100,"Sub-basin 6"
5970,2200,577,14100,16300,"Sub-basin 6"
5971,400,9,4000,4400,"Sub-basin 6"
5972,100,3,1700,1800,"Sub-basin 6"
5973,100,1,2000,2100,"Sub-basin 6"
5974,100,3,2100,2200,"Sub-basin 6"
5975,3300,631,23300,26600,"Sub-basin 6"
5976,1100,370,2200,3300,"Sub-basin 6"
5977,400,12,1100,1500,"Sub-basin 6"
5978,500,24,5200,5700,"Sub-basin 6"
5979,900,78,2600,3500,"Sub-basin 6"
5980,300,11,4400,4700,"Sub-basin 6"
5981,100,1,1100,1200,"Sub-basin 6"
5982,300,11,1600,1900,"Sub-basin 6"
5983,200,3,2000,2200,"Sub-basin 6"
5984,800,32,4800,5600,"Sub-basin 6"
5985,1500,87,9700,11200,"Sub-basin 6"
5986,100,4,1400,1500,"Sub-basin 6"
5987,200,4,2400,2600,"Sub-basin 6"
5988,100,1,2800,2900,"Sub-basin 6"
5989,100,1,800,900,"Sub-basin 6"
5990,300,10,1900,2200,"Sub-basin 6"
5991,400,18,1600,2000,"Sub-basin 6"
5992,300,7,2900,3200,"Sub-basin 6"
5993,200,21,2900,3100,"Sub-basin 6"
5994,3000,830,4800,7800,"Sub-basin 6"
5995,300,46,900,1200,"Sub-basin 6"
5996,900,62,2300,3200,"Sub-basin 6"
5997,200,5.004,3300,3500,"Sub-basin 6"
5998,100,2,1600,1700,"Sub-basin 6"
5999,200,7,3100,3300,"Sub-basin 6"
6000,1600,528,8300,9900,"Sub-basin 6"
6001,1000,36,8700,9700,"Sub-basin 6"
6002,1000,95,8600,9600,"Sub-basin 6"
6003,500,84,1900,2400,"Sub-basin 6"
6004,300,6,3500,3800,"Sub-basin 6"
6005,600,55,4600,5200,"Sub-basin 6"
6006,100,2,800,900,"Sub-basin 6"
6007,5200,1391,22000,27200,"Sub-basin 6"
6008,200,5,2900,3100,"Sub-basin 6"
6009,100,1,1600,1700,"Sub-basin 6"
6010,400,18,6500,6900,"Sub-basin 6"
6011,800,50,1400,2200,"Sub-basin 6"
6012,600,23,4200,4800,"Sub-basin 6"
6013,300,10,3100,3400,"Sub-basin 6"
6014,1500,73,11200,12700,"Sub-basin 6"
6015,200,8,2100,2300,"Sub-basin 6"
6016,200,2,2100,2300,"Sub-basin 6"
6017,200,4,2200,2400,"Sub-basin 6"
6018,1700,385,3800,5500,"Sub-basin 6"
6019,1500,115,6900,8400,"Sub-basin 6"
6020,100,1.0151,2400,2500,"Sub-basin 6"
6021,100,6,1500,1600,"Sub-basin 6"
6022,100,4,1000,1100,"Sub-basin 6"
6023,100,1,1100,1200,"Sub-basin 6"
6024,800,29,12700,13500,"Sub-basin 6"
6025,2200,188,10000,12200,"Sub-basin 6"
6026,600,67,3900,4500,"Sub-basin 6"
6027,600,93,1900,2500,"Sub-basin 6"
6028,900,79,5300,6200,"Sub-basin 6"
6029,100,2,1400,1500,"Sub-basin 6"
6030,200,5,1200,1400,"Sub-basin 6"
6031,300,6,2600,2900,"Sub-basin 6"
6032,100,1,800,900,"Sub-basin 6"
6033,200,3,500,700,"Sub-basin 6"
6034,300,8,3300,3600,"Sub-basin 6"
6035,100,2,1300,1400,"Sub-basin 6"
6036,100,2,600,700,"Sub-basin 6"
6037,100,1,2500,2600,"Sub-basin 6"
6038,700,36,4900,5600,"Sub-basin 6"
6039,1700,176,9900,11600,"Sub-basin 6"
6040,100,4,3100,3200,"Sub-basin 6"
6041,5500,1232.2292,59800,65300,"Sub-basin 6"
6042,100,2,1500,1600,"Sub-basin 6"
6043,2300,296,16000,18300,"Sub-basin 6"
6044,500,9,6000,6500,"Sub-basin 6"
6045,100,1,1300,1400,"Sub-basin 6"
6046,200,11,2300,2500,"Sub-basin 6"
6047,900,70,6000,6900,"Sub-basin 6"
6048,200,5,1700,1900,"Sub-basin 6"
6049,4100,422,23000,27100,"Sub-basin 6"
6050,900,78,12400,13300,"Sub-basin 6"
6051,200,8,2900,3100,"Sub-basin 6"
6052,200,6,1600,1800,"Sub-basin 6"
6053,100,1,1500,1600,"Sub-basin 6"
6054,100,1,1800,1900,"Sub-basin 6"
6055,700,31,5100,5800,"Sub-basin 6"
6056,400,27,800,1200,"Sub-basin 6"
6057,7900,1645,38900,46800,"Sub-basin 6"
6058,700,20,8400,9100,"Sub-basin 6"
6059,100,1,1500,1600,"Sub-basin 6"
6060,300,8,3600,3900,"Sub-basin 6"
6061,400,16,3300,3700,"Sub-basin 6"
6062,100,1,800,900,"Sub-basin 6"
6063,200,7,2700,2900,"Sub-basin 6"
6064,100,4,1600,1700,"Sub-basin 6"
6065,2400,170,21400,23800,"Sub-basin 6"
6066,100,3,2000,2100,"Sub-basin 6"
6067,200,4,600,800,"Sub-basin 6"
6068,1300,655,5600,6900,"Sub-basin 6"
6069,700,196,3600,4300,"Sub-basin 6"
6070,100,1,900,1000,"Sub-basin 6"
6071,600,19,8100,8700,"Sub-basin 6"
6072,400,80.33,2600,3000,"Sub-basin 6"
6073,100,2,2000,2100,"Sub-basin 6"
6074,1200,221,2500,3700,"Sub-basin 6"
6075,300,6,2300,2600,"Sub-basin 6"
6076,1400,164,8200,9600,"Sub-basin 6"
6077,400,14,2600,3000,"Sub-basin 6"
6078,300,10,1900,2200,"Sub-basin 6"
6079,100,1,2900,3000,"Sub-basin 6"
6080,100,1,1900,2000,"Sub-basin 6"
6081,2100,193,3800,5900,"Sub-basin 6"
6082,100,2,2000,2100,"Sub-basin 6"
6083,1500,156,9900,11400,"Sub-basin 6"
6084,31700,6792,74700,106400,"Sub-basin 6"
6085,1400,82,9700,11100,"Sub-basin 6"
6086,200,15,3600,3800,"Sub-basin 6"
6087,100,5,1000,1100,"Sub-basin 6"
6088,8400,1712,49600,58000,"Sub-basin 6"
6089,200,8,2200,2400,"Sub-basin 6"
6090,600,34,8500,9100,"Sub-basin 6"
6091,1100,89,8200,9300,"Sub-basin 6"
6092,100,1,2600,2700,"Sub-basin 6"
6093,400,11,2000,2400,"Sub-basin 6"
6094,1100,69,7600,8700,"Sub-basin 6"
6095,400,18,1500,1900,"Sub-basin 6"
6096,1000,118,3200,4200,"Sub-basin 6"
6097,200,10,1500,1700,"Sub-basin 6"
6098,400,19,4100,4500,"Sub-basin 6"
6099,900,68,10700,11600,"Sub-basin 6"
6100,300,3,1300,1600,"Sub-basin 6"
6101,100,1,1200,1300,"Sub-basin 6"
6102,100,1,2000,2100,"Sub-basin 6"
6103,100,3,2800,2900,"Sub-basin 6"
6104,200,3,2500,2700,"Sub-basin 6"
6105,2000,767,4500,6500,"Sub-basin 6"
6106,1400,65,9700,11100,"Sub-basin 6"
6107,1200,176,10400,11600,"Sub-basin 6"
6108,100,4,2000,2100,"Sub-basin 6"
6109,100,1,1700,1800,"Sub-basin 6"
6110,400,38,2900,3300,"Sub-basin 6"
6111,700,26,6000,6700,"Sub-basin 6"
6112,200,4,2800,3000,"Sub-basin 6"
6113,6300,1548,7000,13300,"Sub-basin 6"
6114,100,2,1700,1800,"Sub-basin 6"
6115,300,8,2100,2400,"Sub-basin 6"
6116,100,3,600,700,"Sub-basin 6"
6117,100,2,1300,1400,"Sub-basin 6"
6118,100,2,2100,2200,"Sub-basin 6"
6119,400,9,3400,3800,"Sub-basin 6"
6120,100,2,1800,1900,"Sub-basin 6"
6121,100,2,1200,1300,"Sub-basin 6"
6122,6300,2624,6300,12600,"Sub-basin 6"
6123,900,71,6500,7400,"Sub-basin 6"
6124,900,52,10600,11500,"Sub-basin 6"
6125,500,37,6100,6600,"Sub-basin 6"
6126,600,90,4300,4900,"Sub-basin 6"
6127,300,5,2100,2400,"Sub-basin 6"
6128,200,9,1600,1800,"Sub-basin 6"
6129,600,35,3500,4100,"Sub-basin 6"
6130,1000,63,5400,6400,"Sub-basin 6"
6131,1800,144,11400,13200,"Sub-basin 6"
6132,200,9,3200,3400,"Sub-basin 6"
6133,300,11,3900,4200,"Sub-basin 6"
6134,100,1,1000,1100,"Sub-basin 6"
6135,100,1,1400,1500,"Sub-basin 6"
6136,200,4,3900,4100,"Sub-basin 6"
6137,900,40,7000,7900,"Sub-basin 6"
6138,3600,220,29700,33300,"Sub-basin 6"
6139,600,41,7800,8400,"Sub-basin 6"
6140,7900,1079,32900,40800,"Sub-basin 6"
6141,200,2,1900,2100,"Sub-basin 6"
6142,100,2,1300,1400,"Sub-basin 6"
6143,900,59,8900,9800,"Sub-basin 6"
6144,200,9,2000,2200,"Sub-basin 6"
6145,200,11,2300,2500,"Sub-basin 6"
6146,100,3,800,900,"Sub-basin 6"
6147,400,44,2100,2500,"Sub-basin 6"
6148,200,6,1800,2000,"Sub-basin 6"
6149,600,102,2400,3000,"Sub-basin 6"
6150,2100,209,7000,9100,"Sub-basin 6"
6151,100,1,1000,1100,"Sub-basin 6"
6152,100,1,1600,1700,"Sub-basin 6"
6153,400,15,5200,5600,"Sub-basin 6"
6154,1100,413.17,5300,6400,"Sub-basin 6"
6155,1000,327,3400,4400,"Sub-basin 6"
6156,600,31,3100,3700,"Sub-basin 6"
6157,400,11,5700,6100,"Sub-basin 6"
6158,900,114,4600,5500,"Sub-basin 6"
6159,1500,162,8800,10300,"Sub-basin 6"
6160,300,8,3400,3700,"Sub-basin 6"
6161,200,9,1900,2100,"Sub-basin 6"
6162,1900,162,17100,19000,"Sub-basin 6"
6163,800,146,2600,3400,"Sub-basin 6"
6164,300,40,700,1000,"Sub-basin 6"
6165,500,49,6100,6600,"Sub-basin 6"
6166,300,10,6900,7200,"Sub-basin 6"
6167,100,1,1400,1500,"Sub-basin 6"
6168,3900,1132,10300,14200,"Sub-basin 6"
6169,200,13,2200,2400,"Sub-basin 6"
6170,400,7,1900,2300,"Sub-basin 6"
6171,100,5,1300,1400,"Sub-basin 6"
6172,100,1,1400,1500,"Sub-basin 6"
6173,100,1,1100,1200,"Sub-basin 6"
6174,300,20,5000,5300,"Sub-basin 6"
6175,100,1,1900,2000,"Sub-basin 6"
6176,500,14,4000,4500,"Sub-basin 6"
6177,200,2,500,700,"Sub-basin 6"
6178,300,13,4200,4500,"Sub-basin 6"
6179,1900,186,17900,19800,"Sub-basin 6"
6180,200,9,4400,4600,"Sub-basin 6"
6181,200,10,2400,2600,"Sub-basin 6"
6182,1000,68,4000,5000,"Sub-basin 6"
6183,700,52,6000,6700,"Sub-basin 6"
6184,1800,163,17200,19000,"Sub-basin 6"
6185,200,2,2300,2500,"Sub-basin 6"
6186,100,1,1600,1700,"Sub-basin 6"
6187,1800,253,12300,14100,"Sub-basin 6"
6188,3600,435,33800,37400,"Sub-basin 6"
6189,1400,103,7100,8500,"Sub-basin 6"
6190,100,2,1400,1500,"Sub-basin 6"
6191,200,3,3900,4100,"Sub-basin 6"
6192,300,16,2700,3000,"Sub-basin 6"
6193,100,2,1200,1300,"Sub-basin 6"
6194,4900,1020,9500,14400,"Sub-basin 6"
6195,200,9,2000,2200,"Sub-basin 6"
6196,800,43,5300,6100,"Sub-basin 6"
6197,800,110,3700,4500,"Sub-basin 6"
6198,100,5,1600,1700,"Sub-basin 6"
6199,100,4,1200,1300,"Sub-basin 6"
6200,500,15,3000,3500,"Sub-basin 6"
6201,300,14,1700,2000,"Sub-basin 6"
6202,900,79,4900,5800,"Sub-basin 6"
6203,1000,41,7100,8100,"Sub-basin 6"
6204,400,13,4400,4800,"Sub-basin 6"
6205,100,3,900,1000,"Sub-basin 6"
6206,200,2,3400,3600,"Sub-basin 6"
6207,5600,827,30000,35600,"Sub-basin 6"
6208,100,1,1900,2000,"Sub-basin 6"
6209,300,7,2400,2700,"Sub-basin 6"
6210,700,21,4800,5500,"Sub-basin 6"
6211,500,15,4200,4700,"Sub-basin 6"
6212,100,1,1600,1700,"Sub-basin 6"
6213,1100,22,8200,9300,"Sub-basin 6"
6214,500,24,3900,4400,"Sub-basin 6"
6215,300,3.0037,5600,5900,"Sub-basin 6"
6216,100,10,700,800,"Sub-basin 6"
6217,100,2,1500,1600,"Sub-basin 6"
6218,500,8,4300,4800,"Sub-basin 6"
6219,100,2,900,1000,"Sub-basin 6"
6220,100,1,1000,1100,"Sub-basin 6"
6221,900,136,3800,4700,"Sub-basin 6"
6222,100,1,800,900,"Sub-basin 6"
6223,1000,29,6500,7500,"Sub-basin 6"
6224,1100,95,6500,7600,"Sub-basin 6"
6225,200,5,1900,2100,"Sub-basin 6"
6226,3600,529,14700,18300,"Sub-basin 6"
6227,100,2,1400,1500,"Sub-basin 6"
6228,500,39,2100,2600,"Sub-basin 6"
6229,700,65,2300,3000,"Sub-basin 6"
6230,2600,684,7200,9800,"Sub-basin 6"
6231,1000,59,4100,5100,"Sub-basin 6"
6232,100,2,1100,1200,"Sub-basin 6"
6233,100,6,1500,1600,"Sub-basin 6"
6234,200,10,4000,4200,"Sub-basin 6"
6235,200,7,1300,1500,"Sub-basin 6"
6236,100,1,1500,1600,"Sub-basin 6"
6237,100,4,1200,1300,"Sub-basin 6"
6238,200,7,1400,1600,"Sub-basin 6"
6239,200,13,1700,1900,"Sub-basin 6"
6240,800,176,5600,6400,"Sub-basin 6"
6241,1700,313.0852,16900,18600,"Sub-basin 6"
6242,100,4,1300,1400,"Sub-basin 6"
6243,200,5,1300,1500,"Sub-basin 6"
6244,200,8,1200,1400,"Sub-basin 6"
6245,200,6,2000,2200,"Sub-basin 6"
6246,400,28,2700,3100,"Sub-basin 6"
6247,100,1,2300,2400,"Sub-basin 6"
6248,200,8,1700,1900,"Sub-basin 6"
6249,2300,397,7200,9500,"Sub-basin 6"
6250,100,1,1800,1900,"Sub-basin 6"
6251,300,4,2000,2300,"Sub-basin 6"
6252,700,98,3100,3800,"Sub-basin 6"
6253,400,26,7400,7800,"Sub-basin 6"
6254,100,6,2400,2500,"Sub-basin 6"
6255,100,3,700,800,"Sub-basin 6"
6256,500,22,1700,2200,"Sub-basin 6"
6257,200,8,700,900,"Sub-basin 6"
6258,900,43,2900,3800,"Sub-basin 6"
6259,200,3,1500,1700,"Sub-basin 6"
6260,300,10,1700,2000,"Sub-basin 6"
6261,200,8,2200,2400,"Sub-basin 6"
6262,6200,1655,34800,41000,"Sub-basin 6"
6263,100,2,1700,1800,"Sub-basin 6"
6264,400,33,7000,7400,"Sub-basin 6"
6265,100,1,800,900,"Sub-basin 6"
6266,400,20,1300,1700,"Sub-basin 6"
6267,1200,39,5600,6800,"Sub-basin 6"
6268,200,7,3600,3800,"Sub-basin 6"
6269,500,30,1500,2000,"Sub-basin 6"
6270,500,17,7900,8400,"Sub-basin 6"
6271,100,1,1400,1500,"Sub-basin 6"
6272,2800,348,10200,13000,"Sub-basin 6"
6273,300,20,2500,2800,"Sub-basin 6"
6274,1200,143,8500,9700,"Sub-basin 6"
6275,200,5,1400,1600,"Sub-basin 6"
6276,200,9,1100,1300,"Sub-basin 6"
6277,2300,227,12200,14500,"Sub-basin 6"
6278,1300,76,6700,8000,"Sub-basin 6"
6279,300,4,2100,2400,"Sub-basin 6"
6280,200,8,1900,2100,"Sub-basin 6"
6281,400,37,2300,2700,"Sub-basin 6"
6282,200,5,2200,2400,"Sub-basin 6"
6283,600,46,5500,6100,"Sub-basin 6"
6284,100,1,500,600,"Sub-basin 6"
6285,400,17,300,700,"Sub-basin 6"
6286,22300,6336,30100,52400,"Sub-basin 6"
6287,1000,197,2800,3800,"Sub-basin 6"
6288,700,48,2500,3200,"Sub-basin 6"
6289,3200,218,8300,11500,"Sub-basin 6"
6290,300,6,4200,4500,"Sub-basin 6"
6291,300,12,3100,3400,"Sub-basin 6"
6292,600,50,7600,8200,"Sub-basin 6"
6293,3500,631,12100,15600,"Sub-basin 6"
6294,200,3,700,900,"Sub-basin 6"
6295,500,42,2000,2500,"Sub-basin 6"
6296,1100,53,7200,8300,"Sub-basin 6"
6297,600,55,4900,5500,"Sub-basin 6"
6298,100,1,400,500,"Sub-basin 6"
6299,100,4,1700,1800,"Sub-basin 6"
6300,400,18,1200,1600,"Sub-basin 6"
6301,300,8,1800,2100,"Sub-basin 6"
6302,100,1,1100,1200,"Sub-basin 6"
6303,300,5,1100,1400,"Sub-basin 6"
6304,700,33,2800,3500,"Sub-basin 6"
6305,200,7,4000,4200,"Sub-basin 6"
6306,300,11,2800,3100,"Sub-basin 6"
6307,300,6,4600,4900,"Sub-basin 6"
6308,100,1,500,600,"Sub-basin 6"
6309,400,16,1000,1400,"Sub-basin 6"
6310,400,25,1100,1500,"Sub-basin 6"
6311,300,8,2300,2600,"Sub-basin 6"
6312,100,1,2000,2100,"Sub-basin 6"
6313,800,142,5600,6400,"Sub-basin 6"
6314,12400,1841,57600,70000,"Sub-basin 6"
6315,100,3,800,900,"Sub-basin 6"
6316,100,7,500,600,"Sub-basin 6"
6317,900,103,10400,11300,"Sub-basin 6"
6318,1800,414,15100,16900,"Sub-basin 6"
6319,600,20,7200,7800,"Sub-basin 6"
6320,100,1,1100,1200,"Sub-basin 6"
6321,1300,161,5500,6800,"Sub-basin 6"
6322,100,1,1000,1100,"Sub-basin 6"
6323,200,2,2200,2400,"Sub-basin 6"
6324,200,8,1200,1400,"Sub-basin 6"
6325,100,1,700,800,"Sub-basin 6"
6326,700,20,2800,3500,"Sub-basin 6"
6327,400,13,900,1300,"Sub-basin 6"
6328,3700,233,33700,37400,"Sub-basin 6"
6329,400,12,3200,3600,"Sub-basin 6"
6330,800,27,4300,5100,"Sub-basin 6"
6331,800,42,6800,7600,"Sub-basin 6"
6332,500,18,3600,4100,"Sub-basin 6"
6333,1600,76,7700,9300,"Sub-basin 6"
6334,100,2.0011,2000,2100,"Sub-basin 6"
6335,3700,265,13100,16800,"Sub-basin 6"
6336,500,39,3200,3700,"Sub-basin 6"
6337,100,1.001,1600,1700,"Sub-basin 6"
6338,100,1,1200,1300,"Sub-basin 6"
6339,6200,571,31300,37500,"Sub-basin 6"
6340,100,3,2900,3000,"Sub-basin 6"
6341,200,7,2900,3100,"Sub-basin 6"
6342,400,38,4500,4900,"Sub-basin 6"
6343,200,3.0099,4000,4200,"Sub-basin 6"
6344,100,1,1500,1600,"Sub-basin 6"
6345,400,9,3900,4300,"Sub-basin 6"
6346,200,4,2600,2800,"Sub-basin 6"
6347,600,20,9600,10200,"Sub-basin 6"
6348,100,1,1400,1500,"Sub-basin 6"
6349,400,13,3700,4100,"Sub-basin 6"
6350,900,53,7900,8800,"Sub-basin 6"
6351,1900,123,4900,6800,"Sub-basin 6"
6352,200,12.0039,2800,3000,"Sub-basin 6"
6353,700,39,4500,5200,"Sub-basin 6"
6354,300,7,2200,2500,"Sub-basin 6"
6355,200,4,3000,3200,"Sub-basin 6"
6356,200,6,3200,3400,"Sub-basin 6"
6357,200,6,2600,2800,"Sub-basin 6"
6358,100,1,1900,2000,"Sub-basin 6"
6359,600,57,3100,3700,"Sub-basin 6"
6360,6800,1802,49100,55900,"Sub-basin 6"
6361,100,1,1500,1600,"Sub-basin 6"
6362,200,3,1500,1700,"Sub-basin 6"
6363,100,2,2500,2600,"Sub-basin 6"
6364,100,2,900,1000,"Sub-basin 6"
6365,100,1,900,1000,"Sub-basin 6"
6366,200,11,2100,2300,"Sub-basin 6"
6367,500,19,4400,4900,"Sub-basin 6"
6368,100,6.0013,2500,2600,"Sub-basin 6"
6369,100,1,2000,2100,"Sub-basin 6"
6370,500,33,5700,6200,"Sub-basin 6"
6371,100,3,1900,2000,"Sub-basin 6"
6372,400,15,2100,2500,"Sub-basin 6"
6373,2400,452.1127,27700,30100,"Sub-basin 6"
6374,1000,74,9900,10900,"Sub-basin 6"
6375,1000,140,3700,4700,"Sub-basin 6"
6376,100,2,1600,1700,"Sub-basin 6"
6377,200,2,4500,4700,"Sub-basin 6"
6378,100,1,1900,2000,"Sub-basin 6"
6379,100,3,1200,1300,"Sub-basin 6"
6380,400,6.33,3500,3900,"Sub-basin 6"
6381,700,62,3400,4100,"Sub-basin 6"
6382,500,12,5700,6200,"Sub-basin 6"
6383,300,5,2000,2300,"Sub-basin 6"
6384,100,1,1400,1500,"Sub-basin 6"
6385,100,1,2600,2700,"Sub-basin 6"
6386,700,33,6300,7000,"Sub-basin 6"
6387,600,37,4000,4600,"Sub-basin 6"
6388,500,37,3100,3600,"Sub-basin 6"
6389,100,1,600,700,"Sub-basin 6"
6390,400,31,1800,2200,"Sub-basin 6"
6391,400,10,2900,3300,"Sub-basin 6"
6392,200,3,1400,1600,"Sub-basin 6"
6393,100,2,1900,2000,"Sub-basin 6"
6394,800,64,4600,5400,"Sub-basin 6"
6395,200,5,1500,1700,"Sub-basin 6"
6396,600,63,5900,6500,"Sub-basin 6"
6397,600,26,9100,9700,"Sub-basin 6"
6398,1000,53,10500,11500,"Sub-basin 6"
6399,600,38,7100,7700,"Sub-basin 6"
6400,100,2,2000,2100,"Sub-basin 6"
6401,800,40,6400,7200,"Sub-basin 6"
6402,2600,129.2341,41600,44200,"Sub-basin 6"
6403,100,5,1200,1300,"Sub-basin 6"
6404,4400,604,39700,44100,"Sub-basin 6"
6405,3500,641,12300,15800,"Sub-basin 6"
6406,100,1,1400,1500,"Sub-basin 6"
6407,100,2,800,900,"Sub-basin 6"
6408,1000,53,10200,11200,"Sub-basin 6"
6409,1000,41,6600,7600,"Sub-basin 6"
6410,1100,35,9000,10100,"Sub-basin 6"
6411,7000,2540,26100,33100,"Sub-basin 6"
6412,300,5,8800,9100,"Sub-basin 6"
6413,300,10,2100,2400,"Sub-basin 6"
6414,2500,130,14600,17100,"Sub-basin 6"
6415,700,19,7000,7700,"Sub-basin 6"
6416,1200,61,7400,8600,"Sub-basin 6"
6417,100,2,1200,1300,"Sub-basin 6"
6418,200,3,2400,2600,"Sub-basin 6"
6419,100,2,4800,4900,"Sub-basin 6"
6420,400,9,5600,6000,"Sub-basin 6"
6421,200,8,3100,3300,"Sub-basin 6"
6422,100,2,500,600,"Sub-basin 6"
6423,800,23,5600,6400,"Sub-basin 6"
6424,2500,375,15000,17500,"Sub-basin 6"
6425,700,28,3800,4500,"Sub-basin 6"
6426,1000,75,3800,4800,"Sub-basin 6"
6427,100,2,1400,1500,"Sub-basin 6"
6428,300,4,400,700,"Sub-basin 6"
6429,2100,89,15100,17200,"Sub-basin 6"
6430,800,64,8300,9100,"Sub-basin 6"
6431,100,1.0045,4200,4300,"Sub-basin 6"
6432,200,8,4900,5100,"Sub-basin 6"
6433,2000,132,12200,14200,"Sub-basin 6"
6434,100,2.0024,4900,5000,"Sub-basin 6"
6435,100,1,700,800,"Sub-basin 6"
6436,300,8,2700,3000,"Sub-basin 6"
6437,1500,81,15200,16700,"Sub-basin 6"
6438,400,14,3900,4300,"Sub-basin 6"
6439,100,2,1700,1800,"Sub-basin 6"
6440,1200,112.0606,15300,16500,"Sub-basin 6"
6441,600,16,4500,5100,"Sub-basin 6"
6442,300,18,5300,5600,"Sub-basin 6"
6443,100,1,1600,1700,"Sub-basin 6"
6444,700,40,4800,5500,"Sub-basin 6"
6445,600,18,6500,7100,"Sub-basin 6"
6446,500,28,2000,2500,"Sub-basin 6"
6447,100,1,1100,1200,"Sub-basin 6"
6448,1300,104,4700,6000,"Sub-basin 6"
6449,600,20,9500,10100,"Sub-basin 6"
6450,7400,1041,23800,31200,"Sub-basin 6"
6451,600,24,4100,4700,"Sub-basin 6"
6452,100,1,3700,3800,"Sub-basin 6"
6453,300,17,4000,4300,"Sub-basin 6"
6454,700,64,6200,6900,"Sub-basin 6"
6455,300,8,2900,3200,"Sub-basin 6"
6456,700,322,8300,9000,"Sub-basin 6"
6457,400,17,3800,4200,"Sub-basin 6"
6458,100,1,1600,1700,"Sub-basin 6"
6459,1800,163,7400,9200,"Sub-basin 6"
6460,400,9,6600,7000,"Sub-basin 6"
6461,100,2,1600,1700,"Sub-basin 6"
6462,100,1,800,900,"Sub-basin 6"
6463,900,46,5100,6000,"Sub-basin 6"
6464,300,11,1100,1400,"Sub-basin 6"
6465,500,15,7000,7500,"Sub-basin 6"
6466,100,3.0022,2100,2200,"Sub-basin 6"
6467,100,2,1800,1900,"Sub-basin 6"
6468,1300,43,7600,8900,"Sub-basin 6"
6469,400,23,3600,4000,"Sub-basin 6"
6470,200,2,3600,3800,"Sub-basin 6"
6471,600,50,7800,8400,"Sub-basin 6"
6472,100,4,2300,2400,"Sub-basin 6"
6473,500,24,2300,2800,"Sub-basin 6"
6474,400,20,3100,3500,"Sub-basin 6"
6475,800,22,4600,5400,"Sub-basin 6"
6476,100,1.0022,1200,1300,"Sub-basin 6"
6477,500,18,5300,5800,"Sub-basin 6"
6478,200,5,4000,4200,"Sub-basin 6"
6479,700,43,3000,3700,"Sub-basin 6"
6480,300,9.0136,5400,5700,"Sub-basin 6"
6481,1100,110,3200,4300,"Sub-basin 6"
6482,200,2,1400,1600,"Sub-basin 6"
6483,600,40,2200,2800,"Sub-basin 6"
6484,100,2,1900,2000,"Sub-basin 6"
6485,500,18,5600,6100,"Sub-basin 6"
6486,300,12,1500,1800,"Sub-basin 6"
6487,1600,487,1500,3100,"Sub-basin 6"
6488,400,6,4700,5100,"Sub-basin 6"
6489,2200,162,4700,6900,"Sub-basin 6"
6490,700,78,3600,4300,"Sub-basin 6"
6491,200,3,3600,3800,"Sub-basin 6"
6492,1900,151,7800,9700,"Sub-basin 6"
6493,100,2,1700,1800,"Sub-basin 6"
6494,400,9,800,1200,"Sub-basin 6"
6495,1200,49,7400,8600,"Sub-basin 6"
6496,100,1,3800,3900,"Sub-basin 6"
6497,100,1,2200,2300,"Sub-basin 6"
6498,300,11,1700,2000,"Sub-basin 6"
6499,300,18,3300,3600,"Sub-basin 6"
6500,200,5,5200,5400,"Sub-basin 6"
6501,400,14,1400,1800,"Sub-basin 6"
6502,300,12,5200,5500,"Sub-basin 6"
6503,100,1,3400,3500,"Sub-basin 6"
6504,1900,448.1096,38300,40200,"Sub-basin 6"
6505,400,23,6400,6800,"Sub-basin 6"
6506,200,4,2500,2700,"Sub-basin 6"
6507,100,1,1200,1300,"Sub-basin 6"
6508,100,1,600,700,"Sub-basin 6"
6509,400,22,3700,4100,"Sub-basin 6"
6510,200,5,1700,1900,"Sub-basin 6"
6511,200,6,3300,3500,"Sub-basin 6"
6512,700,49,1700,2400,"Sub-basin 6"
6513,100,1,800,900,"Sub-basin 6"
6514,300,7,2100,2400,"Sub-basin 6"
6515,400,10,2500,2900,"Sub-basin 6"
6516,100,2,1500,1600,"Sub-basin 6"
6517,600,43,3200,3800,"Sub-basin 6"
6518,1100,53,7400,8500,"Sub-basin 6"
6519,400,41,8900,9300,"Sub-basin 6"
6520,2600,395,7000,9600,"Sub-basin 6"
6521,300,11,3000,3300,"Sub-basin 6"
6522,100,9,1000,1100,"Sub-basin 6"
6523,500,20,3200,3700,"Sub-basin 6"
6524,200,2,3500,3700,"Sub-basin 6"
6525,200,30,3400,3600,"Sub-basin 6"
6526,100,1,1700,1800,"Sub-basin 6"
6527,600,45,6700,7300,"Sub-basin 6"
6528,1900,191,9700,11600,"Sub-basin 6"
6529,1400,168,9900,11300,"Sub-basin 6"
6530,600,24,5200,5800,"Sub-basin 6"
6531,200,9,3200,3400,"Sub-basin 6"
6532,100,1,1900,2000,"Sub-basin 6"
6533,200,9,2600,2800,"Sub-basin 6"
6534,700,42,5700,6400,"Sub-basin 6"
6535,200,5,3900,4100,"Sub-basin 6"
6536,600,33,2900,3500,"Sub-basin 6"
6537,500,12,4400,4900,"Sub-basin 6"
6538,200,5,2000,2200,"Sub-basin 6"
6539,100,4,800,900,"Sub-basin 6"
6540,200,8,2100,2300,"Sub-basin 6"
6541,1800,259,12000,13800,"Sub-basin 6"
6542,400,38,4200,4600,"Sub-basin 6"
6543,100,2,1400,1500,"Sub-basin 6"
6544,200,11.0058,3100,3300,"Sub-basin 6"
6545,100,14,2500,2600,"Sub-basin 6"
6546,100,2,2500,2600,"Sub-basin 6"
6547,5000,641,46300,51300,"Sub-basin 6"
6548,800,37,14100,14900,"Sub-basin 6"
6549,200,6,2400,2600,"Sub-basin 6"
6550,100,3,1800,1900,"Sub-basin 6"
6551,1700,182.0596,29900,31600,"Sub-basin 6"
6552,500,20,3500,4000,"Sub-basin 6"
6553,100,2,2500,2600,"Sub-basin 6"
6554,1100,52,8800,9900,"Sub-basin 6"
6555,800,22,9500,10300,"Sub-basin 6"
6556,200,5,1900,2100,"Sub-basin 6"
6557,500,18,5100,5600,"Sub-basin 6"
6558,100,3,3000,3100,"Sub-basin 6"
6559,1400,123,7300,8700,"Sub-basin 6"
6560,900,29,7800,8700,"Sub-basin 6"
6561,1300,58,11800,13100,"Sub-basin 6"
6562,300,4,1800,2100,"Sub-basin 6"
6563,200,5,2200,2400,"Sub-basin 6"
6564,100,2,2800,2900,"Sub-basin 6"
6565,1100,66,4900,6000,"Sub-basin 6"
6566,3600,700,9700,13300,"Sub-basin 6"
6567,8800,1105.3635,48200,57000,"Sub-basin 6"
6568,600,44,8300,8900,"Sub-basin 6"
6569,2000,133,10500,12500,"Sub-basin 6"
6570,800,54,4500,5300,"Sub-basin 6"
6571,100,1,900,1000,"Sub-basin 6"
6572,100,1,1000,1100,"Sub-basin 6"
6573,200,5,4400,4600,"Sub-basin 6"
6574,200,3,2900,3100,"Sub-basin 6"
6575,1100,119,9500,10600,"Sub-basin 6"
6576,100,6,1300,1400,"Sub-basin 6"
6577,300,6,2200,2500,"Sub-basin 6"
6578,100,1,1300,1400,"Sub-basin 6"
6579,700,114,7200,7900,"Sub-basin 6"
6580,700,46,2800,3500,"Sub-basin 6"
6581,1100,50,6700,7800,"Sub-basin 6"
6582,2900,458,5700,8600,"Sub-basin 6"
6583,100,3,2200,2300,"Sub-basin 6"
6584,1100,45,10100,11200,"Sub-basin 6"
6585,100,1,1300,1400,"Sub-basin 6"
6586,500,17,5000,5500,"Sub-basin 6"
6587,200,6,1400,1600,"Sub-basin 6"
6588,100,1,200,300,"Sub-basin 6"
6589,700,37,4700,5400,"Sub-basin 6"
6590,200,34,1300,1500,"Sub-basin 6"
6591,600,17,5800,6400,"Sub-basin 6"
6592,200,2.0058,2600,2800,"Sub-basin 6"
6593,300,7,1500,1800,"Sub-basin 6"
6594,2000,117,9800,11800,"Sub-basin 6"
6595,100,7,100,200,"Sub-basin 6"
6596,400,9.0116,6000,6400,"Sub-basin 6"
6597,300,12,4300,4600,"Sub-basin 6"
6598,400,12,5100,5500,"Sub-basin 6"
6599,100,4,1300,1400,"Sub-basin 6"
6600,100,1,1700,1800,"Sub-basin 6"
6601,500,12,5400,5900,"Sub-basin 6"
6602,3500,531,22800,26300,"Sub-basin 6"
6603,100,1,1200,1300,"Sub-basin 6"
6604,6500,1707,11000,17500,"Sub-basin 6"
6605,400,19,2500,2900,"Sub-basin 6"
6606,400,16,1300,1700,"Sub-basin 6"
6607,700,146,2100,2800,"Sub-basin 6"
6608,400,119,500,900,"Sub-basin 6"
1,100,3,200,300,"Sub-basin 7"
2,800,40,4100,4900,"Sub-basin 7"
3,900,53,2100,3000,"Sub-basin 7"
4,1400,147,7400,8800,"Sub-basin 7"
5,700,60,2800,3500,"Sub-basin 7"
6,100,1,600,700,"Sub-basin 7"
7,2100,213,13400,15500,"Sub-basin 7"
8,400,25,2500,2900,"Sub-basin 7"
9,400,16,2000,2400,"Sub-basin 7"
10,100,1,700,800,"Sub-basin 7"
11,100,3,700,800,"Sub-basin 7"
12,100,1,700,800,"Sub-basin 7"
13,100,2,1500,1600,"Sub-basin 7"
14,500,27,5800,6300,"Sub-basin 7"
15,100,2,1200,1300,"Sub-basin 7"
16,2500,146,17300,19800,"Sub-basin 7"
17,400,23,2200,2600,"Sub-basin 7"
18,100,1,1000,1100,"Sub-basin 7"
19,6600,1553.17,19500,26100,"Sub-basin 7"
20,7600,1526,37200,44800,"Sub-basin 7"
21,100,4,600,700,"Sub-basin 7"
22,200,2,900,1100,"Sub-basin 7"
23,100,2,1300,1400,"Sub-basin 7"
24,200,3,1700,1900,"Sub-basin 7"
25,100,4,1200,1300,"Sub-basin 7"
26,1000,61,7000,8000,"Sub-basin 7"
27,1100,52,8300,9400,"Sub-basin 7"
28,100,1,800,900,"Sub-basin 7"
29,100,1,1000,1100,"Sub-basin 7"
30,200,8,2300,2500,"Sub-basin 7"
31,200,3,2300,2500,"Sub-basin 7"
32,100,1,1900,2000,"Sub-basin 7"
33,300,6,3200,3500,"Sub-basin 7"
34,100,1,600,700,"Sub-basin 7"
35,200,7,2700,2900,"Sub-basin 7"
36,100,1,800,900,"Sub-basin 7"
37,100,3,1500,1600,"Sub-basin 7"
38,100,3,2500,2600,"Sub-basin 7"
39,200,6,2600,2800,"Sub-basin 7"
40,200,4,2700,2900,"Sub-basin 7"
41,200,4,1600,1800,"Sub-basin 7"
42,400,14,2500,2900,"Sub-basin 7"
43,300,6,2300,2600,"Sub-basin 7"
44,100,1,1200,1300,"Sub-basin 7"
45,200,6,1600,1800,"Sub-basin 7"
46,100,3,1100,1200,"Sub-basin 7"
47,300,15,2700,3000,"Sub-basin 7"
48,300,6,3100,3400,"Sub-basin 7"
49,4000,461,40200,44200,"Sub-basin 7"
50,300,9,3900,4200,"Sub-basin 7"
51,100,3,2200,2300,"Sub-basin 7"
52,1000,65,8000,9000,"Sub-basin 7"
53,1500,150,11100,12600,"Sub-basin 7"
54,400,27,3000,3400,"Sub-basin 7"
55,200,7,2200,2400,"Sub-basin 7"
56,200,8,2300,2500,"Sub-basin 7"
57,500,31,2300,2800,"Sub-basin 7"
58,100,6,1200,1300,"Sub-basin 7"
59,400,15,2300,2700,"Sub-basin 7"
60,500,11,5500,6000,"Sub-basin 7"
61,700,76,1300,2000,"Sub-basin 7"
62,100,1,1100,1200,"Sub-basin 7"
63,600,426,3800,4400,"Sub-basin 7"
64,200,3,2500,2700,"Sub-basin 7"
65,900,37,6900,7800,"Sub-basin 7"
66,1400,177,11600,13000,"Sub-basin 7"
67,600,28,2400,3000,"Sub-basin 7"
68,100,1,2300,2400,"Sub-basin 7"
69,1600,508,7300,8900,"Sub-basin 7"
70,300,8,5500,5800,"Sub-basin 7"
71,100,3,1000,1100,"Sub-basin 7"
72,100,1,1200,1300,"Sub-basin 7"
73,1100,46,10300,11400,"Sub-basin 7"
74,200,13,3100,3300,"Sub-basin 7"
75,200,5,2800,3000,"Sub-basin 7"
76,100,2,1500,1600,"Sub-basin 7"
77,600,23,9700,10300,"Sub-basin 7"
78,100,1,1300,1400,"Sub-basin 7"
79,200,5,2700,2900,"Sub-basin 7"
80,1000,38,17800,18800,"Sub-basin 7"
81,100,1,1000,1100,"Sub-basin 7"
82,200,7,3200,3400,"Sub-basin 7"
83,100,3,1500,1600,"Sub-basin 7"
84,600,111,1900,2500,"Sub-basin 7"
85,100,1,2900,3000,"Sub-basin 7"
86,200,4,3100,3300,"Sub-basin 7"
87,200,4,2100,2300,"Sub-basin 7"
88,300,8,2400,2700,"Sub-basin 7"
89,100,1,1000,1100,"Sub-basin 7"
90,100,1,3200,3300,"Sub-basin 7"
91,200,3,1900,2100,"Sub-basin 7"
92,200,2,4300,4500,"Sub-basin 7"
93,200,12,2000,2200,"Sub-basin 7"
94,2900,786,18300,21200,"Sub-basin 7"
95,800,48,7300,8100,"Sub-basin 7"
96,1100,82,8400,9500,"Sub-basin 7"
97,100,2,3800,3900,"Sub-basin 7"
98,600,19,2800,3400,"Sub-basin 7"
99,100,1,1700,1800,"Sub-basin 7"
100,100,2,1600,1700,"Sub-basin 7"
101,600,28,10700,11300,"Sub-basin 7"
102,100,1,1600,1700,"Sub-basin 7"
103,100,1,1900,2000,"Sub-basin 7"
104,100,1,2800,2900,"Sub-basin 7"
105,300,14,2200,2500,"Sub-basin 7"
106,500,16,3800,4300,"Sub-basin 7"
107,300,12,2400,2700,"Sub-basin 7"
108,100,2,2500,2600,"Sub-basin 7"
109,100,3,2700,2800,"Sub-basin 7"
110,400,18,5800,6200,"Sub-basin 7"
111,700,38,5200,5900,"Sub-basin 7"
112,900,69,6400,7300,"Sub-basin 7"
113,11800,1585,127100,138900,"Sub-basin 7"
114,100,2,2400,2500,"Sub-basin 7"
115,1700,162,8200,9900,"Sub-basin 7"
116,200,5,2000,2200,"Sub-basin 7"
117,300,5,4400,4700,"Sub-basin 7"
118,100,1,1500,1600,"Sub-basin 7"
119,200,3,600,800,"Sub-basin 7"
120,400,21,2200,2600,"Sub-basin 7"
121,100,3,800,900,"Sub-basin 7"
122,200,2,2600,2800,"Sub-basin 7"
123,200,3,4300,4500,"Sub-basin 7"
124,400,7,6400,6800,"Sub-basin 7"
125,100,1,2500,2600,"Sub-basin 7"
126,200,2,3000,3200,"Sub-basin 7"
127,100,5,1000,1100,"Sub-basin 7"
128,100,1,1600,1700,"Sub-basin 7"
129,100,3,1000,1100,"Sub-basin 7"
130,1100,37,13600,14700,"Sub-basin 7"
131,300,8,3600,3900,"Sub-basin 7"
132,200,5,1300,1500,"Sub-basin 7"
133,200,5,2800,3000,"Sub-basin 7"
134,100,3,600,700,"Sub-basin 7"
135,2000,140,14800,16800,"Sub-basin 7"
136,100,2,1400,1500,"Sub-basin 7"
137,300,8,2900,3200,"Sub-basin 7"
138,100,1,1900,2000,"Sub-basin 7"
139,500,26,5100,5600,"Sub-basin 7"
140,100,2,600,700,"Sub-basin 7"
141,300,25,4900,5200,"Sub-basin 7"
142,100,1,500,600,"Sub-basin 7"
143,200,2,400,600,"Sub-basin 7"
144,400,8,7600,8000,"Sub-basin 7"
145,100,1,2400,2500,"Sub-basin 7"
146,100,2,800,900,"Sub-basin 7"
147,100,1,600,700,"Sub-basin 7"
148,400,25,9100,9500,"Sub-basin 7"
149,300,11,4500,4800,"Sub-basin 7"
150,300,8,3900,4200,"Sub-basin 7"
151,100,1,2800,2900,"Sub-basin 7"
152,100,2,2700,2800,"Sub-basin 7"
153,500,29,7800,8300,"Sub-basin 7"
154,100,3,200,300,"Sub-basin 7"
155,100,3,1200,1300,"Sub-basin 7"
156,100,3,1800,1900,"Sub-basin 7"
157,200,3,1400,1600,"Sub-basin 7"
158,100,1,1900,2000,"Sub-basin 7"
159,300,5,5500,5800,"Sub-basin 7"
160,300,7,4500,4800,"Sub-basin 7"
161,300,27,2800,3100,"Sub-basin 7"
162,300,11,3200,3500,"Sub-basin 7"
163,100,3,2100,2200,"Sub-basin 7"
164,100,1,1700,1800,"Sub-basin 7"
165,100,2,1700,1800,"Sub-basin 7"
166,200,15,2200,2400,"Sub-basin 7"
167,300,15,4400,4700,"Sub-basin 7"
168,700,42,7800,8500,"Sub-basin 7"
169,100,2,2500,2600,"Sub-basin 7"
170,200,13,3400,3600,"Sub-basin 7"
171,100,10,500,600,"Sub-basin 7"
172,4100,609,11000,15100,"Sub-basin 7"
173,300,6,4600,4900,"Sub-basin 7"
174,3800,570,40700,44500,"Sub-basin 7"
175,400,22,5100,5500,"Sub-basin 7"
176,100,17,600,700,"Sub-basin 7"
177,100,1,1300,1400,"Sub-basin 7"
178,400,7,5400,5800,"Sub-basin 7"
179,300,25,2200,2500,"Sub-basin 7"
180,600,18,5300,5900,"Sub-basin 7"
181,200,27,2600,2800,"Sub-basin 7"
182,100,2,300,400,"Sub-basin 7"
183,600,43,3400,4000,"Sub-basin 7"
184,300,18,400,700,"Sub-basin 7"
185,100,1,1400,1500,"Sub-basin 7"
186,1300,204,13600,14900,"Sub-basin 7"
187,1300,222,4900,6200,"Sub-basin 7"
188,3500,1211,5000,8500,"Sub-basin 7"
189,100,1,2000,2100,"Sub-basin 7"
190,300,6,3200,3500,"Sub-basin 7"
191,600,142,1300,1900,"Sub-basin 7"
192,500,12,3900,4400,"Sub-basin 7"
193,30200,12479,42500,72700,"Sub-basin 7"
194,2400,1271,4900,7300,"Sub-basin 7"
195,1300,60,6500,7800,"Sub-basin 7"
196,100,4,1200,1300,"Sub-basin 7"
197,2000,355,26400,28400,"Sub-basin 7"
198,100,1,2200,2300,"Sub-basin 7"
199,200,5,1500,1700,"Sub-basin 7"
200,300,6,2500,2800,"Sub-basin 7"
201,300,6,3000,3300,"Sub-basin 7"
202,100,1,1100,1200,"Sub-basin 7"
203,100,1,1600,1700,"Sub-basin 7"
204,200,7,2300,2500,"Sub-basin 7"
205,300,21,1600,1900,"Sub-basin 7"
206,100,2,400,500,"Sub-basin 7"
207,100,1,1100,1200,"Sub-basin 7"
208,100,4,1700,1800,"Sub-basin 7"
209,100,4,900,1000,"Sub-basin 7"
210,25200,9369,36300,61500,"Sub-basin 7"
211,2000,94,13800,15800,"Sub-basin 7"
212,100,2,900,1000,"Sub-basin 7"
213,100,1,1400,1500,"Sub-basin 7"
214,1600,137,2500,4100,"Sub-basin 7"
215,700,81,5100,5800,"Sub-basin 7"
216,100,1,900,1000,"Sub-basin 7"
217,100,2,1200,1300,"Sub-basin 7"
218,100,1,1400,1500,"Sub-basin 7"
219,400,23,5900,6300,"Sub-basin 7"
220,200,8,1300,1500,"Sub-basin 7"
221,100,3,1300,1400,"Sub-basin 7"
222,500,12,3200,3700,"Sub-basin 7"
223,1900,141,8700,10600,"Sub-basin 7"
224,100,2,700,800,"Sub-basin 7"
225,100,1,700,800,"Sub-basin 7"
226,500,43,5100,5600,"Sub-basin 7"
227,400,20,1900,2300,"Sub-basin 7"
228,300,6,2000,2300,"Sub-basin 7"
229,200,10,2100,2300,"Sub-basin 7"
230,100,4,2000,2100,"Sub-basin 7"
231,200,7,2200,2400,"Sub-basin 7"
232,100,1,1700,1800,"Sub-basin 7"
233,100,1,1800,1900,"Sub-basin 7"
234,13500,3975,25400,38900,"Sub-basin 7"
235,1700,707,3900,5600,"Sub-basin 7"
236,600,38,5300,5900,"Sub-basin 7"
237,100,1,500,600,"Sub-basin 7"
238,400,28,5300,5700,"Sub-basin 7"
239,500,21,3300,3800,"Sub-basin 7"
240,400,11,4700,5100,"Sub-basin 7"
241,4700,1361,7600,12300,"Sub-basin 7"
242,100,1,1200,1300,"Sub-basin 7"
243,400,11,4600,5000,"Sub-basin 7"
244,500,26,5700,6200,"Sub-basin 7"
245,300,8,3700,4000,"Sub-basin 7"
246,500,32,2800,3300,"Sub-basin 7"
247,100,1,900,1000,"Sub-basin 7"
248,500,8,3100,3600,"Sub-basin 7"
249,12000,6783,8900,20900,"Sub-basin 7"
250,200,2,1700,1900,"Sub-basin 7"
251,300,17,3100,3400,"Sub-basin 7"
252,100,1,1600,1700,"Sub-basin 7"
253,1000,206,2800,3800,"Sub-basin 7"
254,5000,1289,7700,12700,"Sub-basin 7"
255,200,4,2800,3000,"Sub-basin 7"
256,400,30,4900,5300,"Sub-basin 7"
257,200,4,2000,2200,"Sub-basin 7"
258,100,1,1600,1700,"Sub-basin 7"
259,100,7,700,800,"Sub-basin 7"
260,4300,1278,6200,10500,"Sub-basin 7"
261,200,3,1900,2100,"Sub-basin 7"
262,6000,2595,5300,11300,"Sub-basin 7"
263,400,62,1000,1400,"Sub-basin 7"
264,100,2,2300,2400,"Sub-basin 7"
265,100,1,1900,2000,"Sub-basin 7"
266,300,7,4000,4300,"Sub-basin 7"
267,1500,90,12900,14400,"Sub-basin 7"
268,1400,142,13200,14600,"Sub-basin 7"
269,4800,1403,4900,9700,"Sub-basin 7"
270,100,2,1900,2000,"Sub-basin 7"
271,100,1,1700,1800,"Sub-basin 7"
272,200,2,3900,4100,"Sub-basin 7"
273,1200,167,4600,5800,"Sub-basin 7"
274,300,19,2200,2500,"Sub-basin 7"
275,100,4,500,600,"Sub-basin 7"
276,100,1,1100,1200,"Sub-basin 7"
277,100,1,2200,2300,"Sub-basin 7"
278,400,20,1200,1600,"Sub-basin 7"
279,100,1,1400,1500,"Sub-basin 7"
280,2200,321,3500,5700,"Sub-basin 7"
281,200,3,200,400,"Sub-basin 7"
282,300,17,7500,7800,"Sub-basin 7"
283,92700,40734,88800,181500,"Sub-basin 7"
284,200,9,300,500,"Sub-basin 7"
285,400,13,900,1300,"Sub-basin 7"
286,600,74,2300,2900,"Sub-basin 7"
287,2500,426,7100,9600,"Sub-basin 7"
288,1100,123,5000,6100,"Sub-basin 7"
289,400,22,1900,2300,"Sub-basin 7"
290,100,56,500,600,"Sub-basin 7"
291,1100,112,2900,4000,"Sub-basin 7"
292,19100,9310.33,14600,33700,"Sub-basin 7"
293,300,7,1000,1300,"Sub-basin 7"
294,200,18,800,1000,"Sub-basin 7"
295,5500,553,36400,41900,"Sub-basin 7"
296,1200,119,4600,5800,"Sub-basin 7"
297,700,36,4600,5300,"Sub-basin 7"
298,1300,249,2500,3800,"Sub-basin 7"
299,1700,881,1400,3100,"Sub-basin 7"
300,100,1,2000,2100,"Sub-basin 7"
301,100,1,2900,3000,"Sub-basin 7"
302,100,3,1100,1200,"Sub-basin 7"
303,400,219,1300,1700,"Sub-basin 7"
304,1000,41,8500,9500,"Sub-basin 7"
305,900,112,1800,2700,"Sub-basin 7"
306,200,9,900,1100,"Sub-basin 7"
307,3200,522,9700,12900,"Sub-basin 7"
308,47100,22690.17,36100,83200,"Sub-basin 7"
309,200,8,3600,3800,"Sub-basin 7"
310,3800,645,7000,10800,"Sub-basin 7"
311,2500,625,7200,9700,"Sub-basin 7"
312,100,4,400,500,"Sub-basin 7"
313,100,1,2200,2300,"Sub-basin 7"
314,800,42,2100,2900,"Sub-basin 7"
315,100,2,1700,1800,"Sub-basin 7"
316,41600,16080,56200,97800,"Sub-basin 7"
317,2900,705,6200,9100,"Sub-basin 7"
318,600,133,1100,1700,"Sub-basin 7"
319,400,12,1100,1500,"Sub-basin 7"
320,600,20,8800,9400,"Sub-basin 7"
321,100,3,1500,1600,"Sub-basin 7"
322,800,136,2500,3300,"Sub-basin 7"
323,3400,919,7700,11100,"Sub-basin 7"
324,1000,280,2500,3500,"Sub-basin 7"
325,300,28,5300,5600,"Sub-basin 7"
326,100,2,1700,1800,"Sub-basin 7"
327,3800,1554,5400,9200,"Sub-basin 7"
328,200,13,2800,3000,"Sub-basin 7"
329,1700,105,20000,21700,"Sub-basin 7"
330,100,1,1200,1300,"Sub-basin 7"
331,400,93,1000,1400,"Sub-basin 7"
332,400,93,1600,2000,"Sub-basin 7"
333,4800,1582,6300,11100,"Sub-basin 7"
334,1800,735,4900,6700,"Sub-basin 7"
335,700,53,4700,5400,"Sub-basin 7"
336,800,39,2000,2800,"Sub-basin 7"
337,700,48,4200,4900,"Sub-basin 7"
338,6500,2534,9000,15500,"Sub-basin 7"
339,500,96,2100,2600,"Sub-basin 7"
340,200,4,100,300,"Sub-basin 7"
341,2500,808,3900,6400,"Sub-basin 7"
342,6300,1040,13100,19400,"Sub-basin 7"
343,4600,1671,5700,10300,"Sub-basin 7"
344,1100,349,2000,3100,"Sub-basin 7"
345,1500,60,11300,12800,"Sub-basin 7"
346,600,30,14900,15500,"Sub-basin 7"
347,700,26,6600,7300,"Sub-basin 7"
348,3800,682,8100,11900,"Sub-basin 7"
349,400,66,1000,1400,"Sub-basin 7"
350,1400,434,10000,11400,"Sub-basin 7"
351,7600,3167,9500,17100,"Sub-basin 7"
352,1600,349,5000,6600,"Sub-basin 7"
353,100,4,1700,1800,"Sub-basin 7"
354,500,17,3600,4100,"Sub-basin 7"
355,200,4,700,900,"Sub-basin 7"
356,1100,296,3300,4400,"Sub-basin 7"
357,100,1,1600,1700,"Sub-basin 7"
358,5800,3078,6100,11900,"Sub-basin 7"
359,200,4,2700,2900,"Sub-basin 7"
360,100,2,2700,2800,"Sub-basin 7"
361,600,12,7300,7900,"Sub-basin 7"
362,500,47,1400,1900,"Sub-basin 7"
363,200,24,1200,1400,"Sub-basin 7"
364,500,11,3900,4400,"Sub-basin 7"
365,500,69,1300,1800,"Sub-basin 7"
366,400,12,2300,2700,"Sub-basin 7"
367,2200,237,7800,10000,"Sub-basin 7"
368,1200,249,2300,3500,"Sub-basin 7"
369,100,2,400,500,"Sub-basin 7"
370,400,16,7700,8100,"Sub-basin 7"
371,100,2,1100,1200,"Sub-basin 7"
372,1300,223,2900,4200,"Sub-basin 7"
373,300,41,2100,2400,"Sub-basin 7"
374,1700,119,11100,12800,"Sub-basin 7"
375,400,10,5700,6100,"Sub-basin 7"
376,900,179,1800,2700,"Sub-basin 7"
377,100,4,900,1000,"Sub-basin 7"
378,700,229,2200,2900,"Sub-basin 7"
379,1100,314,2500,3600,"Sub-basin 7"
380,100,2,1800,1900,"Sub-basin 7"
381,11700,3690,10800,22500,"Sub-basin 7"
382,300,6,2700,3000,"Sub-basin 7"
383,800,89,1500,2300,"Sub-basin 7"
384,17200,4233,22200,39400,"Sub-basin 7"
385,26800,5122,194600,221400,"Sub-basin 7"
386,38400,20457,34600,73000,"Sub-basin 7"
387,1100,177,2900,4000,"Sub-basin 7"
388,600,155,1900,2500,"Sub-basin 7"
389,900,59,8200,9100,"Sub-basin 7"
390,100,1,1600,1700,"Sub-basin 7"
391,900,46,4400,5300,"Sub-basin 7"
392,200,14,1300,1500,"Sub-basin 7"
393,900,91,1600,2500,"Sub-basin 7"
394,31700,15351,35300,67000,"Sub-basin 7"
395,2100,429,3900,6000,"Sub-basin 7"
396,600,181,1700,2300,"Sub-basin 7"
397,500,31,4400,4900,"Sub-basin 7"
398,200,5,2000,2200,"Sub-basin 7"
399,3000,351,7300,10300,"Sub-basin 7"
400,600,207,2800,3400,"Sub-basin 7"
401,1200,162,3000,4200,"Sub-basin 7"
402,200,5,3100,3300,"Sub-basin 7"
403,500,19,8800,9300,"Sub-basin 7"
404,300,11,700,1000,"Sub-basin 7"
405,10200,4329,15900,26100,"Sub-basin 7"
406,700,56,4000,4700,"Sub-basin 7"
407,100,1,600,700,"Sub-basin 7"
408,1600,425,2900,4500,"Sub-basin 7"
409,400,18,3300,3700,"Sub-basin 7"
410,100,4,700,800,"Sub-basin 7"
411,200,2,2900,3100,"Sub-basin 7"
412,1300,176,3100,4400,"Sub-basin 7"
413,100,2,600,700,"Sub-basin 7"
414,200,2,1100,1300,"Sub-basin 7"
415,500,31,3500,4000,"Sub-basin 7"
416,2800,266,14600,17400,"Sub-basin 7"
417,1400,210,4700,6100,"Sub-basin 7"
418,200,5,2700,2900,"Sub-basin 7"
419,500,22,5800,6300,"Sub-basin 7"
420,1500,159,2100,3600,"Sub-basin 7"
421,400,5,2500,2900,"Sub-basin 7"
422,100,3,1300,1400,"Sub-basin 7"
423,2300,421,5600,7900,"Sub-basin 7"
424,500,47,2200,2700,"Sub-basin 7"
425,100,2,1100,1200,"Sub-basin 7"
426,200,8,3700,3900,"Sub-basin 7"
427,100,4,1000,1100,"Sub-basin 7"
428,1300,80,3800,5100,"Sub-basin 7"
429,2200,509,3800,6000,"Sub-basin 7"
430,200,10,500,700,"Sub-basin 7"
431,1700,409,1800,3500,"Sub-basin 7"
432,1700,70,7400,9100,"Sub-basin 7"
433,3600,359,16100,19700,"Sub-basin 7"
434,300,8,4900,5200,"Sub-basin 7"
435,100,3,1100,1200,"Sub-basin 7"
436,1100,80,6600,7700,"Sub-basin 7"
437,700,81,5600,6300,"Sub-basin 7"
438,400,20,1800,2200,"Sub-basin 7"
439,700,84,3300,4000,"Sub-basin 7"
440,100,12,1700,1800,"Sub-basin 7"
441,1900,290.17,23200,25100,"Sub-basin 7"
442,6100,2175,5100,11200,"Sub-basin 7"
443,6000,2577,5900,11900,"Sub-basin 7"
444,5600,1637,6200,11800,"Sub-basin 7"
445,1300,130,1900,3200,"Sub-basin 7"
446,300,22,1000,1300,"Sub-basin 7"
447,100,1,1100,1200,"Sub-basin 7"
448,100,2,700,800,"Sub-basin 7"
449,400,13,400,800,"Sub-basin 7"
450,2600,926,2400,5000,"Sub-basin 7"
451,900,85,2900,3800,"Sub-basin 7"
452,27800,9059,27800,55600,"Sub-basin 7"
453,6000,1552,5800,11800,"Sub-basin 7"
454,1100,239,1900,3000,"Sub-basin 7"
455,1000,149,3100,4100,"Sub-basin 7"
456,200,10,2000,2200,"Sub-basin 7"
457,700,94,2500,3200,"Sub-basin 7"
458,24900,10859,26100,51000,"Sub-basin 7"
459,600,53,1800,2400,"Sub-basin 7"
460,700,67,2800,3500,"Sub-basin 7"
461,300,30,2300,2600,"Sub-basin 7"
462,200,4,900,1100,"Sub-basin 7"
463,1100,46,5500,6600,"Sub-basin 7"
464,200,16,1400,1600,"Sub-basin 7"
465,5000,753,7500,12500,"Sub-basin 7"
466,200,3,500,700,"Sub-basin 7"
467,39600,28690,25700,65300,"Sub-basin 7"
468,1000,76,4700,5700,"Sub-basin 7"
469,500,18,3000,3500,"Sub-basin 7"
470,1000,62,5900,6900,"Sub-basin 7"
471,100,2,800,900,"Sub-basin 7"
472,33100,19111,30400,63500,"Sub-basin 7"
473,100,35,2400,2500,"Sub-basin 7"
474,4000,1526,9000,13000,"Sub-basin 7"
475,100,2,300,400,"Sub-basin 7"
476,3700,525,7900,11600,"Sub-basin 7"
477,900,252,2000,2900,"Sub-basin 7"
478,100,1,1700,1800,"Sub-basin 7"
479,1500,222,3900,5400,"Sub-basin 7"
480,1900,447,4600,6500,"Sub-basin 7"
481,100,1,1500,1600,"Sub-basin 7"
482,1200,54,4700,5900,"Sub-basin 7"
483,1000,60,5400,6400,"Sub-basin 7"
484,600,36,2000,2600,"Sub-basin 7"
485,200,2,2300,2500,"Sub-basin 7"
486,1600,205,6500,8100,"Sub-basin 7"
487,100,1,900,1000,"Sub-basin 7"
488,500,61,3800,4300,"Sub-basin 7"
489,100,4,1200,1300,"Sub-basin 7"
490,1500,376,2800,4300,"Sub-basin 7"
491,800,87,3400,4200,"Sub-basin 7"
492,1000,76,3000,4000,"Sub-basin 7"
493,4900,1615,4100,9000,"Sub-basin 7"
494,800,71,2400,3200,"Sub-basin 7"
495,23000,11080,21300,44300,"Sub-basin 7"
496,200,6,1600,1800,"Sub-basin 7"
497,1600,67,6900,8500,"Sub-basin 7"
498,100,4,700,800,"Sub-basin 7"
499,3800,252.33,21800,25600,"Sub-basin 7"
500,700,43,700,1400,"Sub-basin 7"
501,400,9,1900,2300,"Sub-basin 7"
502,1100,99,4900,6000,"Sub-basin 7"
503,1100,122,4400,5500,"Sub-basin 7"
504,1300,122,5500,6800,"Sub-basin 7"
505,400,33,1900,2300,"Sub-basin 7"
506,600,41,2400,3000,"Sub-basin 7"
507,300,4,2500,2800,"Sub-basin 7"
508,500,19,4000,4500,"Sub-basin 7"
509,100,2,500,600,"Sub-basin 7"
510,2000,178,4100,6100,"Sub-basin 7"
511,400,23,900,1300,"Sub-basin 7"
512,600,53,3300,3900,"Sub-basin 7"
513,42400,16751,51800,94200,"Sub-basin 7"
514,100,2,1100,1200,"Sub-basin 7"
515,1300,139,3600,4900,"Sub-basin 7"
516,100,1,1200,1300,"Sub-basin 7"
517,200,4,3500,3700,"Sub-basin 7"
518,3400,455,5200,8600,"Sub-basin 7"
519,400,28,1300,1700,"Sub-basin 7"
520,400,17,2600,3000,"Sub-basin 7"
521,400,21,1900,2300,"Sub-basin 7"
522,5100,1855,5900,11000,"Sub-basin 7"
523,10700,1880,32900,43600,"Sub-basin 7"
524,3300,309,17000,20300,"Sub-basin 7"
525,400,9,4600,5000,"Sub-basin 7"
526,4100,468,20800,24900,"Sub-basin 7"
527,200,2,1700,1900,"Sub-basin 7"
528,18100,6770,30700,48800,"Sub-basin 7"
529,900,35,5500,6400,"Sub-basin 7"
530,100,1,1400,1500,"Sub-basin 7"
531,100,5,600,700,"Sub-basin 7"
532,100,1,700,800,"Sub-basin 7"
533,200,18,1900,2100,"Sub-basin 7"
534,300,4,3100,3400,"Sub-basin 7"
535,1700,101,10300,12000,"Sub-basin 7"
536,300,6,2000,2300,"Sub-basin 7"
537,200,8,1600,1800,"Sub-basin 7"
538,6200,1236,9500,15700,"Sub-basin 7"
539,1300,57,7600,8900,"Sub-basin 7"
540,3700,1645,3600,7300,"Sub-basin 7"
541,100,3,1700,1800,"Sub-basin 7"
542,600,40,2200,2800,"Sub-basin 7"
543,600,69,1000,1600,"Sub-basin 7"
544,200,5,3900,4100,"Sub-basin 7"
545,400,15,3600,4000,"Sub-basin 7"
546,4400,2148,12300,16700,"Sub-basin 7"
547,1900,322,2700,4600,"Sub-basin 7"
548,1900,332,5000,6900,"Sub-basin 7"
549,400,11,5600,6000,"Sub-basin 7"
550,300,10,2500,2800,"Sub-basin 7"
551,300,10,5400,5700,"Sub-basin 7"
552,8400,5119,11200,19600,"Sub-basin 7"
553,5200,1531,5400,10600,"Sub-basin 7"
554,700,160,2200,2900,"Sub-basin 7"
555,200,8,4600,4800,"Sub-basin 7"
556,200,7,2500,2700,"Sub-basin 7"
557,300,23,1700,2000,"Sub-basin 7"
558,4600,1833,11800,16400,"Sub-basin 7"
559,5600,1947,10200,15800,"Sub-basin 7"
560,100,1,3100,3200,"Sub-basin 7"
561,100,1,1700,1800,"Sub-basin 7"
562,1900,446,2800,4700,"Sub-basin 7"
563,1600,100,14500,16100,"Sub-basin 7"
564,30200,15776,30000,60200,"Sub-basin 7"
565,200,4,600,800,"Sub-basin 7"
566,500,44,1900,2400,"Sub-basin 7"
567,1300,91,5400,6700,"Sub-basin 7"
568,300,8,4200,4500,"Sub-basin 7"
569,1100,272,3200,4300,"Sub-basin 7"
570,400,10,7700,8100,"Sub-basin 7"
571,200,14,2000,2200,"Sub-basin 7"
572,7000,915,20300,27300,"Sub-basin 7"
573,2500,809,4000,6500,"Sub-basin 7"
574,2200,543.83,10200,12400,"Sub-basin 7"
575,200,3,700,900,"Sub-basin 7"
576,300,16,2700,3000,"Sub-basin 7"
577,300,14,4800,5100,"Sub-basin 7"
578,100,1,1300,1400,"Sub-basin 7"
579,100,2,1200,1300,"Sub-basin 7"
580,100,1,1900,2000,"Sub-basin 7"
581,1200,37,12800,14000,"Sub-basin 7"
582,1000,180,2100,3100,"Sub-basin 7"
583,600,26,5200,5800,"Sub-basin 7"
584,200,9,2000,2200,"Sub-basin 7"
585,4200,1841,7700,11900,"Sub-basin 7"
586,3100,1196,4400,7500,"Sub-basin 7"
587,200,2,1500,1700,"Sub-basin 7"
588,400,26,5000,5400,"Sub-basin 7"
589,200,5,3900,4100,"Sub-basin 7"
590,100,1,2100,2200,"Sub-basin 7"
591,100,4,1200,1300,"Sub-basin 7"
592,200,5,1400,1600,"Sub-basin 7"
593,400,9,1200,1600,"Sub-basin 7"
594,300,18,1000,1300,"Sub-basin 7"
595,6400,2325,6900,13300,"Sub-basin 7"
596,400,25,1000,1400,"Sub-basin 7"
597,500,26,4000,4500,"Sub-basin 7"
598,700,56,4100,4800,"Sub-basin 7"
599,200,3,4500,4700,"Sub-basin 7"
600,700,21,10600,11300,"Sub-basin 7"
601,100,1,2900,3000,"Sub-basin 7"
602,100,2,1400,1500,"Sub-basin 7"
603,100,1,1500,1600,"Sub-basin 7"
604,100,2,2100,2200,"Sub-basin 7"
605,100,1,200,300,"Sub-basin 7"
606,1900,215,7500,9400,"Sub-basin 7"
607,600,18,3700,4300,"Sub-basin 7"
608,200,4,2900,3100,"Sub-basin 7"
609,700,21,4500,5200,"Sub-basin 7"
610,500,56,5000,5500,"Sub-basin 7"
611,11200,1273,84000,95200,"Sub-basin 7"
612,1600,656,9000,10600,"Sub-basin 7"
613,4900,791,31100,36000,"Sub-basin 7"
614,400,15,3500,3900,"Sub-basin 7"
615,300,10,2500,2800,"Sub-basin 7"
616,21800,7657.67,27600,49400,"Sub-basin 7"
617,3600,1030,21500,25100,"Sub-basin 7"
618,300,16,1200,1500,"Sub-basin 7"
619,2600,712,6600,9200,"Sub-basin 7"
620,100,2,1700,1800,"Sub-basin 7"
621,13900,1896.17,93900,107800,"Sub-basin 7"
622,400,23,2200,2600,"Sub-basin 7"
623,200,5,2000,2200,"Sub-basin 7"
624,100,2,900,1000,"Sub-basin 7"
625,7600,3281,8400,16000,"Sub-basin 7"
626,200,6,800,1000,"Sub-basin 7"
627,100,1,1200,1300,"Sub-basin 7"
628,400,5,800,1200,"Sub-basin 7"
629,200,7,3200,3400,"Sub-basin 7"
630,1100,61,13000,14100,"Sub-basin 7"
631,5600,571,26800,32400,"Sub-basin 7"
632,100,1,2200,2300,"Sub-basin 7"
633,300,8,3800,4100,"Sub-basin 7"
634,300,10,2100,2400,"Sub-basin 7"
635,100,1,1100,1200,"Sub-basin 7"
636,400,10,7500,7900,"Sub-basin 7"
637,400,24,6500,6900,"Sub-basin 7"
638,100,1,1000,1100,"Sub-basin 7"
639,4600,2772,7600,12200,"Sub-basin 7"
640,600,19,7400,8000,"Sub-basin 7"
641,800,93,6600,7400,"Sub-basin 7"
642,1100,66,4700,5800,"Sub-basin 7"
643,100,1,2100,2200,"Sub-basin 7"
644,500,20,4400,4900,"Sub-basin 7"
645,19300,11375,18900,38200,"Sub-basin 7"
646,13300,2401,22600,35900,"Sub-basin 7"
647,1400,290,8500,9900,"Sub-basin 7"
648,100,1,2300,2400,"Sub-basin 7"
649,200,7,2500,2700,"Sub-basin 7"
650,1900,221,15300,17200,"Sub-basin 7"
651,100,2,1400,1500,"Sub-basin 7"
652,800,55,1900,2700,"Sub-basin 7"
653,1200,414,7400,8600,"Sub-basin 7"
654,200,11,2400,2600,"Sub-basin 7"
655,31200,15895.5,33300,64500,"Sub-basin 7"
656,100,2,800,900,"Sub-basin 7"
657,100,6,1700,1800,"Sub-basin 7"
658,100,3,1700,1800,"Sub-basin 7"
659,100,1,1500,1600,"Sub-basin 7"
660,100,5,700,800,"Sub-basin 7"
661,600,37,3600,4200,"Sub-basin 7"
662,700,26,3300,4000,"Sub-basin 7"
663,200,6,2300,2500,"Sub-basin 7"
664,200,7,400,600,"Sub-basin 7"
665,500,129,1100,1600,"Sub-basin 7"
666,3300,1542,9000,12300,"Sub-basin 7"
667,100,1,600,700,"Sub-basin 7"
668,100,2,2600,2700,"Sub-basin 7"
669,100,1,2000,2100,"Sub-basin 7"
670,200,12,2900,3100,"Sub-basin 7"
671,500,19,7600,8100,"Sub-basin 7"
672,600,19,2300,2900,"Sub-basin 7"
673,500,50,5500,6000,"Sub-basin 7"
674,100,1,2300,2400,"Sub-basin 7"
675,7500,3969,12700,20200,"Sub-basin 7"
676,42500,20997,33800,76300,"Sub-basin 7"
677,300,10,600,900,"Sub-basin 7"
678,11100,3635,18500,29600,"Sub-basin 7"
679,1000,124,2600,3600,"Sub-basin 7"
680,100,1,0,100,"Sub-basin 7"
681,1100,119,3100,4200,"Sub-basin 7"
682,800,59,4900,5700,"Sub-basin 7"
683,200,14,4200,4400,"Sub-basin 7"
684,200,5,2500,2700,"Sub-basin 7"
685,200,5,2200,2400,"Sub-basin 7"
686,200,4,3100,3300,"Sub-basin 7"
687,800,69,1900,2700,"Sub-basin 7"
688,400,22,2900,3300,"Sub-basin 7"
689,8700,3323,15800,24500,"Sub-basin 7"
690,100,1,1200,1300,"Sub-basin 7"
691,100,2,900,1000,"Sub-basin 7"
692,53200,32245.54,61100,114300,"Sub-basin 7"
693,400,42,2500,2900,"Sub-basin 7"
694,100,1,3500,3600,"Sub-basin 7"
695,200,4,2600,2800,"Sub-basin 7"
696,600,55,3200,3800,"Sub-basin 7"
697,300,6,3900,4200,"Sub-basin 7"
698,100,1,1400,1500,"Sub-basin 7"
699,200,14,1000,1200,"Sub-basin 7"
700,200,6,1900,2100,"Sub-basin 7"
701,400,9,6800,7200,"Sub-basin 7"
702,200,3,2500,2700,"Sub-basin 7"
703,600,112,1400,2000,"Sub-basin 7"
704,300,15,1600,1900,"Sub-basin 7"
705,1100,94,4100,5200,"Sub-basin 7"
706,800,52,3600,4400,"Sub-basin 7"
707,100,1,1600,1700,"Sub-basin 7"
708,200,5,2000,2200,"Sub-basin 7"
709,500,17,5200,5700,"Sub-basin 7"
710,100,2,700,800,"Sub-basin 7"
711,700,43,2800,3500,"Sub-basin 7"
712,2600,457,18500,21100,"Sub-basin 7"
713,400,11,3100,3500,"Sub-basin 7"
714,200,3,2200,2400,"Sub-basin 7"
715,400,8,3400,3800,"Sub-basin 7"
716,400,13,7600,8000,"Sub-basin 7"
717,700,32,12200,12900,"Sub-basin 7"
718,3800,663,8000,11800,"Sub-basin 7"
719,1400,245,1900,3300,"Sub-basin 7"
720,1100,248,2200,3300,"Sub-basin 7"
721,300,7,1800,2100,"Sub-basin 7"
722,100,1,1700,1800,"Sub-basin 7"
723,200,10,3000,3200,"Sub-basin 7"
724,500,20,4500,5000,"Sub-basin 7"
725,100,2,500,600,"Sub-basin 7"
726,500,19,2500,3000,"Sub-basin 7"
727,100,2,1100,1200,"Sub-basin 7"
728,200,2,700,900,"Sub-basin 7"
729,1800,92,10400,12200,"Sub-basin 7"
730,200,2,1700,1900,"Sub-basin 7"
731,2200,135,35700,37900,"Sub-basin 7"
732,200,4,3100,3300,"Sub-basin 7"
733,8800,4134,11000,19800,"Sub-basin 7"
734,200,5,2800,3000,"Sub-basin 7"
735,15900,7557,17800,33700,"Sub-basin 7"
736,500,57,4200,4700,"Sub-basin 7"
737,2400,332,8900,11300,"Sub-basin 7"
738,100,1,1200,1300,"Sub-basin 7"
739,200,9,2100,2300,"Sub-basin 7"
740,200,3,1800,2000,"Sub-basin 7"
741,200,5,1200,1400,"Sub-basin 7"
742,200,3,2100,2300,"Sub-basin 7"
743,400,33,1100,1500,"Sub-basin 7"
744,400,78,600,1000,"Sub-basin 7"
745,1000,88,4400,5400,"Sub-basin 7"
746,200,10,1900,2100,"Sub-basin 7"
747,400,60,2300,2700,"Sub-basin 7"
748,800,197,400,1200,"Sub-basin 7"
749,200,4,2600,2800,"Sub-basin 7"
750,100,3,2400,2500,"Sub-basin 7"
751,100,1,2600,2700,"Sub-basin 7"
752,100,4,1600,1700,"Sub-basin 7"
753,1500,136,9800,11300,"Sub-basin 7"
754,100,2,1300,1400,"Sub-basin 7"
755,600,31,2000,2600,"Sub-basin 7"
756,24300,4402,58900,83200,"Sub-basin 7"
757,300,50,500,800,"Sub-basin 7"
758,15900,3339,52500,68400,"Sub-basin 7"
759,100,4,1300,1400,"Sub-basin 7"
760,5800,1250,22000,27800,"Sub-basin 7"
761,3400,613,8800,12200,"Sub-basin 7"
762,100,2,500,600,"Sub-basin 7"
763,100,1,1600,1700,"Sub-basin 7"
764,7800,1810,16900,24700,"Sub-basin 7"
765,500,14,1100,1600,"Sub-basin 7"
766,100,1,2500,2600,"Sub-basin 7"
767,4900,1559,24000,28900,"Sub-basin 7"
768,200,2,2400,2600,"Sub-basin 7"
769,100,2,1200,1300,"Sub-basin 7"
770,400,24,700,1100,"Sub-basin 7"
771,200,5,2600,2800,"Sub-basin 7"
772,4000,1907,8100,12100,"Sub-basin 7"
773,100,2,2200,2300,"Sub-basin 7"
774,400,16,5400,5800,"Sub-basin 7"
775,200,12,3900,4100,"Sub-basin 7"
776,500,18,1800,2300,"Sub-basin 7"
777,9500,1971,23500,33000,"Sub-basin 7"
778,5300,1147,13000,18300,"Sub-basin 7"
779,900,129,3700,4600,"Sub-basin 7"
780,1100,42,6600,7700,"Sub-basin 7"
781,600,32,4000,4600,"Sub-basin 7"
782,100,1,1300,1400,"Sub-basin 7"
783,100,4,1500,1600,"Sub-basin 7"
784,30400,10512,62100,92500,"Sub-basin 7"
785,800,102,2300,3100,"Sub-basin 7"
786,200,3,3800,4000,"Sub-basin 7"
787,1200,176,2500,3700,"Sub-basin 7"
788,800,239,1900,2700,"Sub-basin 7"
789,1100,125,2400,3500,"Sub-basin 7"
790,400,19,1500,1900,"Sub-basin 7"
791,400,21,3100,3500,"Sub-basin 7"
792,100,1,1100,1200,"Sub-basin 7"
793,100,3,2400,2500,"Sub-basin 7"
794,500,52,2500,3000,"Sub-basin 7"
795,1300,30,1500,2800,"Sub-basin 7"
796,2000,389,7300,9300,"Sub-basin 7"
797,100,4,2400,2500,"Sub-basin 7"
798,100,1,700,800,"Sub-basin 7"
799,200,3,1100,1300,"Sub-basin 7"
800,100,1,1000,1100,"Sub-basin 7"
801,8200,2760,16900,25100,"Sub-basin 7"
802,200,7,2000,2200,"Sub-basin 7"
803,200,7,4900,5100,"Sub-basin 7"
804,2300,871,16500,18800,"Sub-basin 7"
805,200,5,600,800,"Sub-basin 7"
806,1400,136,6400,7800,"Sub-basin 7"
807,200,5,1000,1200,"Sub-basin 7"
808,4200,2026,8400,12600,"Sub-basin 7"
809,600,40,1900,2500,"Sub-basin 7"
810,100,2,2200,2300,"Sub-basin 7"
811,400,23,1200,1600,"Sub-basin 7"
812,200,2,1600,1800,"Sub-basin 7"
813,100,1,1800,1900,"Sub-basin 7"
814,7100,1365,22800,29900,"Sub-basin 7"
815,300,16,4500,4800,"Sub-basin 7"
816,1000,57,20300,21300,"Sub-basin 7"
817,900,40,20500,21400,"Sub-basin 7"
818,300,6,1200,1500,"Sub-basin 7"
819,200,5,5000,5200,"Sub-basin 7"
820,200,3,1900,2100,"Sub-basin 7"
821,400,29,1700,2100,"Sub-basin 7"
822,400,7,4400,4800,"Sub-basin 7"
823,5300,1474,18000,23300,"Sub-basin 7"
824,300,7,1300,1600,"Sub-basin 7"
825,300,17,5900,6200,"Sub-basin 7"
826,500,34,5900,6400,"Sub-basin 7"
827,200,5,1500,1700,"Sub-basin 7"
828,100,1,1100,1200,"Sub-basin 7"
829,600,26,7000,7600,"Sub-basin 7"
830,200,3,2100,2300,"Sub-basin 7"
831,200,2,900,1100,"Sub-basin 7"
832,100,2,2000,2100,"Sub-basin 7"
833,100,1,2100,2200,"Sub-basin 7"
834,200,5,4600,4800,"Sub-basin 7"
835,700,58,4100,4800,"Sub-basin 7"
836,1300,134,5400,6700,"Sub-basin 7"
837,700,23,9500,10200,"Sub-basin 7"
838,100,1,700,800,"Sub-basin 7"
839,200,4,5900,6100,"Sub-basin 7"
840,100,1,700,800,"Sub-basin 7"
841,2700,944,13900,16600,"Sub-basin 7"
842,300,21,800,1100,"Sub-basin 7"
843,300,5,1900,2200,"Sub-basin 7"
844,13700,9202,15300,29000,"Sub-basin 7"
845,300,9,3800,4100,"Sub-basin 7"
846,1900,280,4100,6000,"Sub-basin 7"
847,200,5,2600,2800,"Sub-basin 7"
848,900,36,13800,14700,"Sub-basin 7"
849,100,1,2100,2200,"Sub-basin 7"
850,100,4,2100,2200,"Sub-basin 7"
851,200,3,2900,3100,"Sub-basin 7"
852,400,114,1500,1900,"Sub-basin 7"
853,1100,74,10100,11200,"Sub-basin 7"
854,1000,457,2300,3300,"Sub-basin 7"
855,400,13,2300,2700,"Sub-basin 7"
856,100,1,2600,2700,"Sub-basin 7"
857,300,12,1300,1600,"Sub-basin 7"
858,100,4,700,800,"Sub-basin 7"
859,100,4,500,600,"Sub-basin 7"
860,300,10,1700,2000,"Sub-basin 7"
861,100,2,700,800,"Sub-basin 7"
862,100,3,1400,1500,"Sub-basin 7"
863,100,2,200,300,"Sub-basin 7"
864,300,15,200,500,"Sub-basin 7"
865,300,17,700,1000,"Sub-basin 7"
866,200,6,400,600,"Sub-basin 7"
867,200,6,500,700,"Sub-basin 7"
868,100,1,900,1000,"Sub-basin 7"
869,100,3,300,400,"Sub-basin 7"
870,1100,216,2000,3100,"Sub-basin 7"
871,200,9,1800,2000,"Sub-basin 7"
872,600,30,6100,6700,"Sub-basin 7"
873,900,59,12200,13100,"Sub-basin 7"
874,200,4,3300,3500,"Sub-basin 7"
875,100,1,1600,1700,"Sub-basin 7"
876,1700,207,6400,8100,"Sub-basin 7"
877,2500,223,10300,12800,"Sub-basin 7"
878,3800,391,9900,13700,"Sub-basin 7"
879,300,9,1600,1900,"Sub-basin 7"
880,3600,972,9100,12700,"Sub-basin 7"
881,100,1,1100,1200,"Sub-basin 7"
882,200,10,3200,3400,"Sub-basin 7"
883,100,3,2200,2300,"Sub-basin 7"
884,300,5,2900,3200,"Sub-basin 7"
885,100,1,700,800,"Sub-basin 7"
886,800,159,2000,2800,"Sub-basin 7"
887,200,2,2400,2600,"Sub-basin 7"
888,100,1,400,500,"Sub-basin 7"
889,1200,37,12300,13500,"Sub-basin 7"
890,100,2,600,700,"Sub-basin 7"
891,4000,898,44000,48000,"Sub-basin 7"
892,500,83,2300,2800,"Sub-basin 7"
893,200,2,1300,1500,"Sub-basin 7"
894,1400,67,14800,16200,"Sub-basin 7"
895,900,96,2900,3800,"Sub-basin 7"
896,2800,840,4400,7200,"Sub-basin 7"
897,400,26,2500,2900,"Sub-basin 7"
898,200,7,4900,5100,"Sub-basin 7"
899,300,11,3400,3700,"Sub-basin 7"
900,700,166,4900,5600,"Sub-basin 7"
901,700,57,2100,2800,"Sub-basin 7"
902,500,19,3300,3800,"Sub-basin 7"
903,900,61,3300,4200,"Sub-basin 7"
904,600,66,2900,3500,"Sub-basin 7"
905,1600,150,5900,7500,"Sub-basin 7"
906,900,169,4000,4900,"Sub-basin 7"
907,500,11,3500,4000,"Sub-basin 7"
908,600,49,6400,7000,"Sub-basin 7"
909,200,3,2200,2400,"Sub-basin 7"
910,200,3,5900,6100,"Sub-basin 7"
911,200,5,4300,4500,"Sub-basin 7"
912,9500,4792,21400,30900,"Sub-basin 7"
913,1500,172,6100,7600,"Sub-basin 7"
914,9500,2484,20300,29800,"Sub-basin 7"
915,1300,120,8400,9700,"Sub-basin 7"
916,200,3,1900,2100,"Sub-basin 7"
917,500,10,5100,5600,"Sub-basin 7"
918,700,108,2000,2700,"Sub-basin 7"
919,600,124,3000,3600,"Sub-basin 7"
920,800,31,14200,15000,"Sub-basin 7"
921,300,13,2900,3200,"Sub-basin 7"
922,100,4,1500,1600,"Sub-basin 7"
923,100,1,800,900,"Sub-basin 7"
924,100,1,1400,1500,"Sub-basin 7"
925,100,2,400,500,"Sub-basin 7"
926,1000,99,6600,7600,"Sub-basin 7"
927,100,7,600,700,"Sub-basin 7"
928,200,3,1900,2100,"Sub-basin 7"
929,900,84,6100,7000,"Sub-basin 7"
930,2200,392,5800,8000,"Sub-basin 7"
931,200,5,1500,1700,"Sub-basin 7"
932,700,58,3800,4500,"Sub-basin 7"
933,12900,4756.33,40900,53800,"Sub-basin 7"
934,300,4,4000,4300,"Sub-basin 7"
935,1600,137,6100,7700,"Sub-basin 7"
936,4200,2081,7500,11700,"Sub-basin 7"
937,100,1,1800,1900,"Sub-basin 7"
938,100,2,900,1000,"Sub-basin 7"
939,100,2,900,1000,"Sub-basin 7"
940,100,1,1200,1300,"Sub-basin 7"
941,200,8,3500,3700,"Sub-basin 7"
942,200,8,1000,1200,"Sub-basin 7"
943,200,4,2600,2800,"Sub-basin 7"
944,200,9,3700,3900,"Sub-basin 7"
945,400,53,1800,2200,"Sub-basin 7"
946,6900,1787,12200,19100,"Sub-basin 7"
947,200,3,700,900,"Sub-basin 7"
948,800,50,3800,4600,"Sub-basin 7"
949,100,2,1800,1900,"Sub-basin 7"
950,200,23,2100,2300,"Sub-basin 7"
951,100,1,900,1000,"Sub-basin 7"
952,500,29,1200,1700,"Sub-basin 7"
953,1300,86,3800,5100,"Sub-basin 7"
954,100,3,1300,1400,"Sub-basin 7"
955,900,44,8300,9200,"Sub-basin 7"
956,8400,1362,31100,39500,"Sub-basin 7"
957,700,36,8200,8900,"Sub-basin 7"
958,10200,1075,133200,143400,"Sub-basin 7"
959,200,11,1700,1900,"Sub-basin 7"
960,300,10,3000,3300,"Sub-basin 7"
961,300,6,3000,3300,"Sub-basin 7"
962,3100,1534,12700,15800,"Sub-basin 7"
963,100,3,900,1000,"Sub-basin 7"
964,100,1,900,1000,"Sub-basin 7"
965,1100,76,12200,13300,"Sub-basin 7"
966,300,6,3100,3400,"Sub-basin 7"
967,100,3,500,600,"Sub-basin 7"
968,800,83,1500,2300,"Sub-basin 7"
969,1100,108,10700,11800,"Sub-basin 7"
970,200,3,5200,5400,"Sub-basin 7"
971,100,1,2400,2500,"Sub-basin 7"
972,600,198,2100,2700,"Sub-basin 7"
973,300,14,2500,2800,"Sub-basin 7"
974,100,2,1000,1100,"Sub-basin 7"
975,100,1,1900,2000,"Sub-basin 7"
976,700,76,1200,1900,"Sub-basin 7"
977,2000,221,3800,5800,"Sub-basin 7"
978,500,39,10100,10600,"Sub-basin 7"
979,400,13,6400,6800,"Sub-basin 7"
980,100,5,2200,2300,"Sub-basin 7"
981,900,244,3700,4600,"Sub-basin 7"
982,1800,136.33,10000,11800,"Sub-basin 7"
983,100,1,1400,1500,"Sub-basin 7"
984,100,1,2200,2300,"Sub-basin 7"
985,100,3,2000,2100,"Sub-basin 7"
986,5400,808,31500,36900,"Sub-basin 7"
987,800,69,8200,9000,"Sub-basin 7"
988,100,1,1500,1600,"Sub-basin 7"
989,400,26,2800,3200,"Sub-basin 7"
990,400,25,4000,4400,"Sub-basin 7"
991,32500,22749.33,31000,63500,"Sub-basin 7"
992,900,93,6300,7200,"Sub-basin 7"
993,100,2,800,900,"Sub-basin 7"
994,200,4,4400,4600,"Sub-basin 7"
995,100,2,1900,2000,"Sub-basin 7"
996,500,15,3700,4200,"Sub-basin 7"
997,200,4,2100,2300,"Sub-basin 7"
998,300,7,2500,2800,"Sub-basin 7"
999,900,107,7100,8000,"Sub-basin 7"
1000,600,110,3100,3700,"Sub-basin 7"
1001,200,7,2600,2800,"Sub-basin 7"
1002,400,32,4900,5300,"Sub-basin 7"
1003,100,4,1200,1300,"Sub-basin 7"
1004,100,2,1400,1500,"Sub-basin 7"
1005,100,3,1000,1100,"Sub-basin 7"
1006,100,1,900,1000,"Sub-basin 7"
1007,100,1,1600,1700,"Sub-basin 7"
1008,100,1,1200,1300,"Sub-basin 7"
1009,200,6,2300,2500,"Sub-basin 7"
1010,1600,73,8400,10000,"Sub-basin 7"
1011,100,7,1500,1600,"Sub-basin 7"
1012,1700,137,21000,22700,"Sub-basin 7"
1013,58500,32109,42200,100700,"Sub-basin 7"
1014,1200,128,3300,4500,"Sub-basin 7"
1015,3500,394,20300,23800,"Sub-basin 7"
1016,900,165,3400,4300,"Sub-basin 7"
1017,600,19,3300,3900,"Sub-basin 7"
1018,200,3,2600,2800,"Sub-basin 7"
1019,100,1,2200,2300,"Sub-basin 7"
1020,1100,108.003,8500,9600,"Sub-basin 7"
1021,300,6,1900,2200,"Sub-basin 7"
1022,400,12,2300,2700,"Sub-basin 7"
1023,1100,52,5400,6500,"Sub-basin 7"
1024,100,1,2200,2300,"Sub-basin 7"
1025,300,7,2600,2900,"Sub-basin 7"
1026,500,24,1700,2200,"Sub-basin 7"
1027,100,1,2300,2400,"Sub-basin 7"
1028,500,77,4900,5400,"Sub-basin 7"
1029,100,3,2400,2500,"Sub-basin 7"
1030,600,43,8600,9200,"Sub-basin 7"
1031,200,4,2100,2300,"Sub-basin 7"
1032,200,2,2800,3000,"Sub-basin 7"
1033,600,19,8700,9300,"Sub-basin 7"
1034,100,1,2500,2600,"Sub-basin 7"
1035,300,9,6000,6300,"Sub-basin 7"
1036,400,18,7600,8000,"Sub-basin 7"
1037,1800,111,11500,13300,"Sub-basin 7"
1038,300,4,2700,3000,"Sub-basin 7"
1039,100,4,1400,1500,"Sub-basin 7"
1040,100,4,1700,1800,"Sub-basin 7"
1041,200,14,1500,1700,"Sub-basin 7"
1042,100,7,1000,1100,"Sub-basin 7"
1043,200,5,2200,2400,"Sub-basin 7"
1044,100,5,1700,1800,"Sub-basin 7"
1045,300,21,1700,2000,"Sub-basin 7"
1046,900,36,4800,5700,"Sub-basin 7"
1047,700,36,3800,4500,"Sub-basin 7"
1048,1400,186,4100,5500,"Sub-basin 7"
1049,900,40,4100,5000,"Sub-basin 7"
1050,200,3,2400,2600,"Sub-basin 7"
1051,200,7,2100,2300,"Sub-basin 7"
1052,100,1,1000,1100,"Sub-basin 7"
1053,500,21,3400,3900,"Sub-basin 7"
1054,1000,79,6700,7700,"Sub-basin 7"
1055,100,1,900,1000,"Sub-basin 7"
1056,400,12,4600,5000,"Sub-basin 7"
1057,3600,318,11600,15200,"Sub-basin 7"
1058,300,7,1200,1500,"Sub-basin 7"
1059,600,41,4000,4600,"Sub-basin 7"
1060,100,1,900,1000,"Sub-basin 7"
1061,100,1,2700,2800,"Sub-basin 7"
1062,200,6,3200,3400,"Sub-basin 7"
1063,100,1,1300,1400,"Sub-basin 7"
1064,400,29,3000,3400,"Sub-basin 7"
1065,200,3,900,1100,"Sub-basin 7"
1066,300,13,2600,2900,"Sub-basin 7"
1067,200,2,4900,5100,"Sub-basin 7"
1068,600,33,10300,10900,"Sub-basin 7"
1069,2600,259,10600,13200,"Sub-basin 7"
1070,200,14,2900,3100,"Sub-basin 7"
1071,300,55.0006,4200,4500,"Sub-basin 7"
1072,100,1.0002,700,800,"Sub-basin 7"
1073,1600,150.0061,12700,14300,"Sub-basin 7"
1074,100,2,1000,1100,"Sub-basin 7"
1075,100,1,700,800,"Sub-basin 7"
1076,200,5,1400,1600,"Sub-basin 7"
1077,4200,1023,36100,40300,"Sub-basin 7"
1078,200,8,4100,4300,"Sub-basin 7"
1079,100,5,1200,1300,"Sub-basin 7"
1080,1100,285,4900,6000,"Sub-basin 7"
1081,2500,593,9800,12300,"Sub-basin 7"
1082,500,13,4600,5100,"Sub-basin 7"
1083,300,10,3400,3700,"Sub-basin 7"
1084,200,9,3400,3600,"Sub-basin 7"
1085,200,4,800,1000,"Sub-basin 7"
1086,600,33,2500,3100,"Sub-basin 7"
1087,500,13,6800,7300,"Sub-basin 7"
1088,100,4,1800,1900,"Sub-basin 7"
1089,100,2,800,900,"Sub-basin 7"
1090,400,32.0014,6200,6600,"Sub-basin 7"
1091,100,4.0002,1200,1300,"Sub-basin 7"
1092,2700,312.0205,28200,30900,"Sub-basin 7"
1093,300,10,2800,3100,"Sub-basin 7"
1094,200,6,2000,2200,"Sub-basin 7"
1095,400,15,9800,10200,"Sub-basin 7"
1096,100,1,2500,2600,"Sub-basin 7"
1097,500,16,2800,3300,"Sub-basin 7"
1098,300,9,2300,2600,"Sub-basin 7"
1099,1200,79,18500,19700,"Sub-basin 7"
1100,3600,465,15700,19300,"Sub-basin 7"
1101,100,1,600,700,"Sub-basin 7"
1102,400,43,2200,2600,"Sub-basin 7"
1103,1000,81,10400,11400,"Sub-basin 7"
1104,300,17,3600,3900,"Sub-basin 7"
1105,100,1,1400,1500,"Sub-basin 7"
1106,100,1,1000,1100,"Sub-basin 7"
1107,900,79,6600,7500,"Sub-basin 7"
1108,300,82.0009,3800,4100,"Sub-basin 7"
1109,3300,468.0161,28000,31300,"Sub-basin 7"
1110,100,2,3100,3200,"Sub-basin 7"
1111,900,52,6000,6900,"Sub-basin 7"
1112,1200,95,3500,4700,"Sub-basin 7"
1113,1200,268,2900,4100,"Sub-basin 7"
1114,4100,1298,7300,11400,"Sub-basin 7"
1115,300,6,7000,7300,"Sub-basin 7"
1116,600,15,9800,10400,"Sub-basin 7"
1117,200,5,1700,1900,"Sub-basin 7"
1118,100,2,2900,3000,"Sub-basin 7"
1119,600,23,5200,5800,"Sub-basin 7"
1120,500,16,6600,7100,"Sub-basin 7"
1121,500,24,4900,5400,"Sub-basin 7"
1122,600,25,5800,6400,"Sub-basin 7"
1123,800,65,9200,10000,"Sub-basin 7"
1124,200,5.0004,2400,2600,"Sub-basin 7"
1125,100,1.0002,2100,2200,"Sub-basin 7"
1126,100,2.0002,1800,1900,"Sub-basin 7"
1127,1000,68.0058,18000,19000,"Sub-basin 7"
1128,200,8.0003,3100,3300,"Sub-basin 7"
1129,400,16.0006,5900,6300,"Sub-basin 7"
1130,600,26,1800,2400,"Sub-basin 7"
1131,100,3,1500,1600,"Sub-basin 7"
1132,300,6,3200,3500,"Sub-basin 7"
1133,900,68,7300,8200,"Sub-basin 7"
1134,600,39,3500,4100,"Sub-basin 7"
1135,400,37,3000,3400,"Sub-basin 7"
1136,100,4,1400,1500,"Sub-basin 7"
1137,500,123,1600,2100,"Sub-basin 7"
1138,200,9,3400,3600,"Sub-basin 7"
1139,1700,69,16500,18200,"Sub-basin 7"
1140,1300,76,6800,8100,"Sub-basin 7"
1141,100,7.0002,2600,2700,"Sub-basin 7"
1142,200,4.0005,2000,2200,"Sub-basin 7"
1143,100,4.0002,1100,1200,"Sub-basin 7"
1144,100,2.0002,800,900,"Sub-basin 7"
1145,1400,103.0027,11400,12800,"Sub-basin 7"
1146,100,3.0002,2100,2200,"Sub-basin 7"
1147,300,5.0015,6700,7000,"Sub-basin 7"
1148,400,15,5800,6200,"Sub-basin 7"
1149,1400,84,11000,12400,"Sub-basin 7"
1150,100,4,600,700,"Sub-basin 7"
1151,100,3.0002,1100,1200,"Sub-basin 7"
1152,1300,71,12300,13600,"Sub-basin 7"
1153,100,2,2100,2200,"Sub-basin 7"
1154,200,61.0005,2900,3100,"Sub-basin 7"
1155,100,5.0002,1000,1100,"Sub-basin 7"
1156,100,2.0002,600,700,"Sub-basin 7"
1157,800,24.0058,8900,9700,"Sub-basin 7"
1158,200,2.0022,3500,3700,"Sub-basin 7"
1159,100,4.0012,1800,1900,"Sub-basin 7"
1160,2100,226.0205,20800,22900,"Sub-basin 7"
1161,100,1,1800,1900,"Sub-basin 7"
1162,300,9,2500,2800,"Sub-basin 7"
1163,100,1,4000,4100,"Sub-basin 7"
1164,100,1,2500,2600,"Sub-basin 7"
1165,400,12,9100,9500,"Sub-basin 7"
1166,100,2,500,600,"Sub-basin 7"
1167,100,1,900,1000,"Sub-basin 7"
1168,1100,211,5300,6400,"Sub-basin 7"
1169,3000,707,12100,15100,"Sub-basin 7"
1170,100,5,1700,1800,"Sub-basin 7"
1171,400,36,5700,6100,"Sub-basin 7"
1172,200,12,3100,3300,"Sub-basin 7"
1173,100,3,2500,2600,"Sub-basin 7"
1174,200,7,3700,3900,"Sub-basin 7"
1175,100,9,500,600,"Sub-basin 7"
1176,100,3,1100,1200,"Sub-basin 7"
1177,100,2,1000,1100,"Sub-basin 7"
1178,200,4,4100,4300,"Sub-basin 7"
1179,100,2.0001,1400,1500,"Sub-basin 7"
1180,100,2.0002,1100,1200,"Sub-basin 7"
1181,26300,5726.9251,222800,249100,"Sub-basin 7"
1182,200,7,3100,3300,"Sub-basin 7"
1183,2700,952,8300,11000,"Sub-basin 7"
1184,400,25,4000,4400,"Sub-basin 7"
1185,200,6,1100,1300,"Sub-basin 7"
1186,600,19,5600,6200,"Sub-basin 7"
1187,500,15,3800,4300,"Sub-basin 7"
1188,2100,137,7400,9500,"Sub-basin 7"
1189,400,36,1700,2100,"Sub-basin 7"
1190,200,6,1000,1200,"Sub-basin 7"
1191,200,4,1200,1400,"Sub-basin 7"
1192,300,16,3500,3800,"Sub-basin 7"
1193,100,3,1600,1700,"Sub-basin 7"
1194,300,3,4600,4900,"Sub-basin 7"
1195,200,4,2300,2500,"Sub-basin 7"
1196,400,20,2000,2400,"Sub-basin 7"
1197,1400,61,8600,10000,"Sub-basin 7"
1198,100,4,900,1000,"Sub-basin 7"
1199,100,5,1200,1300,"Sub-basin 7"
1200,100,4,3000,3100,"Sub-basin 7"
1201,400,12,5800,6200,"Sub-basin 7"
1202,400,17,3400,3800,"Sub-basin 7"
1203,100,2,2500,2600,"Sub-basin 7"
1204,1800,818,8900,10700,"Sub-basin 7"
1205,300,11,2200,2500,"Sub-basin 7"
1206,100,1.0002,1100,1200,"Sub-basin 7"
1207,1000,22,15000,16000,"Sub-basin 7"
1208,400,34,4200,4600,"Sub-basin 7"
1209,500,9,4400,4900,"Sub-basin 7"
1210,400,5,2700,3100,"Sub-basin 7"
1211,500,30,5800,6300,"Sub-basin 7"
1212,700,106,3400,4100,"Sub-basin 7"
1213,1600,111,24800,26400,"Sub-basin 7"
1214,2900,897,1700,4600,"Sub-basin 7"
1215,100,5,900,1000,"Sub-basin 7"
1216,300,7,2400,2700,"Sub-basin 7"
1217,100,2,2300,2400,"Sub-basin 7"
1218,2400,124,15800,18200,"Sub-basin 7"
1219,100,2,1900,2000,"Sub-basin 7"
1220,300,6,2600,2900,"Sub-basin 7"
1221,100,2,1000,1100,"Sub-basin 7"
1222,300,7,4000,4300,"Sub-basin 7"
1223,300,7,4300,4600,"Sub-basin 7"
1224,500,18,6000,6500,"Sub-basin 7"
1225,100,1,500,600,"Sub-basin 7"
1226,600,19,1500,2100,"Sub-basin 7"
1227,1500,89,5800,7300,"Sub-basin 7"
1228,700,39,6700,7400,"Sub-basin 7"
1229,200,8,2400,2600,"Sub-basin 7"
1230,600,47,5000,5600,"Sub-basin 7"
1231,100,3,1400,1500,"Sub-basin 7"
1232,300,6,6200,6500,"Sub-basin 7"
1233,100,2,1400,1500,"Sub-basin 7"
1234,700,40,5100,5800,"Sub-basin 7"
1235,300,19,3200,3500,"Sub-basin 7"
1236,300,13,1800,2100,"Sub-basin 7"
1237,500,68,2700,3200,"Sub-basin 7"
1238,900,82,5100,6000,"Sub-basin 7"
1239,4900,387,38400,43300,"Sub-basin 7"
1240,700,37,4200,4900,"Sub-basin 7"
1241,600,36,5200,5800,"Sub-basin 7"
1242,100,3,1700,1800,"Sub-basin 7"
1243,700,44,2400,3100,"Sub-basin 7"
1244,900,40.0034,7300,8200,"Sub-basin 7"
1245,200,3,2900,3100,"Sub-basin 7"
1246,300,6,4100,4400,"Sub-basin 7"
1247,200,2,3900,4100,"Sub-basin 7"
1248,200,5,1100,1300,"Sub-basin 7"
1249,200,3,900,1100,"Sub-basin 7"
1250,100,1,2900,3000,"Sub-basin 7"
1251,100,4,2400,2500,"Sub-basin 7"
1252,100,2,1000,1100,"Sub-basin 7"
1253,900,51,3900,4800,"Sub-basin 7"
1254,100,2,1300,1400,"Sub-basin 7"
1255,2900,1625,8100,11000,"Sub-basin 7"
1256,600,34,2200,2800,"Sub-basin 7"
1257,200,11,1800,2000,"Sub-basin 7"
1258,1300,165,5300,6600,"Sub-basin 7"
1259,500,14,3000,3500,"Sub-basin 7"
1260,1400,140,10100,11500,"Sub-basin 7"
1261,100,3,1300,1400,"Sub-basin 7"
1262,100,2,700,800,"Sub-basin 7"
1263,700,26,1500,2200,"Sub-basin 7"
1264,200,4,1800,2000,"Sub-basin 7"
1265,100,1,1100,1200,"Sub-basin 7"
1266,100,3,2600,2700,"Sub-basin 7"
1267,100,2,1900,2000,"Sub-basin 7"
1268,100,1,500,600,"Sub-basin 7"
1269,100,3,2800,2900,"Sub-basin 7"
1270,300,6,6700,7000,"Sub-basin 7"
1271,200,3,1200,1400,"Sub-basin 7"
1272,200,6,2500,2700,"Sub-basin 7"
1273,200,3,2900,3100,"Sub-basin 7"
1274,400,14,3900,4300,"Sub-basin 7"
1275,600,18,6000,6600,"Sub-basin 7"
1276,200,10,1700,1900,"Sub-basin 7"
1277,300,15,1800,2100,"Sub-basin 7"
1278,1800,135,16000,17800,"Sub-basin 7"
1279,200,7,2500,2700,"Sub-basin 7"
1280,100,1,1100,1200,"Sub-basin 7"
1281,200,5,1900,2100,"Sub-basin 7"
1282,100,3,1500,1600,"Sub-basin 7"
1283,100,1,1500,1600,"Sub-basin 7"
1284,100,2,1400,1500,"Sub-basin 7"
1285,200,13,1700,1900,"Sub-basin 7"
1286,200,9,2200,2400,"Sub-basin 7"
1287,1800,119,19400,21200,"Sub-basin 7"
1288,200,2,3900,4100,"Sub-basin 7"
1289,200,4,4400,4600,"Sub-basin 7"
1290,200,6,1300,1500,"Sub-basin 7"
1291,400,24,3400,3800,"Sub-basin 7"
1292,200,14,1300,1500,"Sub-basin 7"
1293,200,9,3400,3600,"Sub-basin 7"
1294,100,2,1800,1900,"Sub-basin 7"
1295,100,1,3400,3500,"Sub-basin 7"
1296,1200,89,6400,7600,"Sub-basin 7"
1297,1000,78,6800,7800,"Sub-basin 7"
1298,700,24,1900,2600,"Sub-basin 7"
1299,200,3,2200,2400,"Sub-basin 7"
1300,100,1,1000,1100,"Sub-basin 7"
1301,600,33,4500,5100,"Sub-basin 7"
1302,100,1,1200,1300,"Sub-basin 7"
1303,200,12,2300,2500,"Sub-basin 7"
1304,200,7,800,1000,"Sub-basin 7"
1305,100,5,700,800,"Sub-basin 7"
1306,100,1,2200,2300,"Sub-basin 7"
1307,100,3,2400,2500,"Sub-basin 7"
1308,200,10,2000,2200,"Sub-basin 7"
1309,500,27,3400,3900,"Sub-basin 7"
1310,4000,513,21200,25200,"Sub-basin 7"
1311,300,30,2900,3200,"Sub-basin 7"
1312,200,16,1800,2000,"Sub-basin 7"
1313,700,50,7200,7900,"Sub-basin 7"
1314,600,12,11300,11900,"Sub-basin 7"
1315,700,19,8700,9400,"Sub-basin 7"
1316,100,4,1400,1500,"Sub-basin 7"
1317,500,16,9400,9900,"Sub-basin 7"
1318,300,6,3300,3600,"Sub-basin 7"
1319,200,2,2400,2600,"Sub-basin 7"
1320,200,7,2700,2900,"Sub-basin 7"
1321,200,5,4300,4500,"Sub-basin 7"
1322,200,8,2100,2300,"Sub-basin 7"
1323,300,12,1500,1800,"Sub-basin 7"
1324,1200,171,9300,10500,"Sub-basin 7"
1325,100,1,1400,1500,"Sub-basin 7"
1326,500,58,2500,3000,"Sub-basin 7"
1327,200,4,2900,3100,"Sub-basin 7"
1328,200,12,1700,1900,"Sub-basin 7"
1329,100,4,2900,3000,"Sub-basin 7"
1330,100,2,1300,1400,"Sub-basin 7"
1331,100,3,1900,2000,"Sub-basin 7"
1332,100,1,1600,1700,"Sub-basin 7"
1333,800,40,8800,9600,"Sub-basin 7"
1334,100,5,1300,1400,"Sub-basin 7"
1335,300,15,3200,3500,"Sub-basin 7"
1336,800,36,5600,6400,"Sub-basin 7"
1337,100,2,2700,2800,"Sub-basin 7"
1338,400,8,3600,4000,"Sub-basin 7"
1339,200,3,4400,4600,"Sub-basin 7"
1340,100,1,1400,1500,"Sub-basin 7"
1341,100,3,1000,1100,"Sub-basin 7"
1342,200,4,1300,1500,"Sub-basin 7"
1343,100,1,3100,3200,"Sub-basin 7"
1344,200,2,3200,3400,"Sub-basin 7"
1345,200,3,2000,2200,"Sub-basin 7"
1346,100,2,2000,2100,"Sub-basin 7"
1347,200,5,1400,1600,"Sub-basin 7"
1348,100,1,2000,2100,"Sub-basin 7"
1349,3500,317,20800,24300,"Sub-basin 7"
1350,200,5,1100,1300,"Sub-basin 7"
1351,100,1,2200,2300,"Sub-basin 7"
1352,900,59,8200,9100,"Sub-basin 7"
1353,100,2,1900,2000,"Sub-basin 7"
1354,100,1,3500,3600,"Sub-basin 7"
1355,200,3,1200,1400,"Sub-basin 7"
1356,1600,106,13200,14800,"Sub-basin 7"
1357,100,3,2000,2100,"Sub-basin 7"
1358,1100,162,12600,13700,"Sub-basin 7"
1359,100,2,1600,1700,"Sub-basin 7"
1360,3000,1150,9500,12500,"Sub-basin 7"
1361,700,121,3300,4000,"Sub-basin 7"
1362,900,123,5000,5900,"Sub-basin 7"
1363,3400,331,33200,36600,"Sub-basin 7"
1364,300,9,2700,3000,"Sub-basin 7"
1365,300,10,3400,3700,"Sub-basin 7"
1366,1300,156,7700,9000,"Sub-basin 7"
1367,600,70,10100,10700,"Sub-basin 7"
1368,100,1,1600,1700,"Sub-basin 7"
1369,400,9,3900,4300,"Sub-basin 7"
1370,100,1,2000,2100,"Sub-basin 7"
1371,200,2,2600,2800,"Sub-basin 7"
1372,100,2,1000,1100,"Sub-basin 7"
1373,200,3,3400,3600,"Sub-basin 7"
1374,100,1,2100,2200,"Sub-basin 7"
1375,100,8,600,700,"Sub-basin 7"
1376,800,43,3400,4200,"Sub-basin 7"
1377,200,2,4100,4300,"Sub-basin 7"
1378,300,12,2300,2600,"Sub-basin 7"
1379,500,30,3500,4000,"Sub-basin 7"
1380,100,2,900,1000,"Sub-basin 7"
1381,200,7,3000,3200,"Sub-basin 7"
1382,100,1,1100,1200,"Sub-basin 7"
1383,100,4,1900,2000,"Sub-basin 7"
1384,100,3,2900,3000,"Sub-basin 7"
1385,200,7,900,1100,"Sub-basin 7"
1386,600,15,6600,7200,"Sub-basin 7"
1387,400,21,5500,5900,"Sub-basin 7"
1388,100,1,1600,1700,"Sub-basin 7"
1389,1900,118,10400,12300,"Sub-basin 7"
1390,7500,564,75900,83400,"Sub-basin 7"
1391,900,31,8200,9100,"Sub-basin 7"
1392,100,1,1300,1400,"Sub-basin 7"
1393,2100,653,10100,12200,"Sub-basin 7"
1394,1000,24,11000,12000,"Sub-basin 7"
1395,100,3,1100,1200,"Sub-basin 7"
1396,1500,96,6600,8100,"Sub-basin 7"
1397,100,1,2800,2900,"Sub-basin 7"
1398,200,17,2200,2400,"Sub-basin 7"
1399,900,66,6600,7500,"Sub-basin 7"
1400,300,17,2100,2400,"Sub-basin 7"
1401,700,55,3900,4600,"Sub-basin 7"
1402,1100,101,6600,7700,"Sub-basin 7"
1403,200,3,2500,2700,"Sub-basin 7"
1404,2200,702.0089,20400,22600,"Sub-basin 7"
1405,5200,683,22800,28000,"Sub-basin 7"
1406,100,2,1100,1200,"Sub-basin 7"
1407,500,18,5900,6400,"Sub-basin 7"
1408,100,4,3200,3300,"Sub-basin 7"
1409,100,3,1700,1800,"Sub-basin 7"
1410,1500,85,7300,8800,"Sub-basin 7"
1411,2100,177,16000,18100,"Sub-basin 7"
1412,400,9,3500,3900,"Sub-basin 7"
1413,900,74,7700,8600,"Sub-basin 7"
1414,2800,272,12400,15200,"Sub-basin 7"
1415,500,18,4800,5300,"Sub-basin 7"
1416,5400,3093.6796,7600,13000,"Sub-basin 7"
1417,100,3,1100,1200,"Sub-basin 7"
1418,100,2,1400,1500,"Sub-basin 7"
1419,100,1,2100,2200,"Sub-basin 7"
1420,100,2,1400,1500,"Sub-basin 7"
1421,100,1,1800,1900,"Sub-basin 7"
1422,500,20,3000,3500,"Sub-basin 7"
1423,300,6,2100,2400,"Sub-basin 7"
1424,100,3.0002,1300,1400,"Sub-basin 7"
1425,100,11.0001,1900,2000,"Sub-basin 7"
1426,200,4.0005,3500,3700,"Sub-basin 7"
1427,1100,45,10200,11300,"Sub-basin 7"
1428,300,12,2500,2800,"Sub-basin 7"
1429,6500,1322,58500,65000,"Sub-basin 7"
1430,400,5,6000,6400,"Sub-basin 7"
1431,600,15,10000,10600,"Sub-basin 7"
1432,200,6,2600,2800,"Sub-basin 7"
1433,100,2,1800,1900,"Sub-basin 7"
1434,400,13,5200,5600,"Sub-basin 7"
1435,400,15,4300,4700,"Sub-basin 7"
1436,200,9,3200,3400,"Sub-basin 7"
1437,17400,8598.9446,10100,27500,"Sub-basin 7"
1438,100,1,1300,1400,"Sub-basin 7"
1439,100,4,1700,1800,"Sub-basin 7"
1440,300,5,6500,6800,"Sub-basin 7"
1441,200,3,2900,3100,"Sub-basin 7"
1442,800,55,10100,10900,"Sub-basin 7"
1443,700,18,6600,7300,"Sub-basin 7"
1444,1700,82,15100,16800,"Sub-basin 7"
1445,100,1,1100,1200,"Sub-basin 7"
1446,800,39,3700,4500,"Sub-basin 7"
1447,100,3,1900,2000,"Sub-basin 7"
1448,100,6,600,700,"Sub-basin 7"
1449,6900,560,97600,104500,"Sub-basin 7"
1450,400,11,8400,8800,"Sub-basin 7"
1451,100,1,1500,1600,"Sub-basin 7"
1452,900,48,7000,7900,"Sub-basin 7"
1453,300,6,2600,2900,"Sub-basin 7"
1454,300,8,2200,2500,"Sub-basin 7"
1455,1000,95,7200,8200,"Sub-basin 7"
1456,100,2,400,500,"Sub-basin 7"
1457,100,1,1900,2000,"Sub-basin 7"
1458,200,5,2500,2700,"Sub-basin 7"
1459,500,33,3900,4400,"Sub-basin 7"
1460,100,3,800,900,"Sub-basin 7"
1461,300,10,3200,3500,"Sub-basin 7"
1462,3400,946.0304,36700,40100,"Sub-basin 7"
1463,100,4,900,1000,"Sub-basin 7"
1464,3100,200,28300,31400,"Sub-basin 7"
1465,100,2,600,700,"Sub-basin 7"
1466,100,3,1700,1800,"Sub-basin 7"
1467,1800,58,11800,13600,"Sub-basin 7"
1468,800,56,4600,5400,"Sub-basin 7"
1469,1500,263,13300,14800,"Sub-basin 7"
1470,100,2,900,1000,"Sub-basin 7"
1471,300,9,1100,1400,"Sub-basin 7"
1472,100,4,1300,1400,"Sub-basin 7"
1473,300,14,3800,4100,"Sub-basin 7"
1474,100,1,2200,2300,"Sub-basin 7"
1475,100,2,1000,1100,"Sub-basin 7"
1476,500,17,2300,2800,"Sub-basin 7"
1477,300,26,1900,2200,"Sub-basin 7"
1478,14600,5976,17600,32200,"Sub-basin 7"
1479,400,11,5200,5600,"Sub-basin 7"
1480,200,9,2800,3000,"Sub-basin 7"
1481,500,16,5200,5700,"Sub-basin 7"
1482,600,17,9200,9800,"Sub-basin 7"
1483,1500,64,15100,16600,"Sub-basin 7"
1484,400,7,3400,3800,"Sub-basin 7"
1485,500,19,4200,4700,"Sub-basin 7"
1486,100,3,1300,1400,"Sub-basin 7"
1487,100,1,1300,1400,"Sub-basin 7"
1488,800,40,9500,10300,"Sub-basin 7"
1489,200,8,4000,4200,"Sub-basin 7"
1490,300,7,3600,3900,"Sub-basin 7"
1491,200,4,1700,1900,"Sub-basin 7"
1492,100,2,500,600,"Sub-basin 7"
1493,2300,315,15300,17600,"Sub-basin 7"
1494,1800,455,9900,11700,"Sub-basin 7"
1495,100,3,2500,2600,"Sub-basin 7"
1496,100,1,700,800,"Sub-basin 7"
1497,600,13,5700,6300,"Sub-basin 7"
1498,1800,297,17800,19600,"Sub-basin 7"
1499,6200,3581,16100,22300,"Sub-basin 7"
1500,600,44,6500,7100,"Sub-basin 7"
1501,800,65,4100,4900,"Sub-basin 7"
1502,100,1,1800,1900,"Sub-basin 7"
1503,200,2,1500,1700,"Sub-basin 7"
1504,1000,38,8200,9200,"Sub-basin 7"
1505,4300,533,15600,19900,"Sub-basin 7"
1506,2100,166,12100,14200,"Sub-basin 7"
1507,800,32,5200,6000,"Sub-basin 7"
1508,100,1,1500,1600,"Sub-basin 7"
1509,300,26,1500,1800,"Sub-basin 7"
1510,100,4,1300,1400,"Sub-basin 7"
1511,400,16,5300,5700,"Sub-basin 7"
1512,2300,660,8400,10700,"Sub-basin 7"
1513,100,3,1800,1900,"Sub-basin 7"
1514,100,2,800,900,"Sub-basin 7"
1515,400,14,3300,3700,"Sub-basin 7"
1516,100,2,1500,1600,"Sub-basin 7"
1517,600,14,3500,4100,"Sub-basin 7"
1518,200,9,3400,3600,"Sub-basin 7"
1519,1600,198,14700,16300,"Sub-basin 7"
1520,27000,7128,35500,62500,"Sub-basin 7"
1521,100,4,900,1000,"Sub-basin 7"
1522,400,23,1700,2100,"Sub-basin 7"
1523,500,67,2100,2600,"Sub-basin 7"
1524,1400,72,16300,17700,"Sub-basin 7"
1525,100,1,1400,1500,"Sub-basin 7"
1526,800,85,8300,9100,"Sub-basin 7"
1527,100,6,1400,1500,"Sub-basin 7"
1528,100,2,800,900,"Sub-basin 7"
1529,500,24,7700,8200,"Sub-basin 7"
1530,700,28,9400,10100,"Sub-basin 7"
1531,300,13,8800,9100,"Sub-basin 7"
1532,500,31,2600,3100,"Sub-basin 7"
1533,100,1,800,900,"Sub-basin 7"
1534,400,14,6100,6500,"Sub-basin 7"
1535,100,2,1800,1900,"Sub-basin 7"
1536,6200,1234,11800,18000,"Sub-basin 7"
1537,100,1,500,600,"Sub-basin 7"
1538,200,5,1000,1200,"Sub-basin 7"
1539,400,16,2400,2800,"Sub-basin 7"
1540,800,32,10900,11700,"Sub-basin 7"
1541,400,15,3900,4300,"Sub-basin 7"
1542,100,1,1500,1600,"Sub-basin 7"
1543,100,1,2700,2800,"Sub-basin 7"
1544,1300,247,11100,12400,"Sub-basin 7"
1545,200,7,2200,2400,"Sub-basin 7"
1546,200,6,2300,2500,"Sub-basin 7"
1547,300,4,3700,4000,"Sub-basin 7"
1548,100,1,1400,1500,"Sub-basin 7"
1549,500,19,2800,3300,"Sub-basin 7"
1550,100,1,1300,1400,"Sub-basin 7"
1551,100,2,1700,1800,"Sub-basin 7"
1552,400,13,10600,11000,"Sub-basin 7"
1553,100,1,2000,2100,"Sub-basin 7"
1554,400,16,3000,3400,"Sub-basin 7"
1555,300,5,3600,3900,"Sub-basin 7"
1556,600,24,1200,1800,"Sub-basin 7"
1557,100,2,1100,1200,"Sub-basin 7"
1558,400,64,1300,1700,"Sub-basin 7"
1559,700,29,8100,8800,"Sub-basin 7"
1560,100,1,2300,2400,"Sub-basin 7"
1561,200,4,2800,3000,"Sub-basin 7"
1562,200,7,3600,3800,"Sub-basin 7"
1563,400,9,3900,4300,"Sub-basin 7"
1564,1500,77,11600,13100,"Sub-basin 7"
1565,300,19,4000,4300,"Sub-basin 7"
1566,100,1,1300,1400,"Sub-basin 7"
1567,600,33,8500,9100,"Sub-basin 7"
1568,100,4,1700,1800,"Sub-basin 7"
1569,100,1,1000,1100,"Sub-basin 7"
1570,100,1,1600,1700,"Sub-basin 7"
1571,300,7,1900,2200,"Sub-basin 7"
1572,600,23,5100,5700,"Sub-basin 7"
1573,100,1,2700,2800,"Sub-basin 7"
1574,200,7,2900,3100,"Sub-basin 7"
1575,300,8,5700,6000,"Sub-basin 7"
1576,500,16,5900,6400,"Sub-basin 7"
1577,300,15,4500,4800,"Sub-basin 7"
1578,200,10,4000,4200,"Sub-basin 7"
1579,500,13,5400,5900,"Sub-basin 7"
1580,900,40,11200,12100,"Sub-basin 7"
1581,600,28,5400,6000,"Sub-basin 7"
1582,600,15,4400,5000,"Sub-basin 7"
1583,100,1,1300,1400,"Sub-basin 7"
1584,4600,382,32400,37000,"Sub-basin 7"
1585,100,2,400,500,"Sub-basin 7"
1586,1200,56,8500,9700,"Sub-basin 7"
1587,1000,45,9200,10200,"Sub-basin 7"
1588,1200,102,1300,2500,"Sub-basin 7"
1589,800,35,7400,8200,"Sub-basin 7"
1590,100,3,3100,3200,"Sub-basin 7"
1591,800,51,11100,11900,"Sub-basin 7"
1592,200,14,4300,4500,"Sub-basin 7"
1593,1300,103,11100,12400,"Sub-basin 7"
1594,800,35,10300,11100,"Sub-basin 7"
1595,500,14,1900,2400,"Sub-basin 7"
1596,700,59,4000,4700,"Sub-basin 7"
1597,500,24,4200,4700,"Sub-basin 7"
1598,1500,69,10600,12100,"Sub-basin 7"
1599,200,4,1100,1300,"Sub-basin 7"
1600,300,9,5300,5600,"Sub-basin 7"
1601,200,3,2100,2300,"Sub-basin 7"
1602,1100,104,6400,7500,"Sub-basin 7"
1603,100,3,200,300,"Sub-basin 7"
1604,200,18,1300,1500,"Sub-basin 7"
1605,8500,4324,6400,14900,"Sub-basin 7"
1606,100,1,1500,1600,"Sub-basin 7"
1607,300,12,4000,4300,"Sub-basin 7"
1608,200,3,2600,2800,"Sub-basin 7"
1609,600,22,6200,6800,"Sub-basin 7"
1610,200,5,5500,5700,"Sub-basin 7"
1611,200,12,2700,2900,"Sub-basin 7"
1612,200,26,900,1100,"Sub-basin 7"
1613,100,3,1000,1100,"Sub-basin 7"
1614,200,9,2700,2900,"Sub-basin 7"
1615,900,56,9100,10000,"Sub-basin 7"
1616,200,5,2000,2200,"Sub-basin 7"
1617,500,37,3800,4300,"Sub-basin 7"
1618,100,1,300,400,"Sub-basin 7"
1619,9200,3567,25700,34900,"Sub-basin 7"
1620,800,48,5300,6100,"Sub-basin 7"
1621,600,58,7000,7600,"Sub-basin 7"
1622,300,5,3500,3800,"Sub-basin 7"
1623,2500,443,1200,3700,"Sub-basin 7"
1624,200,3,1700,1900,"Sub-basin 7"
1625,500,46,4700,5200,"Sub-basin 7"
1626,900,134,6600,7500,"Sub-basin 7"
1627,200,12,3100,3300,"Sub-basin 7"
1628,100,1,1700,1800,"Sub-basin 7"
1629,900,93,2500,3400,"Sub-basin 7"
1630,300,4,2200,2500,"Sub-basin 7"
1631,1800,145,11700,13500,"Sub-basin 7"
1632,200,3,3100,3300,"Sub-basin 7"
1633,2700,587,24500,27200,"Sub-basin 7"
1634,100,1,2000,2100,"Sub-basin 7"
1635,200,7,2400,2600,"Sub-basin 7"
1636,800,64,5600,6400,"Sub-basin 7"
1637,200,9,1400,1600,"Sub-basin 7"
1638,200,6,1100,1300,"Sub-basin 7"
1639,2900,504,15400,18300,"Sub-basin 7"
1640,700,9,10100,10800,"Sub-basin 7"
1641,700,175,6100,6800,"Sub-basin 7"
1642,800,97,3800,4600,"Sub-basin 7"
1643,200,6,2500,2700,"Sub-basin 7"
1644,300,31,1700,2000,"Sub-basin 7"
1645,9700,3771,19300,29000,"Sub-basin 7"
1646,300,24,2700,3000,"Sub-basin 7"
1647,100,1,3100,3200,"Sub-basin 7"
1648,200,10,6200,6400,"Sub-basin 7"
1649,100,1,2600,2700,"Sub-basin 7"
1650,500,28,1200,1700,"Sub-basin 7"
1651,200,6,1800,2000,"Sub-basin 7"
1652,8200,2465,30300,38500,"Sub-basin 7"
1653,300,15,2800,3100,"Sub-basin 7"
1654,3300,369,17300,20600,"Sub-basin 7"
1655,1600,140,13300,14900,"Sub-basin 7"
1656,100,1,2900,3000,"Sub-basin 7"
1657,100,1,1800,1900,"Sub-basin 7"
1658,400,43,3200,3600,"Sub-basin 7"
1659,1400,39,9700,11100,"Sub-basin 7"
1660,1300,71,7700,9000,"Sub-basin 7"
1661,300,8,1500,1800,"Sub-basin 7"
1662,500,18,4900,5400,"Sub-basin 7"
1663,100,2,1400,1500,"Sub-basin 7"
1664,4100,870,10300,14400,"Sub-basin 7"
1665,1100,46,12600,13700,"Sub-basin 7"
1666,300,4,4000,4300,"Sub-basin 7"
1667,200,6,2900,3100,"Sub-basin 7"
1668,100,3,1800,1900,"Sub-basin 7"
1669,300,6,2500,2800,"Sub-basin 7"
1670,100,2,1300,1400,"Sub-basin 7"
1671,300,3,3500,3800,"Sub-basin 7"
1672,300,13,4200,4500,"Sub-basin 7"
1673,1800,104,7800,9600,"Sub-basin 7"
1674,200,2,3200,3400,"Sub-basin 7"
1675,400,19,2300,2700,"Sub-basin 7"
1676,400,22,2600,3000,"Sub-basin 7"
1677,600,15,3200,3800,"Sub-basin 7"
1678,200,3,4300,4500,"Sub-basin 7"
1679,100,3,900,1000,"Sub-basin 7"
1680,100,2,3300,3400,"Sub-basin 7"
1681,200,5,3000,3200,"Sub-basin 7"
1682,500,26,6700,7200,"Sub-basin 7"
1683,300,11,4800,5100,"Sub-basin 7"
1684,800,30,7200,8000,"Sub-basin 7"
1685,400,7,4000,4400,"Sub-basin 7"
1686,400,21,4800,5200,"Sub-basin 7"
1687,5000,1770,21800,26800,"Sub-basin 7"
1688,300,9,2600,2900,"Sub-basin 7"
1689,400,6,4500,4900,"Sub-basin 7"
1690,100,1,2000,2100,"Sub-basin 7"
1691,200,2,5300,5500,"Sub-basin 7"
1692,100,1,2100,2200,"Sub-basin 7"
1693,1000,45,13800,14800,"Sub-basin 7"
1694,4700,375,8100,12800,"Sub-basin 7"
1695,370600,146461.68,231600,602200,"Sub-basin 7"
1696,10500,4527,7600,18100,"Sub-basin 7"
1697,400,14,7200,7600,"Sub-basin 7"
1698,600,27,3500,4100,"Sub-basin 7"
1699,600,21,5500,6100,"Sub-basin 7"
1700,1100,43,11800,12900,"Sub-basin 7"
1701,100,1,1100,1200,"Sub-basin 7"
1702,400,16,5300,5700,"Sub-basin 7"
1703,300,8,5000,5300,"Sub-basin 7"
1704,300,9,4100,4400,"Sub-basin 7"
1705,400,15,5500,5900,"Sub-basin 7"
1706,300,8,2500,2800,"Sub-basin 7"
1707,100,1,1300,1400,"Sub-basin 7"
1708,1100,57,12100,13200,"Sub-basin 7"
1709,100,2,1900,2000,"Sub-basin 7"
1710,1600,203,16400,18000,"Sub-basin 7"
1711,2600,420,11600,14200,"Sub-basin 7"
1712,1500,184,7900,9400,"Sub-basin 7"
1713,100,1,2000,2100,"Sub-basin 7"
1714,1200,36,10800,12000,"Sub-basin 7"
1715,1800,75,11900,13700,"Sub-basin 7"
1716,2700,118,14600,17300,"Sub-basin 7"
1717,200,5,2100,2300,"Sub-basin 7"
1718,200,7,3400,3600,"Sub-basin 7"
1719,1000,50,6600,7600,"Sub-basin 7"
1720,3600,389,16900,20500,"Sub-basin 7"
1721,100,1,1500,1600,"Sub-basin 7"
1722,300,14,2400,2700,"Sub-basin 7"
1723,300,14,1900,2200,"Sub-basin 7"
1724,600,64,3100,3700,"Sub-basin 7"
1725,500,15,8600,9100,"Sub-basin 7"
1726,500,16,4200,4700,"Sub-basin 7"
1727,200,4,3200,3400,"Sub-basin 7"
1728,500,31,6800,7300,"Sub-basin 7"
1729,2600,383,19800,22400,"Sub-basin 7"
1730,100,2,900,1000,"Sub-basin 7"
1731,900,41,5900,6800,"Sub-basin 7"
1732,11700,2577,21400,33100,"Sub-basin 7"
1733,700,19,4900,5600,"Sub-basin 7"
1734,200,4,2400,2600,"Sub-basin 7"
1735,500,20,2900,3400,"Sub-basin 7"
1736,200,5,1200,1400,"Sub-basin 7"
1737,100,2,400,500,"Sub-basin 7"
1738,400,17,2500,2900,"Sub-basin 7"
1739,200,2,1500,1700,"Sub-basin 7"
1740,200,7,2900,3100,"Sub-basin 7"
1741,100,1,2900,3000,"Sub-basin 7"
1742,300,11,3200,3500,"Sub-basin 7"
1743,900,31,8300,9200,"Sub-basin 7"
1744,100,1,2300,2400,"Sub-basin 7"
1745,100,1,2000,2100,"Sub-basin 7"
1746,400,6,6100,6500,"Sub-basin 7"
1747,100,1,2600,2700,"Sub-basin 7"
1748,400,13,7700,8100,"Sub-basin 7"
1749,100,1,800,900,"Sub-basin 7"
1750,1700,113,12800,14500,"Sub-basin 7"
1751,200,5,3500,3700,"Sub-basin 7"
1752,100,1,1900,2000,"Sub-basin 7"
1753,100,3,1600,1700,"Sub-basin 7"
1754,400,16,5800,6200,"Sub-basin 7"
1755,500,13,6600,7100,"Sub-basin 7"
1756,100,3,2200,2300,"Sub-basin 7"
1757,300,5,3400,3700,"Sub-basin 7"
1758,400,24,3800,4200,"Sub-basin 7"
1759,100,1,2100,2200,"Sub-basin 7"
1760,400,26,1300,1700,"Sub-basin 7"
1761,100,1,1600,1700,"Sub-basin 7"
1762,1100,87,4800,5900,"Sub-basin 7"
1763,200,6,2800,3000,"Sub-basin 7"
1764,800,70,5900,6700,"Sub-basin 7"
1765,100,3,1100,1200,"Sub-basin 7"
1766,500,26,2800,3300,"Sub-basin 7"
1767,500,18,5900,6400,"Sub-basin 7"
1768,100,1,2400,2500,"Sub-basin 7"
1769,100,1,1100,1200,"Sub-basin 7"
1770,100,2,1200,1300,"Sub-basin 7"
1771,400,48,4100,4500,"Sub-basin 7"
1772,1900,66,14400,16300,"Sub-basin 7"
1773,100,1,700,800,"Sub-basin 7"
1774,100,4,1200,1300,"Sub-basin 7"
1775,500,23,700,1200,"Sub-basin 7"
1776,700,37,10500,11200,"Sub-basin 7"
1777,100,4,2700,2800,"Sub-basin 7"
1778,800,97,12700,13500,"Sub-basin 7"
1779,400,15,1900,2300,"Sub-basin 7"
1780,3000,1231,13600,16600,"Sub-basin 7"
1781,200,2,1800,2000,"Sub-basin 7"
1782,500,20,6100,6600,"Sub-basin 7"
1783,300,3,5000,5300,"Sub-basin 7"
1784,100,2,900,1000,"Sub-basin 7"
1785,1100,36,9700,10800,"Sub-basin 7"
1786,200,5,1200,1400,"Sub-basin 7"
1787,500,42,5700,6200,"Sub-basin 7"
1788,800,36,6900,7700,"Sub-basin 7"
1789,100,1,1300,1400,"Sub-basin 7"
1790,300,23,2700,3000,"Sub-basin 7"
1791,300,13,3600,3900,"Sub-basin 7"
1792,100,1,2300,2400,"Sub-basin 7"
1793,400,11,8000,8400,"Sub-basin 7"
1794,10300,3793,26700,37000,"Sub-basin 7"
1795,13800,1665,62100,75900,"Sub-basin 7"
1796,500,23,4600,5100,"Sub-basin 7"
1797,500,64,6300,6800,"Sub-basin 7"
1798,200,4,3200,3400,"Sub-basin 7"
1799,100,2,1100,1200,"Sub-basin 7"
1800,100,1,1000,1100,"Sub-basin 7"
1801,1300,58,11700,13000,"Sub-basin 7"
1802,100,1,2200,2300,"Sub-basin 7"
1803,600,22,7300,7900,"Sub-basin 7"
1804,200,2,300,500,"Sub-basin 7"
1805,300,6,3800,4100,"Sub-basin 7"
1806,100,1,700,800,"Sub-basin 7"
1807,100,1,1700,1800,"Sub-basin 7"
1808,100,6,1600,1700,"Sub-basin 7"
1809,300,12,8100,8400,"Sub-basin 7"
1810,600,44,4900,5500,"Sub-basin 7"
1811,200,5,2800,3000,"Sub-basin 7"
1812,3400,302.17,25600,29000,"Sub-basin 7"
1813,400,21,4100,4500,"Sub-basin 7"
1814,100,1,1100,1200,"Sub-basin 7"
1815,100,1,1800,1900,"Sub-basin 7"
1816,1500,124,9400,10900,"Sub-basin 7"
1817,100,1,2300,2400,"Sub-basin 7"
1818,400,56.0054,7300,7700,"Sub-basin 7"
1819,100,1,1100,1200,"Sub-basin 7"
1820,300,17,2300,2600,"Sub-basin 7"
1821,800,72,2400,3200,"Sub-basin 7"
1822,7800,1840,41000,48800,"Sub-basin 7"
1823,200,4,2500,2700,"Sub-basin 7"
1824,1800,239,19000,20800,"Sub-basin 7"
1825,100,2,2500,2600,"Sub-basin 7"
1826,1000,52,4300,5300,"Sub-basin 7"
1827,200,4,1500,1700,"Sub-basin 7"
1828,100,1,1700,1800,"Sub-basin 7"
1829,200,5,1800,2000,"Sub-basin 7"
1830,300,11,5600,5900,"Sub-basin 7"
1831,200,14,1800,2000,"Sub-basin 7"
1832,300,7,5900,6200,"Sub-basin 7"
1833,1000,41,6500,7500,"Sub-basin 7"
1834,300,7,3400,3700,"Sub-basin 7"
1835,100,1,2100,2200,"Sub-basin 7"
1836,300,23,2600,2900,"Sub-basin 7"
1837,900,72,5100,6000,"Sub-basin 7"
1838,400,26,4000,4400,"Sub-basin 7"
1839,400,10,6600,7000,"Sub-basin 7"
1840,100,1,1100,1200,"Sub-basin 7"
1841,300,4,4300,4600,"Sub-basin 7"
1842,100,2,2800,2900,"Sub-basin 7"
1843,400,24,4100,4500,"Sub-basin 7"
1844,300,9,2900,3200,"Sub-basin 7"
1845,500,16,3800,4300,"Sub-basin 7"
1846,100,1,1400,1500,"Sub-basin 7"
1847,300,6,4000,4300,"Sub-basin 7"
1848,700,17,8000,8700,"Sub-basin 7"
1849,200,7,4800,5000,"Sub-basin 7"
1850,800,50,7700,8500,"Sub-basin 7"
1851,1300,117,6600,7900,"Sub-basin 7"
1852,1500,75,11400,12900,"Sub-basin 7"
1853,700,77,2400,3100,"Sub-basin 7"
1854,1500,499,2800,4300,"Sub-basin 7"
1855,300,6,9500,9800,"Sub-basin 7"
1856,600,17,5200,5800,"Sub-basin 7"
1857,100,2,1700,1800,"Sub-basin 7"
1858,300,11,4300,4600,"Sub-basin 7"
1859,1900,129,8500,10400,"Sub-basin 7"
1860,100,1,1200,1300,"Sub-basin 7"
1861,400,45,3200,3600,"Sub-basin 7"
1862,400,22,2600,3000,"Sub-basin 7"
1863,200,5,2200,2400,"Sub-basin 7"
1864,2800,852,6500,9300,"Sub-basin 7"
1865,1000,41,15900,16900,"Sub-basin 7"
1866,200,2,2100,2300,"Sub-basin 7"
1867,100,1,1400,1500,"Sub-basin 7"
1868,100,1,1000,1100,"Sub-basin 7"
1869,1000,42,10000,11000,"Sub-basin 7"
1870,300,5,8800,9100,"Sub-basin 7"
1871,1000,51,13300,14300,"Sub-basin 7"
1872,2300,511,10400,12700,"Sub-basin 7"
1873,4800,102,10500,15300,"Sub-basin 7"
1874,100,4,1000,1100,"Sub-basin 7"
1875,100,3,3000,3100,"Sub-basin 7"
1876,300,11,6200,6500,"Sub-basin 7"
1877,100,1,3100,3200,"Sub-basin 7"
1878,100,1,1800,1900,"Sub-basin 7"
1879,200,3,2200,2400,"Sub-basin 7"
1880,100,2,2100,2200,"Sub-basin 7"
1881,100,1,1100,1200,"Sub-basin 7"
1882,900,166.0054,11500,12400,"Sub-basin 7"
1883,400,14,3300,3700,"Sub-basin 7"
1884,300,13,3500,3800,"Sub-basin 7"
1885,7100,965.5,44800,51900,"Sub-basin 7"
1886,100,1,1100,1200,"Sub-basin 7"
1887,500,24,7100,7600,"Sub-basin 7"
1888,500,38,2800,3300,"Sub-basin 7"
1889,300,8,2600,2900,"Sub-basin 7"
1890,300,4,4500,4800,"Sub-basin 7"
1891,200,5,2500,2700,"Sub-basin 7"
1892,1200,136,5400,6600,"Sub-basin 7"
1893,600,154,3700,4300,"Sub-basin 7"
1894,200,4,1800,2000,"Sub-basin 7"
1895,1400,37,16900,18300,"Sub-basin 7"
1896,200,2,6100,6300,"Sub-basin 7"
1897,1700,732,22100,23800,"Sub-basin 7"
1898,100,2,1700,1800,"Sub-basin 7"
1899,100,4,1700,1800,"Sub-basin 7"
1900,400,15,4000,4400,"Sub-basin 7"
1901,100,1,1600,1700,"Sub-basin 7"
1902,800,17,7500,8300,"Sub-basin 7"
1903,100,1,400,500,"Sub-basin 7"
1904,300,8,5500,5800,"Sub-basin 7"
1905,100,2,1500,1600,"Sub-basin 7"
1906,200,2,3200,3400,"Sub-basin 7"
1907,2300,521,6400,8700,"Sub-basin 7"
1908,1200,111,6700,7900,"Sub-basin 7"
1909,600,58,3200,3800,"Sub-basin 7"
1910,3200,281,23100,26300,"Sub-basin 7"
1911,100,1,1200,1300,"Sub-basin 7"
1912,200,3,2200,2400,"Sub-basin 7"
1913,200,3,2200,2400,"Sub-basin 7"
1914,200,6,700,900,"Sub-basin 7"
1915,1400,509,6300,7700,"Sub-basin 7"
1916,100,3,1100,1200,"Sub-basin 7"
1917,100,1,2000,2100,"Sub-basin 7"
1918,100,1,2400,2500,"Sub-basin 7"
1919,700,23,7500,8200,"Sub-basin 7"
1920,1100,43,7300,8400,"Sub-basin 7"
1921,500,22,2300,2800,"Sub-basin 7"
1922,200,147,2300,2500,"Sub-basin 7"
1923,2400,136,12100,14500,"Sub-basin 7"
1924,600,15,5800,6400,"Sub-basin 7"
1925,400,17,5400,5800,"Sub-basin 7"
1926,100,2,1400,1500,"Sub-basin 7"
1927,100,2,1100,1200,"Sub-basin 7"
1928,100,1,2000,2100,"Sub-basin 7"
1929,1000,43,5500,6500,"Sub-basin 7"
1930,100,4,1600,1700,"Sub-basin 7"
1931,900,49,8500,9400,"Sub-basin 7"
1932,900,64,3400,4300,"Sub-basin 7"
1933,1600,516,4300,5900,"Sub-basin 7"
1934,6600,1202,14000,20600,"Sub-basin 7"
1935,400,18,5600,6000,"Sub-basin 7"
1936,400,21,3600,4000,"Sub-basin 7"
1937,100,1,1500,1600,"Sub-basin 7"
1938,1000,110,10400,11400,"Sub-basin 7"
1939,100,1,800,900,"Sub-basin 7"
1940,100,3,1400,1500,"Sub-basin 7"
1941,14700,1953,80500,95200,"Sub-basin 7"
1942,1300,99,6100,7400,"Sub-basin 7"
1943,100,3,3200,3300,"Sub-basin 7"
1944,800,27,2500,3300,"Sub-basin 7"
1945,100,1,1000,1100,"Sub-basin 7"
1946,200,4,2100,2300,"Sub-basin 7"
1947,100,2,2100,2200,"Sub-basin 7"
1948,7300,2724.67,37800,45100,"Sub-basin 7"
1949,300,17,3300,3600,"Sub-basin 7"
1950,1200,82,7200,8400,"Sub-basin 7"
1951,200,3,1600,1800,"Sub-basin 7"
1952,200,4,4000,4200,"Sub-basin 7"
1953,200,3,1800,2000,"Sub-basin 7"
1954,5000,400,43100,48100,"Sub-basin 7"
1955,200,3,4300,4500,"Sub-basin 7"
1956,400,39,2300,2700,"Sub-basin 7"
1957,2000,132.66,8800,10800,"Sub-basin 7"
1958,500,14,3700,4200,"Sub-basin 7"
1959,100,2,2700,2800,"Sub-basin 7"
1960,400,37,2700,3100,"Sub-basin 7"
1961,100,2,1800,1900,"Sub-basin 7"
1962,300,7,4900,5200,"Sub-basin 7"
1963,500,26,2700,3200,"Sub-basin 7"
1964,100,1,1500,1600,"Sub-basin 7"
1965,1000,42,5100,6100,"Sub-basin 7"
1966,200,45,500,700,"Sub-basin 7"
1967,200,5,2800,3000,"Sub-basin 7"
1968,100,1,2700,2800,"Sub-basin 7"
1969,700,21,2800,3500,"Sub-basin 7"
1970,1000,55,8900,9900,"Sub-basin 7"
1971,3100,1114,10700,13800,"Sub-basin 7"
1972,100,11,700,800,"Sub-basin 7"
1973,200,17,1000,1200,"Sub-basin 7"
1974,700,18,4000,4700,"Sub-basin 7"
1975,1300,85,13100,14400,"Sub-basin 7"
1976,200,5,1800,2000,"Sub-basin 7"
1977,400,12,5800,6200,"Sub-basin 7"
1978,1400,290,7400,8800,"Sub-basin 7"
1979,600,28,7600,8200,"Sub-basin 7"
1980,1500,560,1600,3100,"Sub-basin 7"
1981,600,119,2500,3100,"Sub-basin 7"
1982,200,3,2300,2500,"Sub-basin 7"
1983,100,1,1900,2000,"Sub-basin 7"
1984,100,1,3500,3600,"Sub-basin 7"
1985,200,3,6000,6200,"Sub-basin 7"
1986,100,1,900,1000,"Sub-basin 7"
1987,100,1,700,800,"Sub-basin 7"
1988,2100,81,8900,11000,"Sub-basin 7"
1989,800,25,5700,6500,"Sub-basin 7"
1990,100,4,500,600,"Sub-basin 7"
1991,2000,86,19400,21400,"Sub-basin 7"
1992,600,44,6100,6700,"Sub-basin 7"
1993,300,8,3700,4000,"Sub-basin 7"
1994,400,11,6000,6400,"Sub-basin 7"
1995,3900,1642,14700,18600,"Sub-basin 7"
1996,1300,65,11800,13100,"Sub-basin 7"
1997,700,15,8500,9200,"Sub-basin 7"
1998,100,1,900,1000,"Sub-basin 7"
1999,100,2,1800,1900,"Sub-basin 7"
2000,500,51,4800,5300,"Sub-basin 7"
2001,100,4,1400,1500,"Sub-basin 7"
2002,100,1,2700,2800,"Sub-basin 7"
2003,11200,1144,32500,43700,"Sub-basin 7"
2004,100,3,3700,3800,"Sub-basin 7"
2005,11900,2892,62300,74200,"Sub-basin 7"
2006,200,45,1800,2000,"Sub-basin 7"
2007,400,7,1400,1800,"Sub-basin 7"
2008,400,14,6600,7000,"Sub-basin 7"
2009,100,2,600,700,"Sub-basin 7"
2010,300,6,3100,3400,"Sub-basin 7"
2011,100,1,1100,1200,"Sub-basin 7"
2012,1100,324,5400,6500,"Sub-basin 7"
2013,900,119,2600,3500,"Sub-basin 7"
2014,200,2,1400,1600,"Sub-basin 7"
2015,1700,196,19300,21000,"Sub-basin 7"
2016,200,5,3100,3300,"Sub-basin 7"
2017,300,8,4500,4800,"Sub-basin 7"
2018,300,6,4200,4500,"Sub-basin 7"
2019,100,1,800,900,"Sub-basin 7"
2020,100,3,1800,1900,"Sub-basin 7"
2021,100,1,600,700,"Sub-basin 7"
2022,100,1,1800,1900,"Sub-basin 7"
2023,200,9,2400,2600,"Sub-basin 7"
2024,100,2,200,300,"Sub-basin 7"
2025,200,13,2900,3100,"Sub-basin 7"
2026,200,13,3700,3900,"Sub-basin 7"
2027,400,10,3600,4000,"Sub-basin 7"
2028,2600,1262,2200,4800,"Sub-basin 7"
2029,100,2,3700,3800,"Sub-basin 7"
2030,100,1,700,800,"Sub-basin 7"
2031,200,8,2200,2400,"Sub-basin 7"
2032,600,20,1500,2100,"Sub-basin 7"
2033,6000,1595.0946,87100,93100,"Sub-basin 7"
2034,400,12,1400,1800,"Sub-basin 7"
2035,2000,143,13800,15800,"Sub-basin 7"
2036,700,40,4500,5200,"Sub-basin 7"
2037,100,3,2200,2300,"Sub-basin 7"
2038,100,2,2300,2400,"Sub-basin 7"
2039,200,4,2700,2900,"Sub-basin 7"
2040,100,1.0052,1000,1100,"Sub-basin 7"
2041,200,4,2100,2300,"Sub-basin 7"
2042,100,3,1100,1200,"Sub-basin 7"
2043,700,37,5800,6500,"Sub-basin 7"
2044,700,127.33,5200,5900,"Sub-basin 7"
2045,600,21,3700,4300,"Sub-basin 7"
2046,700,44,6300,7000,"Sub-basin 7"
2047,1300,484,1200,2500,"Sub-basin 7"
2048,1200,60,7100,8300,"Sub-basin 7"
2049,200,3,1500,1700,"Sub-basin 7"
2050,100,2,1400,1500,"Sub-basin 7"
2051,100,1,3400,3500,"Sub-basin 7"
2052,100,1,3300,3400,"Sub-basin 7"
2053,9300,2323,59700,69000,"Sub-basin 7"
2054,200,10,2100,2300,"Sub-basin 7"
2055,200,17,2000,2200,"Sub-basin 7"
2056,200,7,2300,2500,"Sub-basin 7"
2057,4100,500,21400,25500,"Sub-basin 7"
2058,400,15,3700,4100,"Sub-basin 7"
2059,100,23,1400,1500,"Sub-basin 7"
2060,400,36,5400,5800,"Sub-basin 7"
2061,600,28,9900,10500,"Sub-basin 7"
2062,100,1,1300,1400,"Sub-basin 7"
2063,800,23,7100,7900,"Sub-basin 7"
2064,300,47,6400,6700,"Sub-basin 7"
2065,700,19,5800,6500,"Sub-basin 7"
2066,40400,14683,44200,84600,"Sub-basin 7"
2067,100,1,1400,1500,"Sub-basin 7"
2068,100,1,3100,3200,"Sub-basin 7"
2069,400,20,12000,12400,"Sub-basin 7"
2070,700,10,10400,11100,"Sub-basin 7"
2071,300,7,2900,3200,"Sub-basin 7"
2072,1200,70,8900,10100,"Sub-basin 7"
2073,400,32,3500,3900,"Sub-basin 7"
2074,200,3,3300,3500,"Sub-basin 7"
2075,8000,1436,29100,37100,"Sub-basin 7"
2076,600,97,1900,2500,"Sub-basin 7"
2077,200,3,2300,2500,"Sub-basin 7"
2078,100,2,500,600,"Sub-basin 7"
2079,100,3,0,100,"Sub-basin 7"
2080,1600,872,1900,3500,"Sub-basin 7"
2081,100,4,3000,3100,"Sub-basin 7"
2082,200,3,4000,4200,"Sub-basin 7"
2083,700,31,6500,7200,"Sub-basin 7"
2084,600,11,4500,5100,"Sub-basin 7"
2085,4800,1908,28200,33000,"Sub-basin 7"
2086,400,32,5500,5900,"Sub-basin 7"
2087,100,7,1500,1600,"Sub-basin 7"
2088,700,21,9600,10300,"Sub-basin 7"
2089,500,91,3500,4000,"Sub-basin 7"
2090,800,31,7700,8500,"Sub-basin 7"
2091,200,5,2300,2500,"Sub-basin 7"
2092,400,11,3900,4300,"Sub-basin 7"
2093,300,15,3900,4200,"Sub-basin 7"
2094,100,4,800,900,"Sub-basin 7"
2095,300,9,3400,3700,"Sub-basin 7"
2096,200,2,900,1100,"Sub-basin 7"
2097,2700,212,17700,20400,"Sub-basin 7"
2098,400,10,3500,3900,"Sub-basin 7"
2099,100,1,600,700,"Sub-basin 7"
2100,2200,122,15300,17500,"Sub-basin 7"
2101,1200,192,6100,7300,"Sub-basin 7"
2102,900,60,6300,7200,"Sub-basin 7"
2103,200,13,2500,2700,"Sub-basin 7"
2104,100,1,1000,1100,"Sub-basin 7"
2105,2500,108,14800,17300,"Sub-basin 7"
2106,100,1,2100,2200,"Sub-basin 7"
2107,100,2,1500,1600,"Sub-basin 7"
2108,200,3,2500,2700,"Sub-basin 7"
2109,400,14,3900,4300,"Sub-basin 7"
2110,400,65,2100,2500,"Sub-basin 7"
2111,100,1,1900,2000,"Sub-basin 7"
2112,1600,61,16600,18200,"Sub-basin 7"
2113,9600,2043,42600,52200,"Sub-basin 7"
2114,100,3,1700,1800,"Sub-basin 7"
2115,100,1,2300,2400,"Sub-basin 7"
2116,100,1,1800,1900,"Sub-basin 7"
2117,3400,1154,10600,14000,"Sub-basin 7"
2118,3400,381,21900,25300,"Sub-basin 7"
2119,300,3,5900,6200,"Sub-basin 7"
2120,400,15,6900,7300,"Sub-basin 7"
2121,400,10,2400,2800,"Sub-basin 7"
2122,100,1,500,600,"Sub-basin 7"
2123,1000,43,6400,7400,"Sub-basin 7"
2124,1400,72,8800,10200,"Sub-basin 7"
2125,100,1,2000,2100,"Sub-basin 7"
2126,2600,149,12600,15200,"Sub-basin 7"
2127,1000,57,14400,15400,"Sub-basin 7"
2128,100,2,2000,2100,"Sub-basin 7"
2129,3200,325,23100,26300,"Sub-basin 7"
2130,100,1,1500,1600,"Sub-basin 7"
2131,100,2,2100,2200,"Sub-basin 7"
2132,200,3,2300,2500,"Sub-basin 7"
2133,500,45,6600,7100,"Sub-basin 7"
2134,1800,80,10100,11900,"Sub-basin 7"
2135,900,23,9000,9900,"Sub-basin 7"
2136,600,28,2800,3400,"Sub-basin 7"
2137,300,6,4300,4600,"Sub-basin 7"
2138,700,19,3500,4200,"Sub-basin 7"
2139,100,1,2100,2200,"Sub-basin 7"
2140,200,3,1500,1700,"Sub-basin 7"
2141,2400,88,17600,20000,"Sub-basin 7"
2142,100,1,1900,2000,"Sub-basin 7"
2143,100,3,1500,1600,"Sub-basin 7"
2144,200,6,2700,2900,"Sub-basin 7"
2145,400,52,2200,2600,"Sub-basin 7"
2146,500,22,2800,3300,"Sub-basin 7"
2147,200,4,3500,3700,"Sub-basin 7"
2148,300,4,3200,3500,"Sub-basin 7"
2149,1600,57,17600,19200,"Sub-basin 7"
2150,2600,78.02,66200,68800,"Sub-basin 7"
2151,200,4,2800,3000,"Sub-basin 7"
2152,200,6,4700,4900,"Sub-basin 7"
2153,100,2,1500,1600,"Sub-basin 7"
2154,100,1,1400,1500,"Sub-basin 7"
2155,100,3,700,800,"Sub-basin 7"
2156,600,19,5800,6400,"Sub-basin 7"
2157,2800,843,9800,12600,"Sub-basin 7"
2158,100,7,1600,1700,"Sub-basin 7"
2159,100,1,1300,1400,"Sub-basin 7"
2160,200,7,2000,2200,"Sub-basin 7"
2161,1000,43,4300,5300,"Sub-basin 7"
2162,1300,73,10900,12200,"Sub-basin 7"
2163,7300,895,50900,58200,"Sub-basin 7"
2164,200,4,4500,4700,"Sub-basin 7"
2165,1200,89,18200,19400,"Sub-basin 7"
2166,700,52,2800,3500,"Sub-basin 7"
2167,500,8,3000,3500,"Sub-basin 7"
2168,100,6,500,600,"Sub-basin 7"
2169,600,45,9800,10400,"Sub-basin 7"
2170,200,5,2800,3000,"Sub-basin 7"
2171,500,10,2900,3400,"Sub-basin 7"
2172,100,2,1600,1700,"Sub-basin 7"
2173,200,4,2500,2700,"Sub-basin 7"
2174,100,1,1800,1900,"Sub-basin 7"
2175,400,16,10300,10700,"Sub-basin 7"
2176,100,2,1700,1800,"Sub-basin 7"
2177,300,11,3700,4000,"Sub-basin 7"
2178,2300,152,15900,18200,"Sub-basin 7"
2179,100,1,900,1000,"Sub-basin 7"
2180,400,23,5600,6000,"Sub-basin 7"
2181,1000,71,14200,15200,"Sub-basin 7"
2182,100,1,1900,2000,"Sub-basin 7"
2183,100,1,500,600,"Sub-basin 7"
2184,1500,96,13400,14900,"Sub-basin 7"
2185,400,22,4300,4700,"Sub-basin 7"
2186,100,2,800,900,"Sub-basin 7"
2187,100,3,1500,1600,"Sub-basin 7"
2188,400,17,2800,3200,"Sub-basin 7"
2189,200,5,2600,2800,"Sub-basin 7"
2190,100,4,1200,1300,"Sub-basin 7"
2191,100,3,800,900,"Sub-basin 7"
2192,100,1,1900,2000,"Sub-basin 7"
2193,100,1,2100,2200,"Sub-basin 7"
2194,200,8,2700,2900,"Sub-basin 7"
2195,11400,3066,25700,37100,"Sub-basin 7"
2196,200,9,6200,6400,"Sub-basin 7"
2197,1500,121,9100,10600,"Sub-basin 7"
2198,800,28,5800,6600,"Sub-basin 7"
2199,2700,173,26200,28900,"Sub-basin 7"
2200,300,4,2300,2600,"Sub-basin 7"
2201,3800,507,8100,11900,"Sub-basin 7"
2202,10300,3328,14700,25000,"Sub-basin 7"
2203,200,8,1200,1400,"Sub-basin 7"
2204,900,51,11300,12200,"Sub-basin 7"
2205,800,92,5700,6500,"Sub-basin 7"
2206,400,13,5900,6300,"Sub-basin 7"
2207,1000,66,3900,4900,"Sub-basin 7"
2208,100,4,1300,1400,"Sub-basin 7"
2209,700,27,9400,10100,"Sub-basin 7"
2210,600,18,6400,7000,"Sub-basin 7"
2211,100,1,600,700,"Sub-basin 7"
2212,400,8,3600,4000,"Sub-basin 7"
2213,600,25,2700,3300,"Sub-basin 7"
2214,200,2,4100,4300,"Sub-basin 7"
2215,100,1,1200,1300,"Sub-basin 7"
2216,100,1,800,900,"Sub-basin 7"
2217,400,33,2800,3200,"Sub-basin 7"
2218,100,5,1000,1100,"Sub-basin 7"
2219,200,9,1400,1600,"Sub-basin 7"
2220,300,64,3300,3600,"Sub-basin 7"
2221,300,6,3900,4200,"Sub-basin 7"
2222,1500,227,6900,8400,"Sub-basin 7"
2223,400,14,3500,3900,"Sub-basin 7"
2224,1400,52,10300,11700,"Sub-basin 7"
2225,700,29,6500,7200,"Sub-basin 7"
2226,400,17,4300,4700,"Sub-basin 7"
2227,500,23,3000,3500,"Sub-basin 7"
2228,600,16,14300,14900,"Sub-basin 7"
2229,100,1,1700,1800,"Sub-basin 7"
2230,500,43,3300,3800,"Sub-basin 7"
2231,100,1,1100,1200,"Sub-basin 7"
2232,800,23,10400,11200,"Sub-basin 7"
2233,100,5,1900,2000,"Sub-basin 7"
2234,100,5.0003,4600,4700,"Sub-basin 7"
2235,100,2,1200,1300,"Sub-basin 7"
2236,500,22,8700,9200,"Sub-basin 7"
2237,600,12,6600,7200,"Sub-basin 7"
2238,100,2,700,800,"Sub-basin 7"
2239,100,1,1400,1500,"Sub-basin 7"
2240,400,27,2900,3300,"Sub-basin 7"
2241,500,50,4000,4500,"Sub-basin 7"
2242,200,7,2400,2600,"Sub-basin 7"
2243,300,10,2800,3100,"Sub-basin 7"
2244,200,2,2000,2200,"Sub-basin 7"
2245,100,3,1300,1400,"Sub-basin 7"
2246,1100,103,6500,7600,"Sub-basin 7"
2247,200,8,1800,2000,"Sub-basin 7"
2248,1600,95,14000,15600,"Sub-basin 7"
2249,100,1,1200,1300,"Sub-basin 7"
2250,100,1.0003,3600,3700,"Sub-basin 7"
2251,200,12.0007,5700,5900,"Sub-basin 7"
2252,100,17.0003,3400,3500,"Sub-basin 7"
2253,100,3.0002,2500,2600,"Sub-basin 7"
2254,300,29,4300,4600,"Sub-basin 7"
2255,100,1,2500,2600,"Sub-basin 7"
2256,200,11,2600,2800,"Sub-basin 7"
2257,100,4,2000,2100,"Sub-basin 7"
2258,400,7,5400,5800,"Sub-basin 7"
2259,600,20,12400,13000,"Sub-basin 7"
2260,1900,1068,9900,11800,"Sub-basin 7"
2261,1000,197,5700,6700,"Sub-basin 7"
2262,500,35,1600,2100,"Sub-basin 7"
2263,800,37,9100,9900,"Sub-basin 7"
2264,800,40,5500,6300,"Sub-basin 7"
2265,200,13.0003,5000,5200,"Sub-basin 7"
2266,100,8.0002,3000,3100,"Sub-basin 7"
2267,400,20,1200,1600,"Sub-basin 7"
2268,100,1,2900,3000,"Sub-basin 7"
2269,500,53,5400,5900,"Sub-basin 7"
2270,200,3,3700,3900,"Sub-basin 7"
2271,200,12,3800,4000,"Sub-basin 7"
2272,100,2,1200,1300,"Sub-basin 7"
2273,100,2,2400,2500,"Sub-basin 7"
2274,500,12,2300,2800,"Sub-basin 7"
2275,200,3,3800,4000,"Sub-basin 7"
2276,1200,116,11300,12500,"Sub-basin 7"
2277,600,22,5900,6500,"Sub-basin 7"
2278,1800,120,14000,15800,"Sub-basin 7"
2279,300,17,2400,2700,"Sub-basin 7"
2280,700,55,5300,6000,"Sub-basin 7"
2281,200,4,3100,3300,"Sub-basin 7"
2282,200,19,1500,1700,"Sub-basin 7"
2283,600,80,5100,5700,"Sub-basin 7"
2284,100,1,4300,4400,"Sub-basin 7"
2285,400,25,2800,3200,"Sub-basin 7"
2286,300,9,3400,3700,"Sub-basin 7"
2287,5300,1089,23100,28400,"Sub-basin 7"
2288,1200,97,11000,12200,"Sub-basin 7"
2289,400,10,8600,9000,"Sub-basin 7"
2290,600,20,3800,4400,"Sub-basin 7"
2291,1300,281.5,7800,9100,"Sub-basin 7"
2292,100,4,1100,1200,"Sub-basin 7"
2293,100,2,800,900,"Sub-basin 7"
2294,600,35,3000,3600,"Sub-basin 7"
2295,100,3,600,700,"Sub-basin 7"
2296,400,16,3000,3400,"Sub-basin 7"
2297,1000,80,6100,7100,"Sub-basin 7"
2298,1000,74,7100,8100,"Sub-basin 7"
2299,500,28,5400,5900,"Sub-basin 7"
2300,1600,207,15800,17400,"Sub-basin 7"
2301,5700,741,62000,67700,"Sub-basin 7"
2302,500,17,5800,6300,"Sub-basin 7"
2303,100,7,1800,1900,"Sub-basin 7"
2304,100,1,3100,3200,"Sub-basin 7"
2305,100,1,1900,2000,"Sub-basin 7"
2306,300,12,4700,5000,"Sub-basin 7"
2307,200,2,3100,3300,"Sub-basin 7"
2308,100,1,1000,1100,"Sub-basin 7"
2309,100,1,1000,1100,"Sub-basin 7"
2310,200,35,2900,3100,"Sub-basin 7"
2311,200,3,2000,2200,"Sub-basin 7"
2312,200,4,5100,5300,"Sub-basin 7"
2313,3200,336,37600,40800,"Sub-basin 7"
2314,1800,173,20300,22100,"Sub-basin 7"
2315,500,18,6400,6900,"Sub-basin 7"
2316,300,7,800,1100,"Sub-basin 7"
2317,100,2,900,1000,"Sub-basin 7"
2318,600,31,5700,6300,"Sub-basin 7"
2319,400,20,5700,6100,"Sub-basin 7"
2320,500,17,6700,7200,"Sub-basin 7"
2321,100,1,2100,2200,"Sub-basin 7"
2322,800,52,5900,6700,"Sub-basin 7"
2323,700,65,2200,2900,"Sub-basin 7"
2324,300,7,1700,2000,"Sub-basin 7"
2325,2300,312,16100,18400,"Sub-basin 7"
2326,200,2,4000,4200,"Sub-basin 7"
2327,100,3.0002,2100,2200,"Sub-basin 7"
2328,200,4,3500,3700,"Sub-basin 7"
2329,200,12,2400,2600,"Sub-basin 7"
2330,100,2,1100,1200,"Sub-basin 7"
2331,900,74,14200,15100,"Sub-basin 7"
2332,300,8,3200,3500,"Sub-basin 7"
2333,200,4,2500,2700,"Sub-basin 7"
2334,5700,2352,16800,22500,"Sub-basin 7"
2335,400,7,5100,5500,"Sub-basin 7"
2336,500,9,2500,3000,"Sub-basin 7"
2337,100,1,1800,1900,"Sub-basin 7"
2338,1100,138,1600,2700,"Sub-basin 7"
2339,600,57,2800,3400,"Sub-basin 7"
2340,400,12,4500,4900,"Sub-basin 7"
2341,100,1,1700,1800,"Sub-basin 7"
2342,100,1,900,1000,"Sub-basin 7"
2343,100,2,1300,1400,"Sub-basin 7"
2344,200,11,3900,4100,"Sub-basin 7"
2345,100,2,1600,1700,"Sub-basin 7"
2346,100,2,1200,1300,"Sub-basin 7"
2347,3700,861,21100,24800,"Sub-basin 7"
2348,200,6,400,600,"Sub-basin 7"
2349,500,20,6700,7200,"Sub-basin 7"
2350,100,1,900,1000,"Sub-basin 7"
2351,500,19,6300,6800,"Sub-basin 7"
2352,800,41,4600,5400,"Sub-basin 7"
2353,3000,359,14600,17600,"Sub-basin 7"
2354,1700,52,16100,17800,"Sub-basin 7"
2355,600,50.002,7600,8200,"Sub-basin 7"
2356,100,9,1500,1600,"Sub-basin 7"
2357,300,15,3800,4100,"Sub-basin 7"
2358,400,15,7300,7700,"Sub-basin 7"
2359,700,58,4400,5100,"Sub-basin 7"
2360,400,42,7500,7900,"Sub-basin 7"
2361,100,1,2200,2300,"Sub-basin 7"
2362,200,8,2400,2600,"Sub-basin 7"
2363,500,16,6600,7100,"Sub-basin 7"
2364,1300,71,10100,11400,"Sub-basin 7"
2365,200,8,3100,3300,"Sub-basin 7"
2366,1000,35,16000,17000,"Sub-basin 7"
2367,100,1,1200,1300,"Sub-basin 7"
2368,100,4,2100,2200,"Sub-basin 7"
2369,3500,668,15200,18700,"Sub-basin 7"
2370,100,2,700,800,"Sub-basin 7"
2371,1300,160,2800,4100,"Sub-basin 7"
2372,1700,160,3300,5000,"Sub-basin 7"
2373,2700,442,6100,8800,"Sub-basin 7"
2374,300,10,1800,2100,"Sub-basin 7"
2375,200,13,600,800,"Sub-basin 7"
2376,100,1,2700,2800,"Sub-basin 7"
2377,100,5,900,1000,"Sub-basin 7"
2378,100,1,600,700,"Sub-basin 7"
2379,100,3,1500,1600,"Sub-basin 7"
2380,2200,234,32000,34200,"Sub-basin 7"
2381,800,55,7400,8200,"Sub-basin 7"
2382,100,3,1600,1700,"Sub-basin 7"
2383,100,2,2300,2400,"Sub-basin 7"
2384,700,21,8300,9000,"Sub-basin 7"
2385,2900,942,5700,8600,"Sub-basin 7"
2386,500,19,2500,3000,"Sub-basin 7"
2387,6400,2464,21700,28100,"Sub-basin 7"
2388,600,43,3300,3900,"Sub-basin 7"
2389,800,40,1700,2500,"Sub-basin 7"
2390,19900,11650.7321,24700,44600,"Sub-basin 7"
2391,500,28,5300,5800,"Sub-basin 7"
2392,100,1,1600,1700,"Sub-basin 7"
2393,400,79,1700,2100,"Sub-basin 7"
2394,300,6,3100,3400,"Sub-basin 7"
2395,1600,94,13200,14800,"Sub-basin 7"
2396,100,1,300,400,"Sub-basin 7"
2397,800,29,9100,9900,"Sub-basin 7"
2398,600,51,5100,5700,"Sub-basin 7"
2399,500,23,7500,8000,"Sub-basin 7"
2400,300,12,3700,4000,"Sub-basin 7"
2401,100,4,2700,2800,"Sub-basin 7"
2402,1400,97,12400,13800,"Sub-basin 7"
2403,300,13,2500,2800,"Sub-basin 7"
2404,1500,57,19500,21000,"Sub-basin 7"
2405,100,1,1500,1600,"Sub-basin 7"
2406,600,42,2300,2900,"Sub-basin 7"
2407,300,19.0015,6500,6800,"Sub-basin 7"
2408,900,26.0035,13400,14300,"Sub-basin 7"
2409,600,25,5300,5900,"Sub-basin 7"
2410,700,34,8100,8800,"Sub-basin 7"
2411,200,2,1800,2000,"Sub-basin 7"
2412,200,3,1100,1300,"Sub-basin 7"
2413,400,16,2800,3200,"Sub-basin 7"
2414,100,1,1700,1800,"Sub-basin 7"
2415,3300,232,22600,25900,"Sub-basin 7"
2416,300,8,3400,3700,"Sub-basin 7"
2417,200,4,3300,3500,"Sub-basin 7"
2418,600,53,6000,6600,"Sub-basin 7"
2419,48100,20089,76900,125000,"Sub-basin 7"
2420,2300,253,18400,20700,"Sub-basin 7"
2421,100,1.0003,3600,3700,"Sub-basin 7"
2422,500,29,8500,9000,"Sub-basin 7"
2423,100,1.0003,1400,1500,"Sub-basin 7"
2424,300,8.0012,4100,4400,"Sub-basin 7"
2425,100,1.0008,1900,2000,"Sub-basin 7"
2426,500,26.0034,11000,11500,"Sub-basin 7"
2427,100,2,2000,2100,"Sub-basin 7"
2428,200,7,1300,1500,"Sub-basin 7"
2429,100,1,1300,1400,"Sub-basin 7"
2430,300,6,2000,2300,"Sub-basin 7"
2431,200,7,2100,2300,"Sub-basin 7"
2432,400,14,2700,3100,"Sub-basin 7"
2433,100,2,2200,2300,"Sub-basin 7"
2434,300,9,5000,5300,"Sub-basin 7"
2435,600,13,5100,5700,"Sub-basin 7"
2436,100,1,400,500,"Sub-basin 7"
2437,100,1,1800,1900,"Sub-basin 7"
2438,4200,795,12100,16300,"Sub-basin 7"
2439,200,4,2300,2500,"Sub-basin 7"
2440,1600,47,20800,22400,"Sub-basin 7"
2441,200,6,1200,1400,"Sub-basin 7"
2442,1400,198,23400,24800,"Sub-basin 7"
2443,3200,251.0655,62700,65900,"Sub-basin 7"
2444,100,2,1900,2000,"Sub-basin 7"
2445,200,3,2200,2400,"Sub-basin 7"
2446,700,41,8600,9300,"Sub-basin 7"
2447,600,27,7800,8400,"Sub-basin 7"
2448,100,1,200,300,"Sub-basin 7"
2449,100,2,600,700,"Sub-basin 7"
2450,1600,251,15400,17000,"Sub-basin 7"
2451,900,60,7400,8300,"Sub-basin 7"
2452,1300,172,6700,8000,"Sub-basin 7"
2453,400,21,3700,4100,"Sub-basin 7"
2454,100,1,1800,1900,"Sub-basin 7"
2455,200,7,600,800,"Sub-basin 7"
2456,200,7,3700,3900,"Sub-basin 7"
2457,1300,85.0136,31700,33000,"Sub-basin 7"
2458,100,3.0003,3000,3100,"Sub-basin 7"
2459,200,5.001,6000,6200,"Sub-basin 7"
2460,1300,63,7700,9000,"Sub-basin 7"
2461,400,7,3400,3800,"Sub-basin 7"
2462,400,25,2400,2800,"Sub-basin 7"
2463,300,9,4200,4500,"Sub-basin 7"
2464,300,10,3400,3700,"Sub-basin 7"
2465,300,7,2900,3200,"Sub-basin 7"
2466,700,163,3400,4100,"Sub-basin 7"
2467,300,13,3000,3300,"Sub-basin 7"
2468,600,474,5700,6300,"Sub-basin 7"
2469,400,27,1600,2000,"Sub-basin 7"
2470,200,4,1600,1800,"Sub-basin 7"
2471,600,22,5800,6400,"Sub-basin 7"
2472,300,8,4700,5000,"Sub-basin 7"
2473,200,2,4100,4300,"Sub-basin 7"
2474,600,56.0031,18000,18600,"Sub-basin 7"
2475,100,2.0003,3900,4000,"Sub-basin 7"
2476,400,11.0018,7000,7400,"Sub-basin 7"
2477,900,41,11800,12700,"Sub-basin 7"
2478,1400,93,15100,16500,"Sub-basin 7"
2479,400,47,6000,6400,"Sub-basin 7"
2480,300,21,4500,4800,"Sub-basin 7"
2481,200,4,2300,2500,"Sub-basin 7"
2482,200,12,1400,1600,"Sub-basin 7"
2483,400,39,2600,3000,"Sub-basin 7"
2484,600,18,13900,14500,"Sub-basin 7"
2485,100,2,1200,1300,"Sub-basin 7"
2486,700,46,8900,9600,"Sub-basin 7"
2487,1600,204,2500,4100,"Sub-basin 7"
2488,600,58,2200,2800,"Sub-basin 7"
2489,600,44,2800,3400,"Sub-basin 7"
2490,1600,109,5200,6800,"Sub-basin 7"
2491,100,1,3100,3200,"Sub-basin 7"
2492,600,50,6000,6600,"Sub-basin 7"
2493,5800,1597.1562,81100,86900,"Sub-basin 7"
2494,100,1,1300,1400,"Sub-basin 7"
2495,300,5,3300,3600,"Sub-basin 7"
2496,100,1,1800,1900,"Sub-basin 7"
2497,200,7,3800,4000,"Sub-basin 7"
2498,200,15,2100,2300,"Sub-basin 7"
2499,100,2,1100,1200,"Sub-basin 7"
2500,100,1,2500,2600,"Sub-basin 7"
2501,1200,37,7900,9100,"Sub-basin 7"
2502,100,3,1400,1500,"Sub-basin 7"
2503,100,1.0004,4500,4600,"Sub-basin 7"
2504,300,8,1400,1700,"Sub-basin 7"
2505,100,20,1400,1500,"Sub-basin 7"
2506,100,2,1000,1100,"Sub-basin 7"
2507,1300,155,8600,9900,"Sub-basin 7"
2508,3600,435,12200,15800,"Sub-basin 7"
2509,200,4,1900,2100,"Sub-basin 7"
2510,300,30,1200,1500,"Sub-basin 7"
2511,200,2,5300,5500,"Sub-basin 7"
2512,100,2,1900,2000,"Sub-basin 7"
2513,800,42,5000,5800,"Sub-basin 7"
2514,700,44,3400,4100,"Sub-basin 7"
2515,300,4,5000,5300,"Sub-basin 7"
2516,100,1,700,800,"Sub-basin 7"
2517,1100,129,4800,5900,"Sub-basin 7"
2518,300,9,4500,4800,"Sub-basin 7"
2519,100,2,1400,1500,"Sub-basin 7"
2520,200,9,2200,2400,"Sub-basin 7"
2521,100,1,1200,1300,"Sub-basin 7"
2522,5700,1749,8600,14300,"Sub-basin 7"
2523,900,54,1800,2700,"Sub-basin 7"
2524,100,13,1000,1100,"Sub-basin 7"
2525,100,2,1700,1800,"Sub-basin 7"
2526,300,12,2200,2500,"Sub-basin 7"
2527,200,11,3300,3500,"Sub-basin 7"
2528,100,1,900,1000,"Sub-basin 7"
2529,100,1,1300,1400,"Sub-basin 7"
2530,100,1,1700,1800,"Sub-basin 7"
2531,100,2,700,800,"Sub-basin 7"
2532,700,74,3300,4000,"Sub-basin 7"
2533,100,2,1600,1700,"Sub-basin 7"
2534,300,10,4300,4600,"Sub-basin 7"
2535,100,4,2000,2100,"Sub-basin 7"
2536,100,3,1900,2000,"Sub-basin 7"
2537,100,1,2000,2100,"Sub-basin 7"
2538,100,5,500,600,"Sub-basin 7"
2539,100,1.0004,3000,3100,"Sub-basin 7"
2540,100,6,2500,2600,"Sub-basin 7"
2541,100,2,1400,1500,"Sub-basin 7"
2542,200,4,4900,5100,"Sub-basin 7"
2543,200,11,3900,4100,"Sub-basin 7"
2544,100,2,1600,1700,"Sub-basin 7"
2545,900,53,3700,4600,"Sub-basin 7"
2546,400,16,3700,4100,"Sub-basin 7"
2547,100,3,1800,1900,"Sub-basin 7"
2548,600,30,5200,5800,"Sub-basin 7"
2549,500,23,1400,1900,"Sub-basin 7"
2550,900,99,3900,4800,"Sub-basin 7"
2551,3600,213,10000,13600,"Sub-basin 7"
2552,300,8,4900,5200,"Sub-basin 7"
2553,500,35,9100,9600,"Sub-basin 7"
2554,100,1,2000,2100,"Sub-basin 7"
2555,300,13,2200,2500,"Sub-basin 7"
2556,200,18,1700,1900,"Sub-basin 7"
2557,100,4,1400,1500,"Sub-basin 7"
2558,200,6,2600,2800,"Sub-basin 7"
2559,200,10,1500,1700,"Sub-basin 7"
2560,100,1,600,700,"Sub-basin 7"
2561,300,23,4800,5100,"Sub-basin 7"
2562,100,2,1800,1900,"Sub-basin 7"
2563,2300,201,14100,16400,"Sub-basin 7"
2564,2600,632,8000,10600,"Sub-basin 7"
2565,300,11,5100,5400,"Sub-basin 7"
2566,500,22,4900,5400,"Sub-basin 7"
2567,400,21,3500,3900,"Sub-basin 7"
2568,100,5,2000,2100,"Sub-basin 7"
2569,200,4,1800,2000,"Sub-basin 7"
2570,200,5,1100,1300,"Sub-basin 7"
2571,1200,158,5900,7100,"Sub-basin 7"
2572,600,26,3000,3600,"Sub-basin 7"
2573,100,3,1300,1400,"Sub-basin 7"
2574,2800,268,16400,19200,"Sub-basin 7"
2575,100,2,1000,1100,"Sub-basin 7"
2576,200,10,1900,2100,"Sub-basin 7"
2577,800,53,7900,8700,"Sub-basin 7"
2578,100,1,1400,1500,"Sub-basin 7"
2579,100,2,1100,1200,"Sub-basin 7"
2580,9500,1494,72800,82300,"Sub-basin 7"
2581,200,4,1800,2000,"Sub-basin 7"
2582,600,18,7100,7700,"Sub-basin 7"
2583,400,9,1400,1800,"Sub-basin 7"
2584,300,8,3300,3600,"Sub-basin 7"
2585,500,43,2600,3100,"Sub-basin 7"
2586,400,17,1500,1900,"Sub-basin 7"
2587,300,4,4900,5200,"Sub-basin 7"
2588,100,1,2000,2100,"Sub-basin 7"
2589,500,22,4900,5400,"Sub-basin 7"
2590,400,17,2500,2900,"Sub-basin 7"
2591,100,3,1000,1100,"Sub-basin 7"
2592,400,20,3600,4000,"Sub-basin 7"
2593,200,9,2100,2300,"Sub-basin 7"
2594,300,6,5300,5600,"Sub-basin 7"
2595,1300,88,5800,7100,"Sub-basin 7"
2596,1600,127,10500,12100,"Sub-basin 7"
2597,4700,485,29500,34200,"Sub-basin 7"
2598,2400,158,11700,14100,"Sub-basin 7"
2599,1000,88,1400,2400,"Sub-basin 7"
2600,200,29,1500,1700,"Sub-basin 7"
2601,100,2.0002,3100,3200,"Sub-basin 7"
2602,500,14,6300,6800,"Sub-basin 7"
2603,200,3,1400,1600,"Sub-basin 7"
2604,300,13,3800,4100,"Sub-basin 7"
2605,300,4,3400,3700,"Sub-basin 7"
2606,100,1,1300,1400,"Sub-basin 7"
2607,1100,71,10900,12000,"Sub-basin 7"
2608,200,4,2700,2900,"Sub-basin 7"
2609,300,15,6900,7200,"Sub-basin 7"
2610,600,36,1700,2300,"Sub-basin 7"
2611,1500,188,5900,7400,"Sub-basin 7"
2612,600,20,2300,2900,"Sub-basin 7"
2613,600,23,8800,9400,"Sub-basin 7"
2614,400,4,3500,3900,"Sub-basin 7"
2615,1000,253,16500,17500,"Sub-basin 7"
2616,600,32,5400,6000,"Sub-basin 7"
2617,100,2,2200,2300,"Sub-basin 7"
2618,1900,143,7000,8900,"Sub-basin 7"
2619,100,1,2000,2100,"Sub-basin 7"
2620,100,2,1300,1400,"Sub-basin 7"
2621,200,4,1900,2100,"Sub-basin 7"
2622,100,3,400,500,"Sub-basin 7"
2623,300,7,1700,2000,"Sub-basin 7"
2624,100,2,1300,1400,"Sub-basin 7"
2625,100,1,800,900,"Sub-basin 7"
2626,200,2,2300,2500,"Sub-basin 7"
2627,100,1,2100,2200,"Sub-basin 7"
2628,8400,4954,13100,21500,"Sub-basin 7"
2629,400,29,2400,2800,"Sub-basin 7"
2630,200,12,1300,1500,"Sub-basin 7"
2631,3300,573,30800,34100,"Sub-basin 7"
2632,100,4,1200,1300,"Sub-basin 7"
2633,200,5,1900,2100,"Sub-basin 7"
2634,200,8,1100,1300,"Sub-basin 7"
2635,600,23,5400,6000,"Sub-basin 7"
2636,100,2,1600,1700,"Sub-basin 7"
2637,100,4,1200,1300,"Sub-basin 7"
2638,100,1,400,500,"Sub-basin 7"
2639,200,39,3200,3400,"Sub-basin 7"
2640,600,14,7700,8300,"Sub-basin 7"
2641,100,1,1700,1800,"Sub-basin 7"
2642,500,19,2600,3100,"Sub-basin 7"
2643,4700,585,30500,35200,"Sub-basin 7"
2644,2400,455,16900,19300,"Sub-basin 7"
2645,100,1,2800,2900,"Sub-basin 7"
2646,200,7,1300,1500,"Sub-basin 7"
2647,200,6,900,1100,"Sub-basin 7"
2648,2100,148,5900,8000,"Sub-basin 7"
2649,100,2,2100,2200,"Sub-basin 7"
2650,100,2,2000,2100,"Sub-basin 7"
2651,100,3,2400,2500,"Sub-basin 7"
2652,200,2,4000,4200,"Sub-basin 7"
2653,300,8,300,600,"Sub-basin 7"
2654,300,7,900,1200,"Sub-basin 7"
2655,1000,56,2600,3600,"Sub-basin 7"
2656,100,1.0003,4400,4500,"Sub-basin 7"
2657,500,44,7100,7600,"Sub-basin 7"
2658,1400,88,19700,21100,"Sub-basin 7"
2659,100,1,3200,3300,"Sub-basin 7"
2660,200,6,3800,4000,"Sub-basin 7"
2661,100,1,2600,2700,"Sub-basin 7"
2662,1100,99,14500,15600,"Sub-basin 7"
2663,100,1,1100,1200,"Sub-basin 7"
2664,1000,46,8200,9200,"Sub-basin 7"
2665,800,31,8300,9100,"Sub-basin 7"
2666,300,7,3500,3800,"Sub-basin 7"
2667,10400,2261,61900,72300,"Sub-basin 7"
2668,600,15,5700,6300,"Sub-basin 7"
2669,600,25,2000,2600,"Sub-basin 7"
2670,2500,456,3000,5500,"Sub-basin 7"
2671,2300,307,9700,12000,"Sub-basin 7"
2672,100,2,2700,2800,"Sub-basin 7"
2673,100,3,3200,3300,"Sub-basin 7"
2674,800,127.0025,8600,9400,"Sub-basin 7"
2675,100,1,600,700,"Sub-basin 7"
2676,100,2,1600,1700,"Sub-basin 7"
2677,200,6,3000,3200,"Sub-basin 7"
2678,1000,88,15300,16300,"Sub-basin 7"
2679,100,2,1800,1900,"Sub-basin 7"
2680,100,1,700,800,"Sub-basin 7"
2681,300,11,2500,2800,"Sub-basin 7"
2682,100,3,700,800,"Sub-basin 7"
2683,200,4,1500,1700,"Sub-basin 7"
2684,700,73,3500,4200,"Sub-basin 7"
2685,200,11,3100,3300,"Sub-basin 7"
2686,100,5,1400,1500,"Sub-basin 7"
2687,100,1,1900,2000,"Sub-basin 7"
2688,100,3,1700,1800,"Sub-basin 7"
2689,200,2,1000,1200,"Sub-basin 7"
2690,600,30,4300,4900,"Sub-basin 7"
2691,100,1,2200,2300,"Sub-basin 7"
2692,100,2,1300,1400,"Sub-basin 7"
2693,300,15,700,1000,"Sub-basin 7"
2694,12100,1720,17800,29900,"Sub-basin 7"
2695,100,3,1400,1500,"Sub-basin 7"
2696,100,1,900,1000,"Sub-basin 7"
2697,200,5,2400,2600,"Sub-basin 7"
2698,100,1,600,700,"Sub-basin 7"
2699,100,2,1200,1300,"Sub-basin 7"
2700,900,182,7700,8600,"Sub-basin 7"
2701,400,7,3800,4200,"Sub-basin 7"
2702,500,31,3200,3700,"Sub-basin 7"
2703,300,9,2300,2600,"Sub-basin 7"
2704,100,1,1600,1700,"Sub-basin 7"
2705,500,50,3100,3600,"Sub-basin 7"
2706,300,41.0173,6100,6400,"Sub-basin 7"
2707,1100,76,3200,4300,"Sub-basin 7"
2708,3100,389,15400,18500,"Sub-basin 7"
2709,500,34,6100,6600,"Sub-basin 7"
2710,100,1.0003,2800,2900,"Sub-basin 7"
2711,700,35,8400,9100,"Sub-basin 7"
2712,600,84,8700,9300,"Sub-basin 7"
2713,200,4,2100,2300,"Sub-basin 7"
2714,200,3,2700,2900,"Sub-basin 7"
2715,300,8,3400,3700,"Sub-basin 7"
2716,900,95,3500,4400,"Sub-basin 7"
2717,600,58,5200,5800,"Sub-basin 7"
2718,500,29,3200,3700,"Sub-basin 7"
2719,600,59,2000,2600,"Sub-basin 7"
2720,2000,199,13700,15700,"Sub-basin 7"
2721,1800,1366,7800,9600,"Sub-basin 7"
2722,1200,125,13400,14600,"Sub-basin 7"
2723,100,2,1800,1900,"Sub-basin 7"
2724,400,55,2100,2500,"Sub-basin 7"
2725,200,8,3400,3600,"Sub-basin 7"
2726,100,3,1300,1400,"Sub-basin 7"
2727,200,9,2500,2700,"Sub-basin 7"
2728,600,35,8200,8800,"Sub-basin 7"
2729,100,2,1200,1300,"Sub-basin 7"
2730,200,5,3900,4100,"Sub-basin 7"
2731,500,35,8200,8700,"Sub-basin 7"
2732,800,17,9600,10400,"Sub-basin 7"
2733,100,2,2900,3000,"Sub-basin 7"
2734,100,1.0002,2100,2200,"Sub-basin 7"
2735,500,19,2800,3300,"Sub-basin 7"
2736,200,2,1000,1200,"Sub-basin 7"
2737,400,11,8100,8500,"Sub-basin 7"
2738,700,26,4800,5500,"Sub-basin 7"
2739,100,4,1900,2000,"Sub-basin 7"
2740,500,45,2300,2800,"Sub-basin 7"
2741,500,16,6200,6700,"Sub-basin 7"
2742,1800,179,10100,11900,"Sub-basin 7"
2743,100,1,1900,2000,"Sub-basin 7"
2744,400,15,900,1300,"Sub-basin 7"
2745,700,31,5100,5800,"Sub-basin 7"
2746,2400,725,12700,15100,"Sub-basin 7"
2747,200,10,4700,4900,"Sub-basin 7"
2748,400,13,4400,4800,"Sub-basin 7"
2749,200,8,3200,3400,"Sub-basin 7"
2750,73500,46575,119500,193000,"Sub-basin 7"
2751,100,3,2800,2900,"Sub-basin 7"
2752,700,16,11100,11800,"Sub-basin 7"
2753,1300,73,5700,7000,"Sub-basin 7"
2754,800,66,7100,7900,"Sub-basin 7"
2755,900,67,10600,11500,"Sub-basin 7"
2756,100,2,1400,1500,"Sub-basin 7"
2757,200,7,2100,2300,"Sub-basin 7"
2758,3600,243,28700,32300,"Sub-basin 7"
2759,300,9,4400,4700,"Sub-basin 7"
2760,1300,65,11400,12700,"Sub-basin 7"
2761,400,26.0232,6800,7200,"Sub-basin 7"
2762,100,1,1800,1900,"Sub-basin 7"
2763,600,22,4300,4900,"Sub-basin 7"
2764,400,24,3600,4000,"Sub-basin 7"
2765,500,18,900,1400,"Sub-basin 7"
2766,100,3.0003,4900,5000,"Sub-basin 7"
2767,700,50,7700,8400,"Sub-basin 7"
2768,200,3.0005,2900,3100,"Sub-basin 7"
2769,100,3,1800,1900,"Sub-basin 7"
2770,5700,1389,59500,65200,"Sub-basin 7"
2771,1300,174,8600,9900,"Sub-basin 7"
2772,900,36,6100,7000,"Sub-basin 7"
2773,200,2,3300,3500,"Sub-basin 7"
2774,900,79,5700,6600,"Sub-basin 7"
2775,200,6,2500,2700,"Sub-basin 7"
2776,200,4,2400,2600,"Sub-basin 7"
2777,800,49,15800,16600,"Sub-basin 7"
2778,100,1,4200,4300,"Sub-basin 7"
2779,100,4,1400,1500,"Sub-basin 7"
2780,200,8,2500,2700,"Sub-basin 7"
2781,100,1,1200,1300,"Sub-basin 7"
2782,300,13,3100,3400,"Sub-basin 7"
2783,300,19,1900,2200,"Sub-basin 7"
2784,600,51,5000,5600,"Sub-basin 7"
2785,900,66,4400,5300,"Sub-basin 7"
2786,400,16,4100,4500,"Sub-basin 7"
2787,600,43,3700,4300,"Sub-basin 7"
2788,1500,187,6300,7800,"Sub-basin 7"
2789,1400,138,7600,9000,"Sub-basin 7"
2790,300,9,1100,1400,"Sub-basin 7"
2791,200,4,1100,1300,"Sub-basin 7"
2792,100,1,1700,1800,"Sub-basin 7"
2793,100,1,3200,3300,"Sub-basin 7"
2794,200,3,2500,2700,"Sub-basin 7"
2795,900,74,5000,5900,"Sub-basin 7"
2796,100,2,2500,2600,"Sub-basin 7"
2797,400,13,6400,6800,"Sub-basin 7"
2798,700,93,2800,3500,"Sub-basin 7"
2799,100,1,700,800,"Sub-basin 7"
2800,100,8,700,800,"Sub-basin 7"
2801,200,10,2000,2200,"Sub-basin 7"
2802,400,22,4400,4800,"Sub-basin 7"
2803,200,4,1200,1400,"Sub-basin 7"
2804,100,1,4600,4700,"Sub-basin 7"
2805,100,1,1800,1900,"Sub-basin 7"
2806,100,1,2200,2300,"Sub-basin 7"
2807,35100,17786.3311,38400,73500,"Sub-basin 7"
2808,200,14,2600,2800,"Sub-basin 7"
2809,200,8,2000,2200,"Sub-basin 7"
2810,600,47,2200,2800,"Sub-basin 7"
2811,100,1,1400,1500,"Sub-basin 7"
2812,600,33,7600,8200,"Sub-basin 7"
2813,300,7,2300,2600,"Sub-basin 7"
2814,800,71,5500,6300,"Sub-basin 7"
2815,2100,242,6400,8500,"Sub-basin 7"
2816,500,27,2300,2800,"Sub-basin 7"
2817,700,88,5100,5800,"Sub-basin 7"
2818,200,10,4100,4300,"Sub-basin 7"
2819,200,5,5600,5800,"Sub-basin 7"
2820,100,3,2000,2100,"Sub-basin 7"
2821,100,1,3100,3200,"Sub-basin 7"
2822,200,7,2000,2200,"Sub-basin 7"
2823,300,11,2600,2900,"Sub-basin 7"
2824,400,17,1100,1500,"Sub-basin 7"
2825,1800,160,6200,8000,"Sub-basin 7"
2826,100,2,600,700,"Sub-basin 7"
2827,1200,56,3100,4300,"Sub-basin 7"
2828,18600,8077,18700,37300,"Sub-basin 7"
2829,400,6,2900,3300,"Sub-basin 7"
2830,300,10,3600,3900,"Sub-basin 7"
2831,100,3,2300,2400,"Sub-basin 7"
2832,100,3,2200,2300,"Sub-basin 7"
2833,900,140,3000,3900,"Sub-basin 7"
2834,600,17,4300,4900,"Sub-basin 7"
2835,100,6,700,800,"Sub-basin 7"
2836,600,26,4400,5000,"Sub-basin 7"
2837,400,26,2300,2700,"Sub-basin 7"
2838,100,1,2200,2300,"Sub-basin 7"
2839,300,6,3300,3600,"Sub-basin 7"
2840,2800,476,14600,17400,"Sub-basin 7"
2841,300,57,2900,3200,"Sub-basin 7"
2842,200,2,7000,7200,"Sub-basin 7"
2843,5500,887,32400,37900,"Sub-basin 7"
2844,200,8,2500,2700,"Sub-basin 7"
2845,2100,996,17800,19900,"Sub-basin 7"
2846,7900,1756,68300,76200,"Sub-basin 7"
2847,4300,415.66,15100,19400,"Sub-basin 7"
2848,2000,186,8800,10800,"Sub-basin 7"
2849,1400,82,7400,8800,"Sub-basin 7"
2850,3800,809,18300,22100,"Sub-basin 7"
2851,500,20,4700,5200,"Sub-basin 7"
2852,100,3,600,700,"Sub-basin 7"
2853,100,3,1200,1300,"Sub-basin 7"
2854,3400,1354,24100,27500,"Sub-basin 7"
2855,200,8.0009,13300,13500,"Sub-basin 7"
2856,400,8,8600,9000,"Sub-basin 7"
2857,100,1,3500,3600,"Sub-basin 7"
2858,400,15,3800,4200,"Sub-basin 7"
2859,100,1,2000,2100,"Sub-basin 7"
2860,4500,357,38400,42900,"Sub-basin 7"
2861,300,17,4600,4900,"Sub-basin 7"
2862,1300,127,9600,10900,"Sub-basin 7"
2863,100,4,2000,2100,"Sub-basin 7"
2864,100,2,1200,1300,"Sub-basin 7"
2865,1600,188,15000,16600,"Sub-basin 7"
2866,100,1,1200,1300,"Sub-basin 7"
2867,500,17,2000,2500,"Sub-basin 7"
2868,500,29,2100,2600,"Sub-basin 7"
2869,3500,345,4400,7900,"Sub-basin 7"
2870,400,6,3000,3400,"Sub-basin 7"
2871,200,12,1700,1900,"Sub-basin 7"
2872,1500,125,3500,5000,"Sub-basin 7"
2873,2400,517,14300,16700,"Sub-basin 7"
2874,400,5,6900,7300,"Sub-basin 7"
2875,300,5,6300,6600,"Sub-basin 7"
2876,100,1,1100,1200,"Sub-basin 7"
2877,200,9,3000,3200,"Sub-basin 7"
2878,100,3,1600,1700,"Sub-basin 7"
2879,100,2,1400,1500,"Sub-basin 7"
2880,3500,302,32700,36200,"Sub-basin 7"
2881,600,20,6100,6700,"Sub-basin 7"
2882,2100,94,8000,10100,"Sub-basin 7"
2883,2100,254,3900,6000,"Sub-basin 7"
2884,1200,108,9300,10500,"Sub-basin 7"
2885,400,12,1600,2000,"Sub-basin 7"
2886,100,2,1000,1100,"Sub-basin 7"
2887,800,56,12100,12900,"Sub-basin 7"
2888,700,47,5600,6300,"Sub-basin 7"
2889,700,73,5500,6200,"Sub-basin 7"
2890,200,7,2100,2300,"Sub-basin 7"
2891,800,75,3400,4200,"Sub-basin 7"
2892,600,20,1500,2100,"Sub-basin 7"
2893,100,2,1900,2000,"Sub-basin 7"
2894,300,9,5300,5600,"Sub-basin 7"
2895,900,308,3200,4100,"Sub-basin 7"
2896,200,3,3800,4000,"Sub-basin 7"
2897,100,1,500,600,"Sub-basin 7"
2898,200,4,3400,3600,"Sub-basin 7"
2899,300,24,3200,3500,"Sub-basin 7"
2900,2800,228,18500,21300,"Sub-basin 7"
2901,400,10,3000,3400,"Sub-basin 7"
2902,2800,205,38200,41000,"Sub-basin 7"
2903,300,27,2200,2500,"Sub-basin 7"
2904,600,27,3400,4000,"Sub-basin 7"
2905,400,34,1400,1800,"Sub-basin 7"
2906,100,2,500,600,"Sub-basin 7"
2907,400,31,2600,3000,"Sub-basin 7"
2908,100,3,900,1000,"Sub-basin 7"
2909,200,7,1800,2000,"Sub-basin 7"
2910,200,3,2600,2800,"Sub-basin 7"
2911,1200,79,7000,8200,"Sub-basin 7"
2912,200,3,2300,2500,"Sub-basin 7"
2913,300,18,3500,3800,"Sub-basin 7"
2914,200,4,1700,1900,"Sub-basin 7"
2915,400,8,2500,2900,"Sub-basin 7"
2916,400,9,3200,3600,"Sub-basin 7"
2917,1100,120,6700,7800,"Sub-basin 7"
2918,500,11,2300,2800,"Sub-basin 7"
2919,1300,108,4700,6000,"Sub-basin 7"
2920,3000,422,8700,11700,"Sub-basin 7"
2921,700,27,1300,2000,"Sub-basin 7"
2922,200,2,5400,5600,"Sub-basin 7"
2923,1100,112,4100,5200,"Sub-basin 7"
2924,200,2,2400,2600,"Sub-basin 7"
2925,200,3,3300,3500,"Sub-basin 7"
2926,1500,119,2900,4400,"Sub-basin 7"
2927,900,90,3000,3900,"Sub-basin 7"
2928,100,1,1200,1300,"Sub-basin 7"
2929,500,12,1600,2100,"Sub-basin 7"
2930,300,6,800,1100,"Sub-basin 7"
2931,300,5,1700,2000,"Sub-basin 7"
2932,1200,102,2900,4100,"Sub-basin 7"
2933,1100,175,3000,4100,"Sub-basin 7"
2934,13600,6556.5512,10300,23900,"Sub-basin 7"
2935,100,2,500,600,"Sub-basin 7"
2936,600,11.0009,22500,23100,"Sub-basin 7"
2937,400,9,10900,11300,"Sub-basin 7"
2938,100,2,2100,2200,"Sub-basin 7"
2939,500,20,4600,5100,"Sub-basin 7"
2940,900,36,10900,11800,"Sub-basin 7"
2941,200,5,2600,2800,"Sub-basin 7"
2942,900,38,4500,5400,"Sub-basin 7"
2943,200,10,2700,2900,"Sub-basin 7"
2944,700,28,4300,5000,"Sub-basin 7"
2945,100,1,600,700,"Sub-basin 7"
2946,300,16,3400,3700,"Sub-basin 7"
2947,2500,297,5600,8100,"Sub-basin 7"
2948,2600,154,7900,10500,"Sub-basin 7"
2949,500,13,1800,2300,"Sub-basin 7"
2950,1300,134,3900,5200,"Sub-basin 7"
2951,200,4,3500,3700,"Sub-basin 7"
2952,100,2,1000,1100,"Sub-basin 7"
2953,200,9,1900,2100,"Sub-basin 7"
2954,1700,120,7200,8900,"Sub-basin 7"
2955,100,4,1100,1200,"Sub-basin 7"
2956,300,12,500,800,"Sub-basin 7"
2957,1300,129,4900,6200,"Sub-basin 7"
2958,400,26,2100,2500,"Sub-basin 7"
2959,1500,107,4200,5700,"Sub-basin 7"
2960,800,59,4000,4800,"Sub-basin 7"
2961,100,2,1600,1700,"Sub-basin 7"
2962,300,8,4700,5000,"Sub-basin 7"
2963,5100,556,24000,29100,"Sub-basin 7"
2964,200,14,2200,2400,"Sub-basin 7"
2965,400,7,2500,2900,"Sub-basin 7"
2966,600,12,2500,3100,"Sub-basin 7"
2967,2400,279,13100,15500,"Sub-basin 7"
2968,200,4,1400,1600,"Sub-basin 7"
2969,200,6,1400,1600,"Sub-basin 7"
2970,200,6,3300,3500,"Sub-basin 7"
2971,400,23,4000,4400,"Sub-basin 7"
2972,400,21,4000,4400,"Sub-basin 7"
2973,300,20,2100,2400,"Sub-basin 7"
2974,300,11,1400,1700,"Sub-basin 7"
2975,100,2,1700,1800,"Sub-basin 7"
2976,200,6,1000,1200,"Sub-basin 7"
2977,900,67,7200,8100,"Sub-basin 7"
2978,500,36,1700,2200,"Sub-basin 7"
2979,600,42,2500,3100,"Sub-basin 7"
2980,300,13,3000,3300,"Sub-basin 7"
2981,400,16,2200,2600,"Sub-basin 7"
2982,14600,6421,20600,35200,"Sub-basin 7"
2983,500,20,6700,7200,"Sub-basin 7"
2984,100,1,1900,2000,"Sub-basin 7"
2985,100,1,500,600,"Sub-basin 7"
2986,200,8,4000,4200,"Sub-basin 7"
2987,100,2,1000,1100,"Sub-basin 7"
2988,500,27,5500,6000,"Sub-basin 7"
2989,300,10,3000,3300,"Sub-basin 7"
2990,100,1,1600,1700,"Sub-basin 7"
2991,1000,66,5500,6500,"Sub-basin 7"
2992,400,22,3800,4200,"Sub-basin 7"
2993,1500,74,14500,16000,"Sub-basin 7"
2994,100,1,1500,1600,"Sub-basin 7"
2995,400,14,2900,3300,"Sub-basin 7"
2996,200,5,2100,2300,"Sub-basin 7"
2997,800,73,2800,3600,"Sub-basin 7"
2998,200,4,3600,3800,"Sub-basin 7"
2999,100,2,2600,2700,"Sub-basin 7"
3000,800,33,4900,5700,"Sub-basin 7"
3001,100,3,2000,2100,"Sub-basin 7"
3002,100,1,1800,1900,"Sub-basin 7"
3003,1100,53,6000,7100,"Sub-basin 7"
3004,900,143,2900,3800,"Sub-basin 7"
3005,600,30,5700,6300,"Sub-basin 7"
3006,1000,56,6600,7600,"Sub-basin 7"
3007,800,45,3000,3800,"Sub-basin 7"
3008,1600,84,5000,6600,"Sub-basin 7"
3009,300,5,3700,4000,"Sub-basin 7"
3010,600,37,2800,3400,"Sub-basin 7"
3011,1200,137,4500,5700,"Sub-basin 7"
3012,700,34,2800,3500,"Sub-basin 7"
3013,400,31,1500,1900,"Sub-basin 7"
3014,200,7,1900,2100,"Sub-basin 7"
3015,400,12,1900,2300,"Sub-basin 7"
3016,200,6,1500,1700,"Sub-basin 7"
3017,100,1.0002,4800,4900,"Sub-basin 7"
3018,3700,599,16800,20500,"Sub-basin 7"
3019,200,7,3200,3400,"Sub-basin 7"
3020,300,20,3500,3800,"Sub-basin 7"
3021,2400,314,9600,12000,"Sub-basin 7"
3022,500,21,8100,8600,"Sub-basin 7"
3023,100,2,2500,2600,"Sub-basin 7"
3024,100,3,700,800,"Sub-basin 7"
3025,2000,231,5700,7700,"Sub-basin 7"
3026,300,7,1100,1400,"Sub-basin 7"
3027,2500,195,13400,15900,"Sub-basin 7"
3028,100,1,800,900,"Sub-basin 7"
3029,2400,136,7900,10300,"Sub-basin 7"
3030,200,3,10500,10700,"Sub-basin 7"
3031,400,9,3700,4100,"Sub-basin 7"
3032,100,2,1600,1700,"Sub-basin 7"
3033,1100,64,4700,5800,"Sub-basin 7"
3034,1000,35,14400,15400,"Sub-basin 7"
3035,200,8,1000,1200,"Sub-basin 7"
3036,300,13,1500,1800,"Sub-basin 7"
3037,200,3,2300,2500,"Sub-basin 7"
3038,100,2.0001,5000,5100,"Sub-basin 7"
3039,200,3,2100,2300,"Sub-basin 7"
3040,100,4,1400,1500,"Sub-basin 7"
3041,200,3,3200,3400,"Sub-basin 7"
3042,100,4,2800,2900,"Sub-basin 7"
3043,500,13,7800,8300,"Sub-basin 7"
3044,200,6,2400,2600,"Sub-basin 7"
3045,300,15,4700,5000,"Sub-basin 7"
3046,100,2,1100,1200,"Sub-basin 7"
3047,400,25,1400,1800,"Sub-basin 7"
3048,600,16,7600,8200,"Sub-basin 7"
3049,100,3,1000,1100,"Sub-basin 7"
3050,200,11,1400,1600,"Sub-basin 7"
3051,700,91,6300,7000,"Sub-basin 7"
3052,1300,45,7300,8600,"Sub-basin 7"
3053,100,1,1000,1100,"Sub-basin 7"
3054,800,32,6200,7000,"Sub-basin 7"
3055,300,10,2200,2500,"Sub-basin 7"
3056,1100,46,3400,4500,"Sub-basin 7"
3057,300,6,800,1100,"Sub-basin 7"
3058,24000,8650,53000,77000,"Sub-basin 7"
3059,1300,311,20700,22000,"Sub-basin 7"
3060,200,5,2600,2800,"Sub-basin 7"
3061,300,4,4600,4900,"Sub-basin 7"
3062,700,53,9600,10300,"Sub-basin 7"
3063,600,15,4400,5000,"Sub-basin 7"
3064,400,12,8400,8800,"Sub-basin 7"
3065,100,4,2200,2300,"Sub-basin 7"
3066,100,1,1900,2000,"Sub-basin 7"
3067,400,15,3300,3700,"Sub-basin 7"
3068,100,7,2300,2400,"Sub-basin 7"
3069,1400,59,4400,5800,"Sub-basin 7"
3070,3600,229,13800,17400,"Sub-basin 7"
3071,600,31,4600,5200,"Sub-basin 7"
3072,400,10,400,800,"Sub-basin 7"
3073,400,16,600,1000,"Sub-basin 7"
3074,300,4,2200,2500,"Sub-basin 7"
3075,1500,43,7100,8600,"Sub-basin 7"
3076,200,4,2600,2800,"Sub-basin 7"
3077,200,5,1400,1600,"Sub-basin 7"
3078,300,9,4200,4500,"Sub-basin 7"
3079,1200,52,5100,6300,"Sub-basin 7"
3080,1600,77,5400,7000,"Sub-basin 7"
3081,200,5,1700,1900,"Sub-basin 7"
3082,100,2,2300,2400,"Sub-basin 7"
3083,800,63,4500,5300,"Sub-basin 7"
3084,100,3,800,900,"Sub-basin 7"
3085,400,11,7200,7600,"Sub-basin 7"
3086,500,14,7600,8100,"Sub-basin 7"
3087,100,1,1700,1800,"Sub-basin 7"
3088,100,2,2400,2500,"Sub-basin 7"
3089,100,1,2300,2400,"Sub-basin 7"
3090,400,13,6500,6900,"Sub-basin 7"
3091,200,9,1300,1500,"Sub-basin 7"
3092,400,18,1200,1600,"Sub-basin 7"
3093,7600,3154,27000,34600,"Sub-basin 7"
3094,100,7,1300,1400,"Sub-basin 7"
3095,200,5,5600,5800,"Sub-basin 7"
3096,200,3,3200,3400,"Sub-basin 7"
3097,300,8,2900,3200,"Sub-basin 7"
3098,100,1,2200,2300,"Sub-basin 7"
3099,200,5,3200,3400,"Sub-basin 7"
3100,100,1,1800,1900,"Sub-basin 7"
3101,100,1,3000,3100,"Sub-basin 7"
3102,100,1,1700,1800,"Sub-basin 7"
3103,400,32,1900,2300,"Sub-basin 7"
3104,800,44,4600,5400,"Sub-basin 7"
3105,100,1,1300,1400,"Sub-basin 7"
3106,100,1,1700,1800,"Sub-basin 7"
3107,500,111,1100,1600,"Sub-basin 7"
3108,100,1,700,800,"Sub-basin 7"
3109,2100,381,8500,10600,"Sub-basin 7"
3110,100,1,1200,1300,"Sub-basin 7"
3111,100,3,2000,2100,"Sub-basin 7"
3112,400,8,6600,7000,"Sub-basin 7"
3113,300,25,3900,4200,"Sub-basin 7"
3114,1800,104,16200,18000,"Sub-basin 7"
3115,1300,152,5200,6500,"Sub-basin 7"
3116,500,28,1300,1800,"Sub-basin 7"
3117,600,55,1900,2500,"Sub-basin 7"
3118,3900,863,6700,10600,"Sub-basin 7"
3119,2200,503,3900,6100,"Sub-basin 7"
3120,1200,155,10300,11500,"Sub-basin 7"
3121,800,28,5800,6600,"Sub-basin 7"
3122,900,54,12200,13100,"Sub-basin 7"
3123,1200,159,4200,5400,"Sub-basin 7"
3124,200,2,1300,1500,"Sub-basin 7"
3125,100,4,2000,2100,"Sub-basin 7"
3126,900,97,5700,6600,"Sub-basin 7"
3127,300,19,3300,3600,"Sub-basin 7"
3128,300,7,3400,3700,"Sub-basin 7"
3129,1500,176,5100,6600,"Sub-basin 7"
3130,900,49,7200,8100,"Sub-basin 7"
3131,500,31,4000,4500,"Sub-basin 7"
3132,300,16,1300,1600,"Sub-basin 7"
3133,600,78,3300,3900,"Sub-basin 7"
3134,200,5,1500,1700,"Sub-basin 7"
3135,100,2,2000,2100,"Sub-basin 7"
3136,200,4,2700,2900,"Sub-basin 7"
3137,200,2,3800,4000,"Sub-basin 7"
3138,100,6,1700,1800,"Sub-basin 7"
3139,300,61,3400,3700,"Sub-basin 7"
3140,100,5,2400,2500,"Sub-basin 7"
3141,300,5,4300,4600,"Sub-basin 7"
3142,300,8,1500,1800,"Sub-basin 7"
3143,600,33,8300,8900,"Sub-basin 7"
3144,1100,67,5900,7000,"Sub-basin 7"
3145,400,28,1100,1500,"Sub-basin 7"
3146,600,34,3200,3800,"Sub-basin 7"
3147,3300,451,11700,15000,"Sub-basin 7"
3148,500,31,1000,1500,"Sub-basin 7"
3149,133100,48769.2303,292800,425900,"Sub-basin 7"
3150,1400,283,2000,3400,"Sub-basin 7"
3151,200,3.0007,7300,7500,"Sub-basin 7"
3152,2100,130,10100,12200,"Sub-basin 7"
3153,100,2,2200,2300,"Sub-basin 7"
3154,100,1,1200,1300,"Sub-basin 7"
3155,300,18,2100,2400,"Sub-basin 7"
3156,100,1,600,700,"Sub-basin 7"
3157,100,6,800,900,"Sub-basin 7"
3158,100,1,700,800,"Sub-basin 7"
3159,800,28,6700,7500,"Sub-basin 7"
3160,600,29,3100,3700,"Sub-basin 7"
3161,1200,60,6700,7900,"Sub-basin 7"
3162,100,1,4800,4900,"Sub-basin 7"
3163,300,8,5400,5700,"Sub-basin 7"
3164,300,31,4900,5200,"Sub-basin 7"
3165,600,32,8500,9100,"Sub-basin 7"
3166,400,17,5700,6100,"Sub-basin 7"
3167,300,10,2600,2900,"Sub-basin 7"
3168,200,5,3800,4000,"Sub-basin 7"
3169,1400,95,4500,5900,"Sub-basin 7"
3170,1300,109,4900,6200,"Sub-basin 7"
3171,1100,135,4200,5300,"Sub-basin 7"
3172,5700,1094,12100,17800,"Sub-basin 7"
3173,400,45,3400,3800,"Sub-basin 7"
3174,100,27,600,700,"Sub-basin 7"
3175,400,12,3200,3600,"Sub-basin 7"
3176,100,1,1600,1700,"Sub-basin 7"
3177,200,5,2800,3000,"Sub-basin 7"
3178,500,25,4400,4900,"Sub-basin 7"
3179,200,9,2400,2600,"Sub-basin 7"
3180,2900,192,10900,13800,"Sub-basin 7"
3181,1000,69,5700,6700,"Sub-basin 7"
3182,500,9,6100,6600,"Sub-basin 7"
3183,100,2,800,900,"Sub-basin 7"
3184,600,18,9200,9800,"Sub-basin 7"
3185,300,7.0004,12000,12300,"Sub-basin 7"
3186,3100,1047,19200,22300,"Sub-basin 7"
3187,100,1,2600,2700,"Sub-basin 7"
3188,100,1,1200,1300,"Sub-basin 7"
3189,100,3,1800,1900,"Sub-basin 7"
3190,100,1,1600,1700,"Sub-basin 7"
3191,100,1,1100,1200,"Sub-basin 7"
3192,900,74,5900,6800,"Sub-basin 7"
3193,1500,119,11700,13200,"Sub-basin 7"
3194,2500,162,15400,17900,"Sub-basin 7"
3195,1700,153,8400,10100,"Sub-basin 7"
3196,200,10,1400,1600,"Sub-basin 7"
3197,15000,4461.67,26300,41300,"Sub-basin 7"
3198,600,69,1700,2300,"Sub-basin 7"
3199,100,2,2000,2100,"Sub-basin 7"
3200,100,2,1700,1800,"Sub-basin 7"
3201,100,2,1400,1500,"Sub-basin 7"
3202,100,1,500,600,"Sub-basin 7"
3203,900,99,4600,5500,"Sub-basin 7"
3204,100,4,1500,1600,"Sub-basin 7"
3205,1200,84,4400,5600,"Sub-basin 7"
3206,1300,62,4700,6000,"Sub-basin 7"
3207,200,2,2200,2400,"Sub-basin 7"
3208,2200,749,4200,6400,"Sub-basin 7"
3209,400,23,800,1200,"Sub-basin 7"
3210,200,8,5100,5300,"Sub-basin 7"
3211,900,36,12500,13400,"Sub-basin 7"
3212,100,2,1500,1600,"Sub-basin 7"
3213,300,11,3400,3700,"Sub-basin 7"
3214,200,6,3700,3900,"Sub-basin 7"
3215,200,8,2300,2500,"Sub-basin 7"
3216,700,18,7600,8300,"Sub-basin 7"
3217,200,2,1800,2000,"Sub-basin 7"
3218,100,2,3100,3200,"Sub-basin 7"
3219,100,3,1100,1200,"Sub-basin 7"
3220,200,10,500,700,"Sub-basin 7"
3221,1100,274,3900,5000,"Sub-basin 7"
3222,500,46,2700,3200,"Sub-basin 7"
3223,100,2,900,1000,"Sub-basin 7"
3224,400,15,4100,4500,"Sub-basin 7"
3225,100,1,2400,2500,"Sub-basin 7"
3226,100,2,2300,2400,"Sub-basin 7"
3227,900,29,9900,10800,"Sub-basin 7"
3228,5700,555,15400,21100,"Sub-basin 7"
3229,1100,150,2200,3300,"Sub-basin 7"
3230,100,6,1700,1800,"Sub-basin 7"
3231,100,3,2800,2900,"Sub-basin 7"
3232,800,47,3600,4400,"Sub-basin 7"
3233,200,5,2200,2400,"Sub-basin 7"
3234,500,15,5900,6400,"Sub-basin 7"
3235,500,20,5200,5700,"Sub-basin 7"
3236,1400,96,14200,15600,"Sub-basin 7"
3237,200,7,2600,2800,"Sub-basin 7"
3238,1200,82,6600,7800,"Sub-basin 7"
3239,100,2,2200,2300,"Sub-basin 7"
3240,100,2,2900,3000,"Sub-basin 7"
3241,100,2,1400,1500,"Sub-basin 7"
3242,200,2,2000,2200,"Sub-basin 7"
3243,600,68,1500,2100,"Sub-basin 7"
3244,12200,5363,23200,35400,"Sub-basin 7"
3245,100,3,500,600,"Sub-basin 7"
3246,100,4,700,800,"Sub-basin 7"
3247,100,2,300,400,"Sub-basin 7"
3248,100,1,1100,1200,"Sub-basin 7"
3249,2300,380,6400,8700,"Sub-basin 7"
3250,1300,79,14800,16100,"Sub-basin 7"
3251,100,2,1700,1800,"Sub-basin 7"
3252,1000,39,4600,5600,"Sub-basin 7"
3253,100,2,1300,1400,"Sub-basin 7"
3254,200,6,1000,1200,"Sub-basin 7"
3255,2400,386,11200,13600,"Sub-basin 7"
3256,700,80,3800,4500,"Sub-basin 7"
3257,1600,54,24500,26100,"Sub-basin 7"
3258,2700,455,26200,28900,"Sub-basin 7"
3259,100,1,1700,1800,"Sub-basin 7"
3260,300,6,3100,3400,"Sub-basin 7"
3261,500,14,5000,5500,"Sub-basin 7"
3262,600,19,8900,9500,"Sub-basin 7"
3263,1600,164,4100,5700,"Sub-basin 7"
3264,300,5.0016,13900,14200,"Sub-basin 7"
3265,700,113,5600,6300,"Sub-basin 7"
3266,600,63,6100,6700,"Sub-basin 7"
3267,200,6,2700,2900,"Sub-basin 7"
3268,100,1,1500,1600,"Sub-basin 7"
3269,200,15,2700,2900,"Sub-basin 7"
3270,100,3,1400,1500,"Sub-basin 7"
3271,300,7,2000,2300,"Sub-basin 7"
3272,800,37,8100,8900,"Sub-basin 7"
3273,100,1,1000,1100,"Sub-basin 7"
3274,400,4,2600,3000,"Sub-basin 7"
3275,100,3,1300,1400,"Sub-basin 7"
3276,200,9,2100,2300,"Sub-basin 7"
3277,400,16,4100,4500,"Sub-basin 7"
3278,100,3,700,800,"Sub-basin 7"
3279,1500,78,4400,5900,"Sub-basin 7"
3280,500,32,3400,3900,"Sub-basin 7"
3281,100,3,1800,1900,"Sub-basin 7"
3282,700,49,3800,4500,"Sub-basin 7"
3283,200,5,2600,2800,"Sub-basin 7"
3284,3100,316.33,24300,27400,"Sub-basin 7"
3285,100,3,2000,2100,"Sub-basin 7"
3286,100,1,900,1000,"Sub-basin 7"
3287,1600,102,7300,8900,"Sub-basin 7"
3288,100,1,3200,3300,"Sub-basin 7"
3289,200,3,2000,2200,"Sub-basin 7"
3290,1200,75,14100,15300,"Sub-basin 7"
3291,100,1,1200,1300,"Sub-basin 7"
3292,500,32,4800,5300,"Sub-basin 7"
3293,200,3,2100,2300,"Sub-basin 7"
3294,600,36,5100,5700,"Sub-basin 7"
3295,400,22,3400,3800,"Sub-basin 7"
3296,400,8,3800,4200,"Sub-basin 7"
3297,200,5,1400,1600,"Sub-basin 7"
3298,200,2,1500,1700,"Sub-basin 7"
3299,700,36,4200,4900,"Sub-basin 7"
3300,600,155,3100,3700,"Sub-basin 7"
3301,500,20,2700,3200,"Sub-basin 7"
3302,200,8,1500,1700,"Sub-basin 7"
3303,200,6,2600,2800,"Sub-basin 7"
3304,300,12,1500,1800,"Sub-basin 7"
3305,400,18,2800,3200,"Sub-basin 7"
3306,300,5,3400,3700,"Sub-basin 7"
3307,100,1,2100,2200,"Sub-basin 7"
3308,200,5,3000,3200,"Sub-basin 7"
3309,300,10,2500,2800,"Sub-basin 7"
3310,100,4,1900,2000,"Sub-basin 7"
3311,300,13,3300,3600,"Sub-basin 7"
3312,13000,2356,106900,119900,"Sub-basin 7"
3313,500,23,2600,3100,"Sub-basin 7"
3314,2600,1020,8300,10900,"Sub-basin 7"
3315,700,42,6600,7300,"Sub-basin 7"
3316,100,2,1000,1100,"Sub-basin 7"
3317,300,18.5,1700,2000,"Sub-basin 7"
3318,100,2,1000,1100,"Sub-basin 7"
3319,1300,64,9800,11100,"Sub-basin 7"
3320,1000,103,3400,4400,"Sub-basin 7"
3321,200,11,2100,2300,"Sub-basin 7"
3322,100,2,1000,1100,"Sub-basin 7"
3323,500,22,2400,2900,"Sub-basin 7"
3324,100,2,2300,2400,"Sub-basin 7"
3325,300,18,4000,4300,"Sub-basin 7"
3326,200,6,1500,1700,"Sub-basin 7"
3327,600,51,4700,5300,"Sub-basin 7"
3328,400,20,1800,2200,"Sub-basin 7"
3329,500,12,5400,5900,"Sub-basin 7"
3330,200,5,1400,1600,"Sub-basin 7"
3331,200,13,3900,4100,"Sub-basin 7"
3332,4300,479,8800,13100,"Sub-basin 7"
3333,300,16,1900,2200,"Sub-basin 7"
3334,700,26,5100,5800,"Sub-basin 7"
3335,200,6,3600,3800,"Sub-basin 7"
3336,300,7,5100,5400,"Sub-basin 7"
3337,300,6,3300,3600,"Sub-basin 7"
3338,200,6,1400,1600,"Sub-basin 7"
3339,1900,1420,5500,7400,"Sub-basin 7"
3340,100,2,2300,2400,"Sub-basin 7"
3341,600,49,3300,3900,"Sub-basin 7"
3342,100,1,1600,1700,"Sub-basin 7"
3343,1400,121,9900,11300,"Sub-basin 7"
3344,200,3,2800,3000,"Sub-basin 7"
3345,800,58,2900,3700,"Sub-basin 7"
3346,300,4,3000,3300,"Sub-basin 7"
3347,600,29,1600,2200,"Sub-basin 7"
3348,300,18,3800,4100,"Sub-basin 7"
3349,600,40,9500,10100,"Sub-basin 7"
3350,100,1,2900,3000,"Sub-basin 7"
3351,100,2,1500,1600,"Sub-basin 7"
3352,100,1,2100,2200,"Sub-basin 7"
3353,100,2.0003,5400,5500,"Sub-basin 7"
3354,200,3,2100,2300,"Sub-basin 7"
3355,2500,710,11800,14300,"Sub-basin 7"
3356,1200,502,3700,4900,"Sub-basin 7"
3357,100,2,1200,1300,"Sub-basin 7"
3358,200,3,1900,2100,"Sub-basin 7"
3359,100,1,2100,2200,"Sub-basin 7"
3360,900,46,11200,12100,"Sub-basin 7"
3361,3500,395,13100,16600,"Sub-basin 7"
3362,1700,274,3200,4900,"Sub-basin 7"
3363,2600,554,13700,16300,"Sub-basin 7"
3364,1000,372,4500,5500,"Sub-basin 7"
3365,100,13,1500,1600,"Sub-basin 7"
3366,100,5,1200,1300,"Sub-basin 7"
3367,100,2,2600,2700,"Sub-basin 7"
3368,100,1,1300,1400,"Sub-basin 7"
3369,900,44,3000,3900,"Sub-basin 7"
3370,700,21,5300,6000,"Sub-basin 7"
3371,700,34,8000,8700,"Sub-basin 7"
3372,100,2,1700,1800,"Sub-basin 7"
3373,200,2,6000,6200,"Sub-basin 7"
3374,100,1,1300,1400,"Sub-basin 7"
3375,600,129,8700,9300,"Sub-basin 7"
3376,700,226,7700,8400,"Sub-basin 7"
3377,1700,264,9300,11000,"Sub-basin 7"
3378,1600,144,8600,10200,"Sub-basin 7"
3379,200,2,2500,2700,"Sub-basin 7"
3380,1200,102,2500,3700,"Sub-basin 7"
3381,100,1,1500,1600,"Sub-basin 7"
3382,100,2,2200,2300,"Sub-basin 7"
3383,200,5,3200,3400,"Sub-basin 7"
3384,1300,119,4800,6100,"Sub-basin 7"
3385,300,11,2500,2800,"Sub-basin 7"
3386,1700,241,7200,8900,"Sub-basin 7"
3387,1300,204,2300,3600,"Sub-basin 7"
3388,900,50,6800,7700,"Sub-basin 7"
3389,2700,696,8000,10700,"Sub-basin 7"
3390,600,35,3800,4400,"Sub-basin 7"
3391,800,55,3700,4500,"Sub-basin 7"
3392,21900,8420,36300,58200,"Sub-basin 7"
3393,400,75,2300,2700,"Sub-basin 7"
3394,100,10,1200,1300,"Sub-basin 7"
3395,200,56,900,1100,"Sub-basin 7"
3396,100,1,600,700,"Sub-basin 7"
3397,100,1,600,700,"Sub-basin 7"
3398,600,31,3200,3800,"Sub-basin 7"
3399,100,2,1500,1600,"Sub-basin 7"
3400,200,8,3500,3700,"Sub-basin 7"
3401,700,17,6800,7500,"Sub-basin 7"
3402,400,8,5200,5600,"Sub-basin 7"
3403,700,117,1900,2600,"Sub-basin 7"
3404,200,7,3800,4000,"Sub-basin 7"
3405,100,3,2000,2100,"Sub-basin 7"
3406,100,3,3000,3100,"Sub-basin 7"
3407,200,9,4100,4300,"Sub-basin 7"
3408,400,10,3000,3400,"Sub-basin 7"
3409,100,2,300,400,"Sub-basin 7"
3410,100,1,1100,1200,"Sub-basin 7"
3411,1200,174,3900,5100,"Sub-basin 7"
3412,1400,238,10700,12100,"Sub-basin 7"
3413,100,3,2800,2900,"Sub-basin 7"
3414,200,16,1200,1400,"Sub-basin 7"
3415,1300,192,4000,5300,"Sub-basin 7"
3416,2200,600,4500,6700,"Sub-basin 7"
3417,100,2,3400,3500,"Sub-basin 7"
3418,2400,230,8100,10500,"Sub-basin 7"
3419,1300,82,5300,6600,"Sub-basin 7"
3420,500,36,4100,4600,"Sub-basin 7"
3421,400,11,3400,3800,"Sub-basin 7"
3422,100,3,1600,1700,"Sub-basin 7"
3423,100,2,2000,2100,"Sub-basin 7"
3424,100,3,1100,1200,"Sub-basin 7"
3425,3400,1113,11100,14500,"Sub-basin 7"
3426,200,25,2100,2300,"Sub-basin 7"
3427,100,13,2300,2400,"Sub-basin 7"
3428,400,45,1100,1500,"Sub-basin 7"
3429,6700,1430,83700,90400,"Sub-basin 7"
3430,1400,77,8200,9600,"Sub-basin 7"
3431,1700,414,10700,12400,"Sub-basin 7"
3432,200,6,3600,3800,"Sub-basin 7"
3433,600,28,2700,3300,"Sub-basin 7"
3434,200,6,2900,3100,"Sub-basin 7"
3435,200,3,1500,1700,"Sub-basin 7"
3436,13100,5152,15900,29000,"Sub-basin 7"
3437,300,8,3600,3900,"Sub-basin 7"
3438,300,8,3500,3800,"Sub-basin 7"
3439,300,7,1900,2200,"Sub-basin 7"
3440,100,1,700,800,"Sub-basin 7"
3441,600,76,6100,6700,"Sub-basin 7"
3442,400,50,3200,3600,"Sub-basin 7"
3443,1900,348,9800,11700,"Sub-basin 7"
3444,500,16,6400,6900,"Sub-basin 7"
3445,300,7,1600,1900,"Sub-basin 7"
3446,100,2,1700,1800,"Sub-basin 7"
3447,300,16,2400,2700,"Sub-basin 7"
3448,2400,414,6500,8900,"Sub-basin 7"
3449,100,3,2500,2600,"Sub-basin 7"
3450,400,24,4400,4800,"Sub-basin 7"
3451,3800,290,20100,23900,"Sub-basin 7"
3452,18700,3728,93200,111900,"Sub-basin 7"
3453,100,1,1200,1300,"Sub-basin 7"
3454,500,19,5200,5700,"Sub-basin 7"
3455,300,8,4400,4700,"Sub-basin 7"
3456,100,1.0002,4400,4500,"Sub-basin 7"
3457,200,11,2200,2400,"Sub-basin 7"
3458,100,1,1800,1900,"Sub-basin 7"
3459,100,2,300,400,"Sub-basin 7"
3460,100,1,1200,1300,"Sub-basin 7"
3461,100,1,1200,1300,"Sub-basin 7"
3462,700,24,8800,9500,"Sub-basin 7"
3463,400,57,3300,3700,"Sub-basin 7"
3464,700,47,3600,4300,"Sub-basin 7"
3465,100,2,1700,1800,"Sub-basin 7"
3466,800,33,6300,7100,"Sub-basin 7"
3467,2800,507,7900,10700,"Sub-basin 7"
3468,400,12,2200,2600,"Sub-basin 7"
3469,100,2,1700,1800,"Sub-basin 7"
3470,600,26,5500,6100,"Sub-basin 7"
3471,700,39,5700,6400,"Sub-basin 7"
3472,100,3,1200,1300,"Sub-basin 7"
3473,100,3,800,900,"Sub-basin 7"
3474,100,1,900,1000,"Sub-basin 7"
3475,700,79,3000,3700,"Sub-basin 7"
3476,700,55,8800,9500,"Sub-basin 7"
3477,300,18,5100,5400,"Sub-basin 7"
3478,100,3,3000,3100,"Sub-basin 7"
3479,2000,287,8700,10700,"Sub-basin 7"
3480,600,58,2500,3100,"Sub-basin 7"
3481,500,15,2400,2900,"Sub-basin 7"
3482,900,165,3100,4000,"Sub-basin 7"
3483,500,25,2000,2500,"Sub-basin 7"
3484,600,24,3000,3600,"Sub-basin 7"
3485,100,1,2000,2100,"Sub-basin 7"
3486,400,19,2200,2600,"Sub-basin 7"
3487,300,7,1900,2200,"Sub-basin 7"
3488,100,3,1300,1400,"Sub-basin 7"
3489,500,20,4400,4900,"Sub-basin 7"
3490,500,36,5100,5600,"Sub-basin 7"
3491,3600,453,28700,32300,"Sub-basin 7"
3492,1000,79,4300,5300,"Sub-basin 7"
3493,100,1,1000,1100,"Sub-basin 7"
3494,400,18,4600,5000,"Sub-basin 7"
3495,1200,426,5000,6200,"Sub-basin 7"
3496,100,3,1200,1300,"Sub-basin 7"
3497,2300,256,9600,11900,"Sub-basin 7"
3498,1000,47,3600,4600,"Sub-basin 7"
3499,1500,91,10800,12300,"Sub-basin 7"
3500,100,4,600,700,"Sub-basin 7"
3501,600,47,7500,8100,"Sub-basin 7"
3502,1200,280,6800,8000,"Sub-basin 7"
3503,2900,300,15000,17900,"Sub-basin 7"
3504,100,1,1100,1200,"Sub-basin 7"
3505,800,27,6100,6900,"Sub-basin 7"
3506,300,13,800,1100,"Sub-basin 7"
3507,100,1.0003,2600,2700,"Sub-basin 7"
3508,100,1,1000,1100,"Sub-basin 7"
3509,100,1,1000,1100,"Sub-basin 7"
3510,200,6,3200,3400,"Sub-basin 7"
3511,400,16,4000,4400,"Sub-basin 7"
3512,100,1,800,900,"Sub-basin 7"
3513,100,5,1300,1400,"Sub-basin 7"
3514,600,33,2900,3500,"Sub-basin 7"
3515,2400,435,3700,6100,"Sub-basin 7"
3516,100,3,1600,1700,"Sub-basin 7"
3517,200,2,1600,1800,"Sub-basin 7"
3518,100,1,2000,2100,"Sub-basin 7"
3519,700,57,2900,3600,"Sub-basin 7"
3520,200,3,3500,3700,"Sub-basin 7"
3521,400,8,4600,5000,"Sub-basin 7"
3522,5600,2619,15700,21300,"Sub-basin 7"
3523,400,17,2300,2700,"Sub-basin 7"
3524,3200,604,9300,12500,"Sub-basin 7"
3525,400,19,4500,4900,"Sub-basin 7"
3526,100,4,1000,1100,"Sub-basin 7"
3527,500,39,2500,3000,"Sub-basin 7"
3528,300,27,1600,1900,"Sub-basin 7"
3529,2500,170,7800,10300,"Sub-basin 7"
3530,100,1.0001,4900,5000,"Sub-basin 7"
3531,1200,74,14800,16000,"Sub-basin 7"
3532,1200,88,9800,11000,"Sub-basin 7"
3533,100,2,1000,1100,"Sub-basin 7"
3534,200,8,900,1100,"Sub-basin 7"
3535,29900,21624.864,36500,66500,"Sub-basin 7"
3536,300,6,3800,4100,"Sub-basin 7"
3537,100,1,3300,3400,"Sub-basin 7"
3538,200,14,2100,2300,"Sub-basin 7"
3539,2100,179,8700,10800,"Sub-basin 7"
3540,200,5,2800,3000,"Sub-basin 7"
3541,1200,283,3800,5000,"Sub-basin 7"
3542,200,2,2400,2600,"Sub-basin 7"
3543,300,13,2600,2900,"Sub-basin 7"
3544,400,24,6500,6900,"Sub-basin 7"
3545,100,1,1400,1500,"Sub-basin 7"
3546,400,14,4100,4500,"Sub-basin 7"
3547,100,1,2200,2300,"Sub-basin 7"
3548,2900,251,15200,18100,"Sub-basin 7"
3549,300,10,3500,3800,"Sub-basin 7"
3550,100,1,1500,1600,"Sub-basin 7"
3551,100,5,600,700,"Sub-basin 7"
3552,2800,1326,10400,13200,"Sub-basin 7"
3553,100,2,1100,1200,"Sub-basin 7"
3554,100,1,5100,5200,"Sub-basin 7"
3555,800,133,4800,5600,"Sub-basin 7"
3556,200,3,1800,2000,"Sub-basin 7"
3557,500,17,3700,4200,"Sub-basin 7"
3558,500,17,4200,4700,"Sub-basin 7"
3559,500,27,6500,7000,"Sub-basin 7"
3560,200,4,2300,2500,"Sub-basin 7"
3561,400,25,3500,3900,"Sub-basin 7"
3562,100,4,1400,1500,"Sub-basin 7"
3563,400,15,2900,3300,"Sub-basin 7"
3564,100,19,1800,1900,"Sub-basin 7"
3565,500,54,4700,5200,"Sub-basin 7"
3566,300,42,1000,1300,"Sub-basin 7"
3567,100,3,800,900,"Sub-basin 7"
3568,200,3,2500,2700,"Sub-basin 7"
3569,300,6.0024,14400,14700,"Sub-basin 7"
3570,200,5,2700,2900,"Sub-basin 7"
3571,1000,66,5500,6500,"Sub-basin 7"
3572,900,80,3300,4200,"Sub-basin 7"
3573,400,23,5100,5500,"Sub-basin 7"
3574,100,2,700,800,"Sub-basin 7"
3575,1200,580,10600,11800,"Sub-basin 7"
3576,100,4,1100,1200,"Sub-basin 7"
3577,2100,909,14800,16900,"Sub-basin 7"
3578,400,14,1100,1500,"Sub-basin 7"
3579,500,59,3100,3600,"Sub-basin 7"
3580,300,8,1000,1300,"Sub-basin 7"
3581,600,54,5200,5800,"Sub-basin 7"
3582,200,12,1900,2100,"Sub-basin 7"
3583,200,2,2100,2300,"Sub-basin 7"
3584,2500,100,17200,19700,"Sub-basin 7"
3585,1400,74,8300,9700,"Sub-basin 7"
3586,200,4,2100,2300,"Sub-basin 7"
3587,600,68,3300,3900,"Sub-basin 7"
3588,100,2,1200,1300,"Sub-basin 7"
3589,700,36,3500,4200,"Sub-basin 7"
3590,300,12,1900,2200,"Sub-basin 7"
3591,200,6,2200,2400,"Sub-basin 7"
3592,100,1,800,900,"Sub-basin 7"
3593,400,14,1700,2100,"Sub-basin 7"
3594,1500,231,4500,6000,"Sub-basin 7"
3595,200,9,2800,3000,"Sub-basin 7"
3596,1600,177,5100,6700,"Sub-basin 7"
3597,300,5,3300,3600,"Sub-basin 7"
3598,100,1,1400,1500,"Sub-basin 7"
3599,100,2,800,900,"Sub-basin 7"
3600,600,30,13400,14000,"Sub-basin 7"
3601,700,15.0026,23000,23700,"Sub-basin 7"
3602,400,14,8600,9000,"Sub-basin 7"
3603,100,1,500,600,"Sub-basin 7"
3604,100,1,1900,2000,"Sub-basin 7"
3605,200,3,2300,2500,"Sub-basin 7"
3606,200,4,1900,2100,"Sub-basin 7"
3607,600,19,8600,9200,"Sub-basin 7"
3608,100,2,1000,1100,"Sub-basin 7"
3609,200,7,1900,2100,"Sub-basin 7"
3610,500,15,3800,4300,"Sub-basin 7"
3611,3100,166,14400,17500,"Sub-basin 7"
3612,600,30,7700,8300,"Sub-basin 7"
3613,4600,1736,12200,16800,"Sub-basin 7"
3614,100,1,2000,2100,"Sub-basin 7"
3615,100,8,2000,2100,"Sub-basin 7"
3616,900,61,3400,4300,"Sub-basin 7"
3617,300,3,900,1200,"Sub-basin 7"
3618,200,3,1500,1700,"Sub-basin 7"
3619,100,1,700,800,"Sub-basin 7"
3620,200,9,6300,6500,"Sub-basin 7"
3621,1900,171,4200,6100,"Sub-basin 7"
3622,300,4,3000,3300,"Sub-basin 7"
3623,300,4,6000,6300,"Sub-basin 7"
3624,200,5,3200,3400,"Sub-basin 7"
3625,200,7,3000,3200,"Sub-basin 7"
3626,100,1,900,1000,"Sub-basin 7"
3627,1600,131,13600,15200,"Sub-basin 7"
3628,500,40,2200,2700,"Sub-basin 7"
3629,100,1,2200,2300,"Sub-basin 7"
3630,200,29,2900,3100,"Sub-basin 7"
3631,700,54,9400,10100,"Sub-basin 7"
3632,200,4,2900,3100,"Sub-basin 7"
3633,200,9,1800,2000,"Sub-basin 7"
3634,100,1,400,500,"Sub-basin 7"
3635,100,1,800,900,"Sub-basin 7"
3636,100,2,2300,2400,"Sub-basin 7"
3637,300,4,4600,4900,"Sub-basin 7"
3638,900,101,4000,4900,"Sub-basin 7"
3639,200,29,3100,3300,"Sub-basin 7"
3640,500,22,2700,3200,"Sub-basin 7"
3641,200,4,1100,1300,"Sub-basin 7"
3642,600,37,6200,6800,"Sub-basin 7"
3643,300,8,2400,2700,"Sub-basin 7"
3644,200,2,2100,2300,"Sub-basin 7"
3645,300,16,2900,3200,"Sub-basin 7"
3646,500,25,6300,6800,"Sub-basin 7"
3647,600,37,5500,6100,"Sub-basin 7"
3648,300,19,3800,4100,"Sub-basin 7"
3649,100,1,2300,2400,"Sub-basin 7"
3650,200,5,1100,1300,"Sub-basin 7"
3651,200,13,1100,1300,"Sub-basin 7"
3652,300,4,1800,2100,"Sub-basin 7"
3653,100,2,1000,1100,"Sub-basin 7"
3654,400,28,3500,3900,"Sub-basin 7"
3655,800,72,6700,7500,"Sub-basin 7"
3656,400,19,3700,4100,"Sub-basin 7"
3657,300,6,3000,3300,"Sub-basin 7"
3658,200,4,2100,2300,"Sub-basin 7"
3659,300,10,1400,1700,"Sub-basin 7"
3660,800,75,2900,3700,"Sub-basin 7"
3661,100,6,700,800,"Sub-basin 7"
3662,200,5,1300,1500,"Sub-basin 7"
3663,200,2,3100,3300,"Sub-basin 7"
3664,200,5,2400,2600,"Sub-basin 7"
3665,1200,121,5300,6500,"Sub-basin 7"
3666,200,13,4300,4500,"Sub-basin 7"
3667,2100,135,9200,11300,"Sub-basin 7"
3668,100,1.0003,5100,5200,"Sub-basin 7"
3669,100,1,1000,1100,"Sub-basin 7"
3670,2800,258,25200,28000,"Sub-basin 7"
3671,600,15,6400,7000,"Sub-basin 7"
3672,500,12,1500,2000,"Sub-basin 7"
3673,100,2,1400,1500,"Sub-basin 7"
3674,100,1,1400,1500,"Sub-basin 7"
3675,1500,72,7200,8700,"Sub-basin 7"
3676,200,6,2300,2500,"Sub-basin 7"
3677,700,43,5600,6300,"Sub-basin 7"
3678,100,1,300,400,"Sub-basin 7"
3679,200,3,900,1100,"Sub-basin 7"
3680,400,11,5700,6100,"Sub-basin 7"
3681,500,16,3800,4300,"Sub-basin 7"
3682,100,3,2700,2800,"Sub-basin 7"
3683,1200,72,9900,11100,"Sub-basin 7"
3684,200,5,2500,2700,"Sub-basin 7"
3685,200,5,2000,2200,"Sub-basin 7"
3686,100,5,1900,2000,"Sub-basin 7"
3687,200,9,1700,1900,"Sub-basin 7"
3688,1800,155,8300,10100,"Sub-basin 7"
3689,400,13,2000,2400,"Sub-basin 7"
3690,500,12,9900,10400,"Sub-basin 7"
3691,600,34,3700,4300,"Sub-basin 7"
3692,1500,92,5600,7100,"Sub-basin 7"
3693,500,40,4500,5000,"Sub-basin 7"
3694,300,9,4300,4600,"Sub-basin 7"
3695,300,5,2300,2600,"Sub-basin 7"
3696,300,4,3500,3800,"Sub-basin 7"
3697,1100,106,11100,12200,"Sub-basin 7"
3698,100,4,2700,2800,"Sub-basin 7"
3699,400,8,5800,6200,"Sub-basin 7"
3700,600,30,3100,3700,"Sub-basin 7"
3701,200,10,1800,2000,"Sub-basin 7"
3702,1300,19.0073,37800,39100,"Sub-basin 7"
3703,100,1,1400,1500,"Sub-basin 7"
3704,400,18,5200,5600,"Sub-basin 7"
3705,100,2,1700,1800,"Sub-basin 7"
3706,1900,134,14000,15900,"Sub-basin 7"
3707,300,4,2700,3000,"Sub-basin 7"
3708,100,2,1500,1600,"Sub-basin 7"
3709,100,1,700,800,"Sub-basin 7"
3710,500,18,10500,11000,"Sub-basin 7"
3711,100,4,900,1000,"Sub-basin 7"
3712,100,1,200,300,"Sub-basin 7"
3713,200,5,3400,3600,"Sub-basin 7"
3714,1400,58,20400,21800,"Sub-basin 7"
3715,200,9,1400,1600,"Sub-basin 7"
3716,200,7,3400,3600,"Sub-basin 7"
3717,1600,193,5500,7100,"Sub-basin 7"
3718,600,38,2500,3100,"Sub-basin 7"
3719,400,37,2600,3000,"Sub-basin 7"
3720,400,12,1500,1900,"Sub-basin 7"
3721,100,1,1500,1600,"Sub-basin 7"
3722,3800,319.0069,19900,23700,"Sub-basin 7"
3723,2800,758,6900,9700,"Sub-basin 7"
3724,200,3,3900,4100,"Sub-basin 7"
3725,400,21,7300,7700,"Sub-basin 7"
3726,200,2,1000,1200,"Sub-basin 7"
3727,400,35,1700,2100,"Sub-basin 7"
3728,1600,125,14100,15700,"Sub-basin 7"
3729,100,1,1100,1200,"Sub-basin 7"
3730,3500,289,20600,24100,"Sub-basin 7"
3731,700,79,5300,6000,"Sub-basin 7"
3732,100,1,300,400,"Sub-basin 7"
3733,100,1,900,1000,"Sub-basin 7"
3734,100,2,800,900,"Sub-basin 7"
3735,100,2,2700,2800,"Sub-basin 7"
3736,600,24,2600,3200,"Sub-basin 7"
3737,500,40,3700,4200,"Sub-basin 7"
3738,200,10,2600,2800,"Sub-basin 7"
3739,700,36,2600,3300,"Sub-basin 7"
3740,500,31,5200,5700,"Sub-basin 7"
3741,200,4,1500,1700,"Sub-basin 7"
3742,500,19,3400,3900,"Sub-basin 7"
3743,900,107,2500,3400,"Sub-basin 7"
3744,3700,907,10400,14100,"Sub-basin 7"
3745,1200,122,7900,9100,"Sub-basin 7"
3746,500,22,1100,1600,"Sub-basin 7"
3747,2300,246,5600,7900,"Sub-basin 7"
3748,100,6,600,700,"Sub-basin 7"
3749,100,1,900,1000,"Sub-basin 7"
3750,1700,473,2200,3900,"Sub-basin 7"
3751,200,3,5200,5400,"Sub-basin 7"
3752,200,5,2200,2400,"Sub-basin 7"
3753,200,4,1100,1300,"Sub-basin 7"
3754,3000,330,10100,13100,"Sub-basin 7"
3755,800,109,2400,3200,"Sub-basin 7"
3756,600,21,10700,11300,"Sub-basin 7"
3757,600,36,8900,9500,"Sub-basin 7"
3758,600,33,5000,5600,"Sub-basin 7"
3759,300,22,4200,4500,"Sub-basin 7"
3760,100,3,900,1000,"Sub-basin 7"
3761,500,32,5300,5800,"Sub-basin 7"
3762,200,4,2900,3100,"Sub-basin 7"
3763,200,4,2500,2700,"Sub-basin 7"
3764,1900,52,14200,16100,"Sub-basin 7"
3765,2300,180,8600,10900,"Sub-basin 7"
3766,300,21,3600,3900,"Sub-basin 7"
3767,100,3,1400,1500,"Sub-basin 7"
3768,1500,110,2900,4400,"Sub-basin 7"
3769,1900,445,2300,4200,"Sub-basin 7"
3770,400,16,2300,2700,"Sub-basin 7"
3771,300,6,2000,2300,"Sub-basin 7"
3772,300,12,3500,3800,"Sub-basin 7"
3773,100,3,1100,1200,"Sub-basin 7"
3774,400,21,1800,2200,"Sub-basin 7"
3775,9700,3568,48600,58300,"Sub-basin 7"
3776,200,7,4900,5100,"Sub-basin 7"
3777,100,1,800,900,"Sub-basin 7"
3778,200,3,1700,1900,"Sub-basin 7"
3779,400,12,5300,5700,"Sub-basin 7"
3780,100,1,900,1000,"Sub-basin 7"
3781,100,1,1900,2000,"Sub-basin 7"
3782,100,1,2900,3000,"Sub-basin 7"
3783,300,5,7700,8000,"Sub-basin 7"
3784,100,1,700,800,"Sub-basin 7"
3785,800,36,5300,6100,"Sub-basin 7"
3786,400,19,2700,3100,"Sub-basin 7"
3787,1000,122,8000,9000,"Sub-basin 7"
3788,100,2,1100,1200,"Sub-basin 7"
3789,100,2.0002,3700,3800,"Sub-basin 7"
3790,400,26,6500,6900,"Sub-basin 7"
3791,800,67,3100,3900,"Sub-basin 7"
3792,200,8,2400,2600,"Sub-basin 7"
3793,200,8,1100,1300,"Sub-basin 7"
3794,100,1,900,1000,"Sub-basin 7"
3795,200,12,3200,3400,"Sub-basin 7"
3796,100,1,600,700,"Sub-basin 7"
3797,300,5,5400,5700,"Sub-basin 7"
3798,400,11,3300,3700,"Sub-basin 7"
3799,200,3,2900,3100,"Sub-basin 7"
3800,200,3,1300,1500,"Sub-basin 7"
3801,400,23,2300,2700,"Sub-basin 7"
3802,400,13,1200,1600,"Sub-basin 7"
3803,100,1,900,1000,"Sub-basin 7"
3804,200,21,3500,3700,"Sub-basin 7"
3805,900,336,3900,4800,"Sub-basin 7"
3806,400,15,4300,4700,"Sub-basin 7"
3807,400,19,6100,6500,"Sub-basin 7"
3808,200,3,900,1100,"Sub-basin 7"
3809,200,4.0011,6800,7000,"Sub-basin 7"
3810,200,4,4700,4900,"Sub-basin 7"
3811,1300,110,7500,8800,"Sub-basin 7"
3812,2700,204,10800,13500,"Sub-basin 7"
3813,200,6,1800,2000,"Sub-basin 7"
3814,2400,203,10200,12600,"Sub-basin 7"
3815,1200,39,10600,11800,"Sub-basin 7"
3816,14400,3157.0545,34600,49000,"Sub-basin 7"
3817,100,2,900,1000,"Sub-basin 7"
3818,200,2,3200,3400,"Sub-basin 7"
3819,15500,7103,28500,44000,"Sub-basin 7"
3820,1600,102,14500,16100,"Sub-basin 7"
3821,800,50,4400,5200,"Sub-basin 7"
3822,400,29,2600,3000,"Sub-basin 7"
3823,500,30,5600,6100,"Sub-basin 7"
3824,100,1,1200,1300,"Sub-basin 7"
3825,11200,2848,31800,43000,"Sub-basin 7"
3826,400,10,6900,7300,"Sub-basin 7"
3827,300,11,3900,4200,"Sub-basin 7"
3828,700,17,4000,4700,"Sub-basin 7"
3829,200,2.0003,6700,6900,"Sub-basin 7"
3830,100,2,1400,1500,"Sub-basin 7"
3831,200,2,1600,1800,"Sub-basin 7"
3832,3300,407,37200,40500,"Sub-basin 7"
3833,100,1,1200,1300,"Sub-basin 7"
3834,100,1,1200,1300,"Sub-basin 7"
3835,500,25,5300,5800,"Sub-basin 7"
3836,300,18,2700,3000,"Sub-basin 7"
3837,100,7,1400,1500,"Sub-basin 7"
3838,900,48,4400,5300,"Sub-basin 7"
3839,1400,69,8000,9400,"Sub-basin 7"
3840,200,2,3600,3800,"Sub-basin 7"
3841,100,1,2100,2200,"Sub-basin 7"
3842,1000,105,6300,7300,"Sub-basin 7"
3843,100,1,1700,1800,"Sub-basin 7"
3844,100,1,1300,1400,"Sub-basin 7"
3845,200,4,1100,1300,"Sub-basin 7"
3846,100,3,1800,1900,"Sub-basin 7"
3847,600,17,7300,7900,"Sub-basin 7"
3848,600,22,6000,6600,"Sub-basin 7"
3849,200,4.0004,6500,6700,"Sub-basin 7"
3850,200,3,6200,6400,"Sub-basin 7"
3851,100,2,4200,4300,"Sub-basin 7"
3852,200,3,1700,1900,"Sub-basin 7"
3853,200,5,3400,3600,"Sub-basin 7"
3854,1200,118,5200,6400,"Sub-basin 7"
3855,100,2,1600,1700,"Sub-basin 7"
3856,100,1,1500,1600,"Sub-basin 7"
3857,100,2,3000,3100,"Sub-basin 7"
3858,600,31,9700,10300,"Sub-basin 7"
3859,700,15,4500,5200,"Sub-basin 7"
3860,600,43,3200,3800,"Sub-basin 7"
3861,12500,1302,51200,63700,"Sub-basin 7"
3862,100,2,1300,1400,"Sub-basin 7"
3863,100,1,600,700,"Sub-basin 7"
3864,200,3,2900,3100,"Sub-basin 7"
3865,900,38,6400,7300,"Sub-basin 7"
3866,100,3,1500,1600,"Sub-basin 7"
3867,100,3,1200,1300,"Sub-basin 7"
3868,100,2.0002,3400,3500,"Sub-basin 7"
3869,400,18,3400,3800,"Sub-basin 7"
3870,100,1,1000,1100,"Sub-basin 7"
3871,200,3,1700,1900,"Sub-basin 7"
3872,600,22,6200,6800,"Sub-basin 7"
3873,600,62,3100,3700,"Sub-basin 7"
3874,300,13,2800,3100,"Sub-basin 7"
3875,400,7,2500,2900,"Sub-basin 7"
3876,200,12,1800,2000,"Sub-basin 7"
3877,300,17,1700,2000,"Sub-basin 7"
3878,200,2,3000,3200,"Sub-basin 7"
3879,2100,589,9000,11100,"Sub-basin 7"
3880,100,1,600,700,"Sub-basin 7"
3881,800,90,2500,3300,"Sub-basin 7"
3882,100,1,1800,1900,"Sub-basin 7"
3883,300,5,6000,6300,"Sub-basin 7"
3884,2300,88,31700,34000,"Sub-basin 7"
3885,100,1,800,900,"Sub-basin 7"
3886,300,16,600,900,"Sub-basin 7"
3887,100,1,1400,1500,"Sub-basin 7"
3888,900,76,6100,7000,"Sub-basin 7"
3889,600,26,3100,3700,"Sub-basin 7"
3890,400,88,1700,2100,"Sub-basin 7"
3891,100,5,1000,1100,"Sub-basin 7"
3892,700,25,10900,11600,"Sub-basin 7"
3893,200,2,4000,4200,"Sub-basin 7"
3894,200,6,2000,2200,"Sub-basin 7"
3895,1800,170,10500,12300,"Sub-basin 7"
3896,1200,18.0047,16200,17400,"Sub-basin 7"
3897,100,2,1100,1200,"Sub-basin 7"
3898,200,8,2600,2800,"Sub-basin 7"
3899,700,32,4600,5300,"Sub-basin 7"
3900,300,8,3200,3500,"Sub-basin 7"
3901,1300,71,13300,14600,"Sub-basin 7"
3902,2600,1446,10200,12800,"Sub-basin 7"
3903,200,4,2500,2700,"Sub-basin 7"
3904,21600,5847,57600,79200,"Sub-basin 7"
3905,500,83,3700,4200,"Sub-basin 7"
3906,1400,64,8300,9700,"Sub-basin 7"
3907,800,57,8800,9600,"Sub-basin 7"
3908,500,27,2100,2600,"Sub-basin 7"
3909,100,3,2500,2600,"Sub-basin 7"
3910,300,11,4200,4500,"Sub-basin 7"
3911,2600,220,8800,11400,"Sub-basin 7"
3912,5300,470,18300,23600,"Sub-basin 7"
3913,300,5,1100,1400,"Sub-basin 7"
3914,100,3,1600,1700,"Sub-basin 7"
3915,400,16,2700,3100,"Sub-basin 7"
3916,1200,434.16,3000,4200,"Sub-basin 7"
3917,100,2,1100,1200,"Sub-basin 7"
3918,200,7,2600,2800,"Sub-basin 7"
3919,1000,24,9600,10600,"Sub-basin 7"
3920,200,4,1200,1400,"Sub-basin 7"
3921,100,2,0,100,"Sub-basin 7"
3922,1900,214,2900,4800,"Sub-basin 7"
3923,100,4,1100,1200,"Sub-basin 7"
3924,100,1,1500,1600,"Sub-basin 7"
3925,1600,122,22600,24200,"Sub-basin 7"
3926,500,37,2400,2900,"Sub-basin 7"
3927,200,6,1900,2100,"Sub-basin 7"
3928,400,18,2100,2500,"Sub-basin 7"
3929,1600,76,9100,10700,"Sub-basin 7"
3930,600,31,4500,5100,"Sub-basin 7"
3931,300,6,4500,4800,"Sub-basin 7"
3932,500,14,11100,11600,"Sub-basin 7"
3933,1800,82,14700,16500,"Sub-basin 7"
3934,100,1,1800,1900,"Sub-basin 7"
3935,600,39,4600,5200,"Sub-basin 7"
3936,100,4,1600,1700,"Sub-basin 7"
3937,100,1,2500,2600,"Sub-basin 7"
3938,600,39,5200,5800,"Sub-basin 7"
3939,200,7,4600,4800,"Sub-basin 7"
3940,100,5,1600,1700,"Sub-basin 7"
3941,200,9,3100,3300,"Sub-basin 7"
3942,200,4,1700,1900,"Sub-basin 7"
3943,100,1,500,600,"Sub-basin 7"
3944,1300,445,2700,4000,"Sub-basin 7"
3945,1200,85,2800,4000,"Sub-basin 7"
3946,100,1,2100,2200,"Sub-basin 7"
3947,200,4,1500,1700,"Sub-basin 7"
3948,100,1,2000,2100,"Sub-basin 7"
3949,1400,122,18900,20300,"Sub-basin 7"
3950,100,2,900,1000,"Sub-basin 7"
3951,300,12,1900,2200,"Sub-basin 7"
3952,4000,1181,8500,12500,"Sub-basin 7"
3953,100,1.0011,3800,3900,"Sub-basin 7"
3954,400,14,7900,8300,"Sub-basin 7"
3955,100,2,1300,1400,"Sub-basin 7"
3956,400,7,5300,5700,"Sub-basin 7"
3957,200,5,2500,2700,"Sub-basin 7"
3958,400,57,1900,2300,"Sub-basin 7"
3959,800,104,5800,6600,"Sub-basin 7"
3960,300,66,3100,3400,"Sub-basin 7"
3961,200,7,1800,2000,"Sub-basin 7"
3962,100,1,700,800,"Sub-basin 7"
3963,1300,398,2700,4000,"Sub-basin 7"
3964,900,27,9500,10400,"Sub-basin 7"
3965,600,15.0046,21800,22400,"Sub-basin 7"
3966,400,9,4200,4600,"Sub-basin 7"
3967,100,1,800,900,"Sub-basin 7"
3968,200,6,1400,1600,"Sub-basin 7"
3969,6100,1106.0445,24600,30700,"Sub-basin 7"
3970,100,2,2800,2900,"Sub-basin 7"
3971,700,75,3100,3800,"Sub-basin 7"
3972,100,2,2400,2500,"Sub-basin 7"
3973,400,30,2000,2400,"Sub-basin 7"
3974,200,4,2400,2600,"Sub-basin 7"
3975,100,4,800,900,"Sub-basin 7"
3976,200,10,3200,3400,"Sub-basin 7"
3977,3800,1223,14600,18400,"Sub-basin 7"
3978,100,2,1400,1500,"Sub-basin 7"
3979,100,2,900,1000,"Sub-basin 7"
3980,500,24,3400,3900,"Sub-basin 7"
3981,18800,10933.5476,23200,42300,"Sub-basin 7"
3982,100,3,2100,2200,"Sub-basin 7"
3983,100,2,1500,1600,"Sub-basin 7"
3984,200,5,1800,2000,"Sub-basin 7"
3985,900,36,4700,5600,"Sub-basin 7"
3986,100,4,1500,1600,"Sub-basin 7"
3987,100,1,2700,2800,"Sub-basin 7"
3988,4800,666,17400,22200,"Sub-basin 7"
3989,200,10,1600,1800,"Sub-basin 7"
3990,500,18,4300,4800,"Sub-basin 7"
3991,1300,146,3600,4900,"Sub-basin 7"
3992,400,27,3300,3700,"Sub-basin 7"
3993,100,7,2100,2200,"Sub-basin 7"
3994,200,6,1900,2100,"Sub-basin 7"
3995,600,11.0014,20400,21000,"Sub-basin 7"
3996,1800,225,14700,16500,"Sub-basin 7"
3997,500,28,2900,3400,"Sub-basin 7"
3998,400,57,3400,3800,"Sub-basin 7"
3999,400,32,5700,6100,"Sub-basin 7"
4000,600,14,4500,5100,"Sub-basin 7"
4001,600,28,6600,7200,"Sub-basin 7"
4002,500,51,3600,4100,"Sub-basin 7"
4003,400,27,4600,5000,"Sub-basin 7"
4004,2000,137,28500,30500,"Sub-basin 7"
4005,300,25,5500,5800,"Sub-basin 7"
4006,400,32,7300,7700,"Sub-basin 7"
4007,400,20,8200,8600,"Sub-basin 7"
4008,1000,64,12100,13100,"Sub-basin 7"
4009,1200,166,11500,12700,"Sub-basin 7"
4010,1300,83,3200,4500,"Sub-basin 7"
4011,100,5,1200,1300,"Sub-basin 7"
4012,1700,196,6500,8200,"Sub-basin 7"
4013,100,10,3100,3200,"Sub-basin 7"
4014,100,1,500,600,"Sub-basin 7"
4015,100,5,1500,1600,"Sub-basin 7"
4016,300,13,2700,3000,"Sub-basin 7"
4017,100,1,2900,3000,"Sub-basin 7"
4018,200,6,2500,2700,"Sub-basin 7"
4019,1400,397,2600,4000,"Sub-basin 7"
4020,700,55,3600,4300,"Sub-basin 7"
4021,1700,57,11400,13100,"Sub-basin 7"
4022,400,15,9500,9900,"Sub-basin 7"
4023,1300,93,2300,3600,"Sub-basin 7"
4024,2600,176,10400,13000,"Sub-basin 7"
4025,500,21,2300,2800,"Sub-basin 7"
4026,100,10,4400,4500,"Sub-basin 7"
4027,600,34,2600,3200,"Sub-basin 7"
4028,10400,1842.0506,69100,79500,"Sub-basin 7"
4029,100,1,1300,1400,"Sub-basin 7"
4030,100,1.0002,3200,3300,"Sub-basin 7"
4031,100,1,3700,3800,"Sub-basin 7"
4032,300,18,2900,3200,"Sub-basin 7"
4033,100,1,1600,1700,"Sub-basin 7"
4034,200,5,3400,3600,"Sub-basin 7"
4035,200,5,3600,3800,"Sub-basin 7"
4036,700,43,4100,4800,"Sub-basin 7"
4037,100,1,800,900,"Sub-basin 7"
4038,1600,138,14200,15800,"Sub-basin 7"
4039,100,1,1000,1100,"Sub-basin 7"
4040,200,12,2300,2500,"Sub-basin 7"
4041,1900,156,18400,20300,"Sub-basin 7"
4042,2000,94,12800,14800,"Sub-basin 7"
4043,100,1,1600,1700,"Sub-basin 7"
4044,100,4,1700,1800,"Sub-basin 7"
4045,1600,90,16900,18500,"Sub-basin 7"
4046,100,1,3100,3200,"Sub-basin 7"
4047,7600,2075,7700,15300,"Sub-basin 7"
4048,100,2,2200,2300,"Sub-basin 7"
4049,400,14,3100,3500,"Sub-basin 7"
4050,600,13,5700,6300,"Sub-basin 7"
4051,100,3,900,1000,"Sub-basin 7"
4052,100,1,1300,1400,"Sub-basin 7"
4053,500,25,4800,5300,"Sub-basin 7"
4054,200,2.0005,10400,10600,"Sub-basin 7"
4055,5300,3050,9500,14800,"Sub-basin 7"
4056,3300,310,16200,19500,"Sub-basin 7"
4057,200,11,2300,2500,"Sub-basin 7"
4058,200,4,1900,2100,"Sub-basin 7"
4059,200,3,3300,3500,"Sub-basin 7"
4060,1100,55,4500,5600,"Sub-basin 7"
4061,100,4,1600,1700,"Sub-basin 7"
4062,100,1.0001,200,300,"Sub-basin 7"
4063,200,3,7400,7600,"Sub-basin 7"
4064,200,4,3500,3700,"Sub-basin 7"
4065,100,2,2100,2200,"Sub-basin 7"
4066,1200,145,4700,5900,"Sub-basin 7"
4067,300,8.0007,12600,12900,"Sub-basin 7"
4068,400,13,1800,2200,"Sub-basin 7"
4069,100,4,1200,1300,"Sub-basin 7"
4070,500,17,2800,3300,"Sub-basin 7"
4071,200,4,2600,2800,"Sub-basin 7"
4072,100,2,600,700,"Sub-basin 7"
4073,500,16,3600,4100,"Sub-basin 7"
4074,300,6.17,4200,4500,"Sub-basin 7"
4075,4600,990,16000,20600,"Sub-basin 7"
4076,5800,886,22200,28000,"Sub-basin 7"
4077,1500,67,12300,13800,"Sub-basin 7"
4078,500,25,4100,4600,"Sub-basin 7"
4079,600,61,7400,8000,"Sub-basin 7"
4080,1100,52,6000,7100,"Sub-basin 7"
4081,100,3,700,800,"Sub-basin 7"
4082,1500,168,6200,7700,"Sub-basin 7"
4083,100,1,1800,1900,"Sub-basin 7"
4084,6100,2377,9100,15200,"Sub-basin 7"
4085,200,2,1500,1700,"Sub-basin 7"
4086,1100,68,11500,12600,"Sub-basin 7"
4087,1100,51,7600,8700,"Sub-basin 7"
4088,200,8,3700,3900,"Sub-basin 7"
4089,400,5.0015,16500,16900,"Sub-basin 7"
4090,200,7,1600,1800,"Sub-basin 7"
4091,100,6,1100,1200,"Sub-basin 7"
4092,100,2,1600,1700,"Sub-basin 7"
4093,900,60,1600,2500,"Sub-basin 7"
4094,100,2,1300,1400,"Sub-basin 7"
4095,300,16,2000,2300,"Sub-basin 7"
4096,400,26,2100,2500,"Sub-basin 7"
4097,400,14,3800,4200,"Sub-basin 7"
4098,500,14,4200,4700,"Sub-basin 7"
4099,600,36,4900,5500,"Sub-basin 7"
4100,200,13,1900,2100,"Sub-basin 7"
4101,100,1,1600,1700,"Sub-basin 7"
4102,100,2,2400,2500,"Sub-basin 7"
4103,1400,64,7600,9000,"Sub-basin 7"
4104,200,6,3100,3300,"Sub-basin 7"
4105,14600,3278,36200,50800,"Sub-basin 7"
4106,7400,2223,27600,35000,"Sub-basin 7"
4107,200,3,2000,2200,"Sub-basin 7"
4108,100,2,1200,1300,"Sub-basin 7"
4109,200,2,1400,1600,"Sub-basin 7"
4110,300,5.0007,8700,9000,"Sub-basin 7"
4111,100,2,1300,1400,"Sub-basin 7"
4112,1000,147,2600,3600,"Sub-basin 7"
4113,8500,2668,24400,32900,"Sub-basin 7"
4114,900,22,7900,8800,"Sub-basin 7"
4115,100,1,2600,2700,"Sub-basin 7"
4116,1800,268,3500,5300,"Sub-basin 7"
4117,500,16,3500,4000,"Sub-basin 7"
4118,100,1,900,1000,"Sub-basin 7"
4119,800,66,1300,2100,"Sub-basin 7"
4120,3600,686,7600,11200,"Sub-basin 7"
4121,200,3,3300,3500,"Sub-basin 7"
4122,200,4,5800,6000,"Sub-basin 7"
4123,2300,187,4400,6700,"Sub-basin 7"
4124,100,1,3100,3200,"Sub-basin 7"
4125,200,2.0005,5900,6100,"Sub-basin 7"
4126,100,1,1100,1200,"Sub-basin 7"
4127,400,19,2300,2700,"Sub-basin 7"
4128,600,37,1600,2200,"Sub-basin 7"
4129,700,63,10900,11600,"Sub-basin 7"
4130,700,37,2800,3500,"Sub-basin 7"
4131,800,35,15800,16600,"Sub-basin 7"
4132,100,1.0002,2900,3000,"Sub-basin 7"
4133,900,166,5000,5900,"Sub-basin 7"
4134,200,4,1200,1400,"Sub-basin 7"
4135,800,47,3400,4200,"Sub-basin 7"
4136,1100,156,4000,5100,"Sub-basin 7"
4137,1400,750,5700,7100,"Sub-basin 7"
4138,300,8,2300,2600,"Sub-basin 7"
4139,600,18,6900,7500,"Sub-basin 7"
4140,1200,59,12700,13900,"Sub-basin 7"
4141,100,4,800,900,"Sub-basin 7"
4142,200,4,800,1000,"Sub-basin 7"
4143,200,11,1000,1200,"Sub-basin 7"
4144,300,24,3900,4200,"Sub-basin 7"
4145,500,48,2500,3000,"Sub-basin 7"
4146,1100,244,3000,4100,"Sub-basin 7"
4147,1400,209,4800,6200,"Sub-basin 7"
4148,200,13,1600,1800,"Sub-basin 7"
4149,300,11,1400,1700,"Sub-basin 7"
4150,400,7,8600,9000,"Sub-basin 7"
4151,200,7,1200,1400,"Sub-basin 7"
4152,3100,333,8500,11600,"Sub-basin 7"
4153,900,127,5100,6000,"Sub-basin 7"
4154,100,2,900,1000,"Sub-basin 7"
4155,100,1,700,800,"Sub-basin 7"
4156,16400,5436,51000,67400,"Sub-basin 7"
4157,500,28,5700,6200,"Sub-basin 7"
4158,1200,147,3800,5000,"Sub-basin 7"
4159,300,3,4500,4800,"Sub-basin 7"
4160,900,37,18300,19200,"Sub-basin 7"
4161,400,14,4100,4500,"Sub-basin 7"
4162,200,2,2200,2400,"Sub-basin 7"
4163,400,29,4700,5100,"Sub-basin 7"
4164,800,33,5500,6300,"Sub-basin 7"
4165,600,83,1900,2500,"Sub-basin 7"
4166,400,9,4400,4800,"Sub-basin 7"
4167,500,18,4500,5000,"Sub-basin 7"
4168,200,2,1400,1600,"Sub-basin 7"
4169,300,4,3200,3500,"Sub-basin 7"
4170,100,1,1100,1200,"Sub-basin 7"
4171,1300,43,11700,13000,"Sub-basin 7"
4172,100,1,1700,1800,"Sub-basin 7"
4173,300,13,4000,4300,"Sub-basin 7"
4174,1500,156,3800,5300,"Sub-basin 7"
4175,200,5,1700,1900,"Sub-basin 7"
4176,100,1.0001,4000,4100,"Sub-basin 7"
4177,100,6,800,900,"Sub-basin 7"
4178,400,10,3900,4300,"Sub-basin 7"
4179,200,6,2600,2800,"Sub-basin 7"
4180,100,1,1500,1600,"Sub-basin 7"
4181,100,3,1400,1500,"Sub-basin 7"
4182,600,29.0006,5300,5900,"Sub-basin 7"
4183,3000,137,16700,19700,"Sub-basin 7"
4184,2800,163,20700,23500,"Sub-basin 7"
4185,600,61,1800,2400,"Sub-basin 7"
4186,100,2,2300,2400,"Sub-basin 7"
4187,900,42,6900,7800,"Sub-basin 7"
4188,100,5,1000,1100,"Sub-basin 7"
4189,6300,474,56500,62800,"Sub-basin 7"
4190,2300,147,20400,22700,"Sub-basin 7"
4191,300,14,3100,3400,"Sub-basin 7"
4192,100,1,2500,2600,"Sub-basin 7"
4193,300,6,2500,2800,"Sub-basin 7"
4194,200,6,2200,2400,"Sub-basin 7"
4195,2300,126,21000,23300,"Sub-basin 7"
4196,100,2,2500,2600,"Sub-basin 7"
4197,3900,237.0336,109300,113200,"Sub-basin 7"
4198,100,3,1300,1400,"Sub-basin 7"
4199,100,2,2400,2500,"Sub-basin 7"
4200,800,25,7600,8400,"Sub-basin 7"
4201,100,1,2700,2800,"Sub-basin 7"
4202,300,11,3700,4000,"Sub-basin 7"
4203,1300,58,7000,8300,"Sub-basin 7"
4204,1100,103,10700,11800,"Sub-basin 7"
4205,1300,64,10700,12000,"Sub-basin 7"
4206,2100,257.0037,16600,18700,"Sub-basin 7"
4207,1000,64,3900,4900,"Sub-basin 7"
4208,100,2,1700,1800,"Sub-basin 7"
4209,800,35,3800,4600,"Sub-basin 7"
4210,100,1,1200,1300,"Sub-basin 7"
4211,200,7,1900,2100,"Sub-basin 7"
4212,300,5,3000,3300,"Sub-basin 7"
4213,400,16,4500,4900,"Sub-basin 7"
4214,400,8,3200,3600,"Sub-basin 7"
4215,400,20,2400,2800,"Sub-basin 7"
4216,600,33,5700,6300,"Sub-basin 7"
4217,100,1,2800,2900,"Sub-basin 7"
4218,200,5,2100,2300,"Sub-basin 7"
4219,300,3,2400,2700,"Sub-basin 7"
4220,300,6,3200,3500,"Sub-basin 7"
4221,200,7,2700,2900,"Sub-basin 7"
4222,600,40,3300,3900,"Sub-basin 7"
4223,400,8,6200,6600,"Sub-basin 7"
4224,600,45.0006,5700,6300,"Sub-basin 7"
4225,400,8,7000,7400,"Sub-basin 7"
4226,300,12,4200,4500,"Sub-basin 7"
4227,200,2,500,700,"Sub-basin 7"
4228,300,3,4600,4900,"Sub-basin 7"
4229,900,87,14000,14900,"Sub-basin 7"
4230,300,85,4700,5000,"Sub-basin 7"
4231,1900,604,6100,8000,"Sub-basin 7"
4232,100,6,200,300,"Sub-basin 7"
4233,300,26,2600,2900,"Sub-basin 7"
4234,200,7,2500,2700,"Sub-basin 7"
4235,500,26.0003,5500,6000,"Sub-basin 7"
4236,2300,300,10400,12700,"Sub-basin 7"
4237,17500,6196,50100,67600,"Sub-basin 7"
4238,500,30,7500,8000,"Sub-basin 7"
4239,1400,509,1400,2800,"Sub-basin 7"
4240,400,27,4600,5000,"Sub-basin 7"
4241,100,4,400,500,"Sub-basin 7"
4242,200,8,1500,1700,"Sub-basin 7"
4243,100,2,3000,3100,"Sub-basin 7"
4244,100,4,1700,1800,"Sub-basin 7"
4245,400,13,4100,4500,"Sub-basin 7"
4246,100,1,1400,1500,"Sub-basin 7"
4247,300,8,4700,5000,"Sub-basin 7"
4248,100,2,1100,1200,"Sub-basin 7"
4249,300,12,5200,5500,"Sub-basin 7"
4250,200,5,1000,1200,"Sub-basin 7"
4251,200,3,4800,5000,"Sub-basin 7"
4252,100,2,2200,2300,"Sub-basin 7"
4253,300,11,2500,2800,"Sub-basin 7"
4254,200,7,1700,1900,"Sub-basin 7"
4255,400,15,4900,5300,"Sub-basin 7"
4256,100,1,2300,2400,"Sub-basin 7"
4257,600,30.0006,6000,6600,"Sub-basin 7"
4258,200,8,2300,2500,"Sub-basin 7"
4259,200,8,400,600,"Sub-basin 7"
4260,100,1,1300,1400,"Sub-basin 7"
4261,900,154,3400,4300,"Sub-basin 7"
4262,100,1,1200,1300,"Sub-basin 7"
4263,1100,107,20800,21900,"Sub-basin 7"
4264,100,4,800,900,"Sub-basin 7"
4265,100,2,100,200,"Sub-basin 7"
4266,1200,90,6500,7700,"Sub-basin 7"
4267,400,32,5700,6100,"Sub-basin 7"
4268,100,1,1400,1500,"Sub-basin 7"
4269,300,6,3100,3400,"Sub-basin 7"
4270,900,91,8900,9800,"Sub-basin 7"
4271,700,51,2100,2800,"Sub-basin 7"
4272,1400,536,6300,7700,"Sub-basin 7"
4273,100,4,1900,2000,"Sub-basin 7"
4274,100,3,1300,1400,"Sub-basin 7"
4275,1800,190,6700,8500,"Sub-basin 7"
4276,100,2,1900,2000,"Sub-basin 7"
4277,600,33,7800,8400,"Sub-basin 7"
4278,300,10,7500,7800,"Sub-basin 7"
4279,300,4.0007,8300,8600,"Sub-basin 7"
4280,1000,130,1900,2900,"Sub-basin 7"
4281,700,61,9100,9800,"Sub-basin 7"
4282,200,3,4000,4200,"Sub-basin 7"
4283,400,12,7000,7400,"Sub-basin 7"
4284,100,2,6900,7000,"Sub-basin 7"
4285,100,5,1700,1800,"Sub-basin 7"
4286,100,2,600,700,"Sub-basin 7"
4287,100,1,1300,1400,"Sub-basin 7"
4288,300,25,4600,4900,"Sub-basin 7"
4289,100,2,4000,4100,"Sub-basin 7"
4290,200,6,8200,8400,"Sub-basin 7"
4291,100,1.0002,4200,4300,"Sub-basin 7"
4292,100,1,1000,1100,"Sub-basin 7"
4293,100,2,1100,1200,"Sub-basin 7"
4294,500,105,2300,2800,"Sub-basin 7"
4295,100,16,1900,2000,"Sub-basin 7"
4296,300,16,6900,7200,"Sub-basin 7"
4297,500,19,3400,3900,"Sub-basin 7"
4298,800,125,5000,5800,"Sub-basin 7"
4299,100,1,2800,2900,"Sub-basin 7"
4300,100,1.0002,2100,2200,"Sub-basin 7"
4301,100,1,1300,1400,"Sub-basin 7"
4302,100,11,900,1000,"Sub-basin 7"
4303,600,22,11000,11600,"Sub-basin 7"
4304,200,7,1900,2100,"Sub-basin 7"
4305,100,1.0002,4200,4300,"Sub-basin 7"
4306,100,1.0001,3800,3900,"Sub-basin 7"
4307,200,22,4400,4600,"Sub-basin 7"
4308,100,5,3200,3300,"Sub-basin 7"
4309,400,11,5900,6300,"Sub-basin 7"
4310,100,2,2800,2900,"Sub-basin 7"
4311,200,3.0003,9200,9400,"Sub-basin 7"
4312,300,7.0012,13100,13400,"Sub-basin 7"
4313,100,1.0002,3700,3800,"Sub-basin 7"
4314,200,2.0007,8200,8400,"Sub-basin 7"
4315,300,9.0013,8900,9200,"Sub-basin 7"
4316,200,2.0007,8200,8400,"Sub-basin 7"
4317,1100,461,4900,6000,"Sub-basin 7"
4318,100,4,2600,2700,"Sub-basin 7"
4319,300,5.0007,11800,12100,"Sub-basin 7"
4320,500,37.0009,14500,15000,"Sub-basin 7"
4321,100,1.0003,3200,3300,"Sub-basin 7"
4322,200,3.0008,9000,9200,"Sub-basin 7"
4323,300,7.0014,11200,11500,"Sub-basin 7"
4324,200,16,10700,10900,"Sub-basin 7"
4325,100,3.0001,4200,4300,"Sub-basin 7"
4326,100,1,2400,2500,"Sub-basin 7"
4327,200,9.0002,6300,6500,"Sub-basin 7"
4328,400,5.0028,14500,14900,"Sub-basin 7"
4329,100,2.0012,3700,3800,"Sub-basin 7"
4330,1000,49,4600,5600,"Sub-basin 7"
4331,100,2,4700,4800,"Sub-basin 7"
4332,100,1,4000,4100,"Sub-basin 7"
4333,300,13.0007,8500,8800,"Sub-basin 7"
4334,100,3.0003,4900,5000,"Sub-basin 7"
4335,300,11.0006,10600,10900,"Sub-basin 7"
4336,200,4.0011,7700,7900,"Sub-basin 7"
4337,700,18.0051,20200,20900,"Sub-basin 7"
4338,100,1,3000,3100,"Sub-basin 7"
4339,100,1.0002,4500,4600,"Sub-basin 7"
4340,100,1.0002,4400,4500,"Sub-basin 7"
4341,900,57,24000,24900,"Sub-basin 7"
4342,100,1,3100,3200,"Sub-basin 7"
4343,900,52,20000,20900,"Sub-basin 7"
4344,300,14,1400,1700,"Sub-basin 7"
4345,100,1,2000,2100,"Sub-basin 7"
4346,100,2,3600,3700,"Sub-basin 7"
4347,300,12,3500,3800,"Sub-basin 7"
4348,400,27,1300,1700,"Sub-basin 7"
4349,200,8.0007,9100,9300,"Sub-basin 7"
4350,100,2.0002,3900,4000,"Sub-basin 7"
4351,200,6,8100,8300,"Sub-basin 7"
4352,500,15,10000,10500,"Sub-basin 7"
4353,100,6.0002,3200,3300,"Sub-basin 7"
4354,100,1,3900,4000,"Sub-basin 7"
4355,200,18,6700,6900,"Sub-basin 7"
4356,200,13,7400,7600,"Sub-basin 7"
4357,900,28.0044,26100,27000,"Sub-basin 7"
4358,600,51,5600,6200,"Sub-basin 7"
4359,400,9.001,15300,15700,"Sub-basin 7"
4360,100,3,3600,3700,"Sub-basin 7"
4361,400,35,9800,10200,"Sub-basin 7"
4362,600,7.0016,25100,25700,"Sub-basin 7"
4363,1000,82,4900,5900,"Sub-basin 7"
4364,500,9.0008,11700,12200,"Sub-basin 7"
4365,100,2,3300,3400,"Sub-basin 7"
4366,200,2,3600,3800,"Sub-basin 7"
4367,100,1.0001,3200,3300,"Sub-basin 7"
4368,100,3.0002,3900,4000,"Sub-basin 7"
4369,100,1.0005,2000,2100,"Sub-basin 7"
4370,600,20.0022,15700,16300,"Sub-basin 7"
4371,300,19,3600,3900,"Sub-basin 7"
4372,600,22,2000,2600,"Sub-basin 7"
4373,100,1,2300,2400,"Sub-basin 7"
4374,100,1.0002,4700,4800,"Sub-basin 7"
4375,100,1,3400,3500,"Sub-basin 7"
4376,100,4.0001,3900,4000,"Sub-basin 7"
4377,100,1,2900,3000,"Sub-basin 7"
4378,200,4.0007,8300,8500,"Sub-basin 7"
4379,100,6,3600,3700,"Sub-basin 7"
4380,1900,55.0075,48100,50000,"Sub-basin 7"
4381,100,4,4200,4300,"Sub-basin 7"
4382,100,3,2800,2900,"Sub-basin 7"
4383,200,8,4500,4700,"Sub-basin 7"
4384,100,3,2700,2800,"Sub-basin 7"
4385,200,5.0007,8600,8800,"Sub-basin 7"
4386,200,11,5800,6000,"Sub-basin 7"
4387,500,41,5500,6000,"Sub-basin 7"
4388,500,14,5400,5900,"Sub-basin 7"
4389,100,4,1800,1900,"Sub-basin 7"
4390,200,4.0003,7600,7800,"Sub-basin 7"
4391,100,2.0004,4200,4300,"Sub-basin 7"
4392,1400,248,13700,15100,"Sub-basin 7"
4393,8600,1119.0546,113600,122200,"Sub-basin 7"
4394,100,5,2500,2600,"Sub-basin 7"
4395,200,3,4800,5000,"Sub-basin 7"
4396,1200,77,10200,11400,"Sub-basin 7"
4397,200,12,4500,4700,"Sub-basin 7"
4398,100,1,300,400,"Sub-basin 7"
4399,100,1,200,300,"Sub-basin 7"
4400,400,34,7000,7400,"Sub-basin 7"
4401,1100,63,9100,10200,"Sub-basin 7"
4402,200,5,3900,4100,"Sub-basin 7"
4403,100,1.0003,6200,6300,"Sub-basin 7"
4404,100,1.0017,3400,3500,"Sub-basin 7"
4405,200,7,2500,2700,"Sub-basin 7"
4406,400,20,7200,7600,"Sub-basin 7"
4407,200,4,4500,4700,"Sub-basin 7"
4408,100,1,2800,2900,"Sub-basin 7"
4409,100,1.0005,5300,5400,"Sub-basin 7"
4410,100,4,1100,1200,"Sub-basin 7"
4411,100,3,2100,2200,"Sub-basin 7"
4412,1000,59,7100,8100,"Sub-basin 7"
4413,100,3,2300,2400,"Sub-basin 7"
4414,100,6,2000,2100,"Sub-basin 7"
4415,200,6,200,400,"Sub-basin 7"
4416,700,60,6600,7300,"Sub-basin 7"
4417,700,80,11000,11700,"Sub-basin 7"
4418,200,7,2900,3100,"Sub-basin 7"
4419,500,24,5300,5800,"Sub-basin 7"
4420,400,13,3700,4100,"Sub-basin 7"
4421,300,3,2800,3100,"Sub-basin 7"
4422,100,1,2800,2900,"Sub-basin 7"
4423,200,3,4000,4200,"Sub-basin 7"
4424,300,10,3800,4100,"Sub-basin 7"
4425,1700,159,12900,14600,"Sub-basin 7"
4426,100,2,2800,2900,"Sub-basin 7"
4427,300,8,14400,14700,"Sub-basin 7"
4428,100,7,1800,1900,"Sub-basin 7"
4429,700,101,4900,5600,"Sub-basin 7"
4430,100,2,1100,1200,"Sub-basin 7"
4431,1000,149,5600,6600,"Sub-basin 7"
4432,700,77,7200,7900,"Sub-basin 7"
4433,700,308,5400,6100,"Sub-basin 7"
4434,400,176,4100,4500,"Sub-basin 7"
4435,1200,107,13900,15100,"Sub-basin 7"
4436,300,18,2400,2700,"Sub-basin 7"
4437,200,4,4300,4500,"Sub-basin 7"
4438,200,5,3000,3200,"Sub-basin 7"
4439,200,4,1600,1800,"Sub-basin 7"
4440,700,99,5200,5900,"Sub-basin 7"
4441,300,8,4200,4500,"Sub-basin 7"
4442,700,76,7700,8400,"Sub-basin 7"
4443,2700,257,20500,23200,"Sub-basin 7"
4444,1100,92,17500,18600,"Sub-basin 7"
4445,900,54,9500,10400,"Sub-basin 7"
4446,200,8,1500,1700,"Sub-basin 7"
4447,100,3,900,1000,"Sub-basin 7"
4448,1000,144,2300,3300,"Sub-basin 7"
4449,500,52,5200,5700,"Sub-basin 7"
4450,100,4,1100,1200,"Sub-basin 7"
4451,100,2,800,900,"Sub-basin 7"
4452,200,5,2500,2700,"Sub-basin 7"
4453,3300,505,15900,19200,"Sub-basin 7"
4454,600,77,6100,6700,"Sub-basin 7"
4455,300,4,1200,1500,"Sub-basin 7"
4456,100,1.0001,4600,4700,"Sub-basin 7"
4457,600,37,7500,8100,"Sub-basin 7"
4458,300,32,5900,6200,"Sub-basin 7"
4459,400,12,3500,3900,"Sub-basin 7"
4460,700,28,6200,6900,"Sub-basin 7"
4461,100,4,1300,1400,"Sub-basin 7"
4462,200,13,1900,2100,"Sub-basin 7"
4463,700,84,6800,7500,"Sub-basin 7"
4464,100,3,2800,2900,"Sub-basin 7"
4465,400,5.0012,14500,14900,"Sub-basin 7"
4466,100,1,2300,2400,"Sub-basin 7"
4467,1100,67,14800,15900,"Sub-basin 7"
4468,300,10,5200,5500,"Sub-basin 7"
4469,3500,509,26700,30200,"Sub-basin 7"
4470,1600,174,16100,17700,"Sub-basin 7"
4471,1100,135,8400,9500,"Sub-basin 7"
4472,100,4,1300,1400,"Sub-basin 7"
4473,900,53,7500,8400,"Sub-basin 7"
4474,200,27,1500,1700,"Sub-basin 7"
4475,5900,937,40700,46600,"Sub-basin 7"
4476,800,58,6600,7400,"Sub-basin 7"
4477,1300,61,5700,7000,"Sub-basin 7"
4478,1500,112,9500,11000,"Sub-basin 7"
4479,300,11,2100,2400,"Sub-basin 7"
4480,300,12,2600,2900,"Sub-basin 7"
4481,400,16,1700,2100,"Sub-basin 7"
4482,800,109,2400,3200,"Sub-basin 7"
4483,7300,1450,25400,32700,"Sub-basin 7"
4484,700,129,2400,3100,"Sub-basin 7"
4485,100,7,100,200,"Sub-basin 7"
4486,200,8,3100,3300,"Sub-basin 7"
4487,100,1,1800,1900,"Sub-basin 7"
4488,100,4,1500,1600,"Sub-basin 7"
4489,300,12,1100,1400,"Sub-basin 7"
4490,500,22,11500,12000,"Sub-basin 7"
4491,100,1,1700,1800,"Sub-basin 7"
4492,300,15,2000,2300,"Sub-basin 7"
4493,500,41,4900,5400,"Sub-basin 7"
4494,100,1,1900,2000,"Sub-basin 7"
4495,200,4,3300,3500,"Sub-basin 7"
4496,700,60,4300,5000,"Sub-basin 7"
4497,300,21,4700,5000,"Sub-basin 7"
4498,200,4.0004,5200,5400,"Sub-basin 7"
4499,400,36,6500,6900,"Sub-basin 7"
4500,1500,265,6200,7700,"Sub-basin 7"
4501,100,1,300,400,"Sub-basin 7"
4502,1500,448,23700,25200,"Sub-basin 7"
4503,3800,1931,14400,18200,"Sub-basin 7"
4504,200,5,3200,3400,"Sub-basin 7"
4505,300,12,3900,4200,"Sub-basin 7"
4506,700,37,5300,6000,"Sub-basin 7"
4507,400,30,2500,2900,"Sub-basin 7"
4508,200,18,4100,4300,"Sub-basin 7"
4509,2800,962,10800,13600,"Sub-basin 7"
4510,100,1,4900,5000,"Sub-basin 7"
4511,100,2,1600,1700,"Sub-basin 7"
4512,100,2,0,100,"Sub-basin 7"
4513,300,4,3300,3600,"Sub-basin 7"
4514,400,12,1800,2200,"Sub-basin 7"
4515,100,2.0001,3900,4000,"Sub-basin 7"
4516,800,49,12700,13500,"Sub-basin 7"
4517,100,1,1300,1400,"Sub-basin 7"
4518,100,2,800,900,"Sub-basin 7"
4519,900,70,5000,5900,"Sub-basin 7"
4520,400,27,3200,3600,"Sub-basin 7"
4521,400,10,1900,2300,"Sub-basin 7"
4522,400,48,6800,7200,"Sub-basin 7"
4523,100,1,2000,2100,"Sub-basin 7"
4524,1900,415,15900,17800,"Sub-basin 7"
4525,900,30.0059,19400,20300,"Sub-basin 7"
4526,200,6,1600,1800,"Sub-basin 7"
4527,600,104,6300,6900,"Sub-basin 7"
4528,300,15,2400,2700,"Sub-basin 7"
4529,100,3,3800,3900,"Sub-basin 7"
4530,1400,379,4500,5900,"Sub-basin 7"
4531,200,25,6500,6700,"Sub-basin 7"
4532,400,127,3500,3900,"Sub-basin 7"
4533,400,95,1900,2300,"Sub-basin 7"
4534,100,2,800,900,"Sub-basin 7"
4535,500,26,3800,4300,"Sub-basin 7"
4536,100,2,800,900,"Sub-basin 7"
4537,1500,801,8600,10100,"Sub-basin 7"
4538,1200,324,1200,2400,"Sub-basin 7"
4539,22000,5545,45900,67900,"Sub-basin 7"
4540,600,94,3400,4000,"Sub-basin 7"
4541,400,22,4400,4800,"Sub-basin 7"
4542,100,3,900,1000,"Sub-basin 7"
4543,400,25,2500,2900,"Sub-basin 7"
4544,4100,328,14900,19000,"Sub-basin 7"
4545,100,5,1000,1100,"Sub-basin 7"
4546,200,16,1500,1700,"Sub-basin 7"
4547,100,1,1100,1200,"Sub-basin 7"
4548,1100,52,13000,14100,"Sub-basin 7"
4549,200,13,2500,2700,"Sub-basin 7"
4550,400,52,1600,2000,"Sub-basin 7"
4551,100,2,400,500,"Sub-basin 7"
4552,2500,916,7800,10300,"Sub-basin 7"
4553,200,7,2000,2200,"Sub-basin 7"
4554,400,7,3900,4300,"Sub-basin 7"
4555,100,2,1400,1500,"Sub-basin 7"
4556,800,78,4400,5200,"Sub-basin 7"
4557,100,2,1000,1100,"Sub-basin 7"
4558,1500,82,8500,10000,"Sub-basin 7"
4559,200,5,2300,2500,"Sub-basin 7"
4560,500,17,4400,4900,"Sub-basin 7"
4561,2300,180,15300,17600,"Sub-basin 7"
4562,23300,4653,48600,71900,"Sub-basin 7"
4563,1800,335,11200,13000,"Sub-basin 7"
4564,200,8,4600,4800,"Sub-basin 7"
4565,300,18,4900,5200,"Sub-basin 7"
4566,500,91,700,1200,"Sub-basin 7"
4567,1800,568,12500,14300,"Sub-basin 7"
4568,300,8,3300,3600,"Sub-basin 7"
4569,100,1,1300,1400,"Sub-basin 7"
4570,600,38,7700,8300,"Sub-basin 7"
4571,200,2,1700,1900,"Sub-basin 7"
4572,200,5,2300,2500,"Sub-basin 7"
4573,400,56,1300,1700,"Sub-basin 7"
4574,200,2,800,1000,"Sub-basin 7"
4575,100,3,1100,1200,"Sub-basin 7"
4576,5500,687,36800,42300,"Sub-basin 7"
4577,100,1,700,800,"Sub-basin 7"
4578,100,7,1800,1900,"Sub-basin 7"
4579,100,1,800,900,"Sub-basin 7"
4580,700,39,5500,6200,"Sub-basin 7"
4581,100,2,300,400,"Sub-basin 7"
4582,200,9,2600,2800,"Sub-basin 7"
4583,100,3,1300,1400,"Sub-basin 7"
4584,200,6,2900,3100,"Sub-basin 7"
4585,100,2,1800,1900,"Sub-basin 7"
4586,700,35,2700,3400,"Sub-basin 7"
4587,600,44,4600,5200,"Sub-basin 7"
4588,100,1,1100,1200,"Sub-basin 7"
4589,100,2,200,300,"Sub-basin 7"
4590,500,31,3100,3600,"Sub-basin 7"
4591,100,2,1100,1200,"Sub-basin 7"
4592,300,9,3000,3300,"Sub-basin 7"
4593,200,2,2400,2600,"Sub-basin 7"
4594,10200,981,53200,63400,"Sub-basin 7"
4595,200,7,3600,3800,"Sub-basin 7"
4596,200,5,1700,1900,"Sub-basin 7"
4597,100,1,1200,1300,"Sub-basin 7"
4598,200,5,2100,2300,"Sub-basin 7"
4599,100,4,2100,2200,"Sub-basin 7"
4600,200,7,2900,3100,"Sub-basin 7"
4601,900,83,4200,5100,"Sub-basin 7"
4602,100,4,1100,1200,"Sub-basin 7"
4603,700,26,4000,4700,"Sub-basin 7"
4604,1200,55,12500,13700,"Sub-basin 7"
4605,100,1,2400,2500,"Sub-basin 7"
4606,200,4,1600,1800,"Sub-basin 7"
4607,400,25,2200,2600,"Sub-basin 7"
4608,100,1,1800,1900,"Sub-basin 7"
4609,300,6,2200,2500,"Sub-basin 7"
4610,1200,103,5900,7100,"Sub-basin 7"
4611,100,1,1700,1800,"Sub-basin 7"
4612,300,22,2900,3200,"Sub-basin 7"
4613,500,21,5900,6400,"Sub-basin 7"
4614,300,16,3400,3700,"Sub-basin 7"
4615,100,1,1900,2000,"Sub-basin 7"
4616,1200,75,5000,6200,"Sub-basin 7"
4617,200,6,1800,2000,"Sub-basin 7"
4618,1200,79,10600,11800,"Sub-basin 7"
4619,100,2,1200,1300,"Sub-basin 7"
4620,2800,233,13000,15800,"Sub-basin 7"
4621,200,4,1800,2000,"Sub-basin 7"
4622,200,5,2000,2200,"Sub-basin 7"
4623,1000,40,6500,7500,"Sub-basin 7"
4624,200,11,2700,2900,"Sub-basin 7"
4625,200,5,1800,2000,"Sub-basin 7"
4626,300,10,2100,2400,"Sub-basin 7"
4627,1700,83,18400,20100,"Sub-basin 7"
4628,2000,182,5300,7300,"Sub-basin 7"
4629,300,16,1500,1800,"Sub-basin 7"
4630,1200,54,8400,9600,"Sub-basin 7"
4631,200,11,2100,2300,"Sub-basin 7"
4632,100,2,700,800,"Sub-basin 7"
4633,500,24,6800,7300,"Sub-basin 7"
4634,100,6,300,400,"Sub-basin 7"
4635,800,15,7600,8400,"Sub-basin 7"
4636,1500,80,9100,10600,"Sub-basin 7"
4637,800,47,4400,5200,"Sub-basin 7"
4638,100,2,1600,1700,"Sub-basin 7"
4639,400,28,600,1000,"Sub-basin 7"
4640,100,1,1600,1700,"Sub-basin 7"
4641,1400,137,4500,5900,"Sub-basin 7"
4642,700,41,4600,5300,"Sub-basin 7"
4643,100,2,1300,1400,"Sub-basin 7"
4644,200,5,1600,1800,"Sub-basin 7"
4645,400,10,3300,3700,"Sub-basin 7"
4646,4300,338,11400,15700,"Sub-basin 7"
4647,400,32,3200,3600,"Sub-basin 7"
4648,8600,1459,43100,51700,"Sub-basin 7"
4649,300,14,2500,2800,"Sub-basin 7"
4650,200,5,1000,1200,"Sub-basin 7"
4651,900,337,4200,5100,"Sub-basin 7"
4652,100,6,1200,1300,"Sub-basin 7"
4653,200,12,2200,2400,"Sub-basin 7"
4654,100,2,1700,1800,"Sub-basin 7"
4655,300,7,3100,3400,"Sub-basin 7"
4656,100,1,1400,1500,"Sub-basin 7"
4657,300,6,2500,2800,"Sub-basin 7"
4658,100,1,900,1000,"Sub-basin 7"
4659,200,3,2400,2600,"Sub-basin 7"
4660,100,2,1700,1800,"Sub-basin 7"
4661,300,8,1800,2100,"Sub-basin 7"
4662,1000,30,4900,5900,"Sub-basin 7"
4663,500,12,6300,6800,"Sub-basin 7"
4664,800,60,3600,4400,"Sub-basin 7"
4665,2800,188,10200,13000,"Sub-basin 7"
4666,1200,59,8200,9400,"Sub-basin 7"
4667,200,9,1400,1600,"Sub-basin 7"
4668,200,8,1600,1800,"Sub-basin 7"
4669,400,20,2500,2900,"Sub-basin 7"
4670,700,45,4300,5000,"Sub-basin 7"
4671,300,9,3300,3600,"Sub-basin 7"
4672,300,12,2800,3100,"Sub-basin 7"
4673,1700,149,4700,6400,"Sub-basin 7"
4674,100,1,800,900,"Sub-basin 7"
4675,4400,1856,5600,10000,"Sub-basin 7"
4676,200,7,1800,2000,"Sub-basin 7"
4677,100,2,400,500,"Sub-basin 7"
4678,1600,254,4000,5600,"Sub-basin 7"
4679,200,3,3300,3500,"Sub-basin 7"
4680,100,4,2900,3000,"Sub-basin 7"
4681,100,3,800,900,"Sub-basin 7"
4682,400,15,2000,2400,"Sub-basin 7"
4683,500,54,3600,4100,"Sub-basin 7"
4684,22800,3663,60300,83100,"Sub-basin 7"
4685,300,4,2200,2500,"Sub-basin 7"
4686,200,3,2700,2900,"Sub-basin 7"
4687,400,21,2100,2500,"Sub-basin 7"
4688,100,1,1500,1600,"Sub-basin 7"
4689,600,87,2400,3000,"Sub-basin 7"
4690,400,7,2800,3200,"Sub-basin 7"
4691,300,11,2100,2400,"Sub-basin 7"
4692,300,4,3800,4100,"Sub-basin 7"
4693,300,13,3100,3400,"Sub-basin 7"
4694,2000,184,6400,8400,"Sub-basin 7"
4695,300,9,2300,2600,"Sub-basin 7"
4696,1400,39,11700,13100,"Sub-basin 7"
4697,200,7,1400,1600,"Sub-basin 7"
4698,400,11,3300,3700,"Sub-basin 7"
4699,300,5,2100,2400,"Sub-basin 7"
4700,100,1,1200,1300,"Sub-basin 7"
4701,200,5,1800,2000,"Sub-basin 7"
4702,400,13,4200,4600,"Sub-basin 7"
4703,200,17,2300,2500,"Sub-basin 7"
4704,200,8.34,600,800,"Sub-basin 7"
4705,800,27,5700,6500,"Sub-basin 7"
4706,1100,94,4400,5500,"Sub-basin 7"
4707,1900,161,11600,13500,"Sub-basin 7"
4708,100,1,400,500,"Sub-basin 7"
4709,500,25,2900,3400,"Sub-basin 7"
4710,100,1,1000,1100,"Sub-basin 7"
4711,200,3,2400,2600,"Sub-basin 7"
4712,900,31,4100,5000,"Sub-basin 7"
4713,200,3,1700,1900,"Sub-basin 7"
4714,100,3,600,700,"Sub-basin 7"
4715,200,3,800,1000,"Sub-basin 7"
4716,300,14,2000,2300,"Sub-basin 7"
4717,300,11,2900,3200,"Sub-basin 7"
4718,500,27,3400,3900,"Sub-basin 7"
4719,100,1,900,1000,"Sub-basin 7"
4720,100,2,1100,1200,"Sub-basin 7"
4721,400,17,5200,5600,"Sub-basin 7"
4722,100,0.67,1600,1700,"Sub-basin 7"
4723,100,1,800,900,"Sub-basin 7"
4724,100,5,2100,2200,"Sub-basin 7"
4725,100,2,1100,1200,"Sub-basin 7"
4726,200,7,2100,2300,"Sub-basin 7"
4727,300,6,1400,1700,"Sub-basin 7"
4728,3000,300,6400,9400,"Sub-basin 7"
4729,1100,67,5700,6800,"Sub-basin 7"
4730,300,3,1300,1600,"Sub-basin 7"
4731,100,3,1100,1200,"Sub-basin 7"
4732,2000,154,6600,8600,"Sub-basin 7"
4733,1300,154,7100,8400,"Sub-basin 7"
4734,6100,1704,11200,17300,"Sub-basin 7"
4735,2300,956,3400,5700,"Sub-basin 7"
4736,700,27,1600,2300,"Sub-basin 7"
4737,500,46,1600,2100,"Sub-basin 7"
4738,3900,1101,2600,6500,"Sub-basin 7"
4739,2400,848,2700,5100,"Sub-basin 7"
4740,100,10,500,600,"Sub-basin 7"
1,300,90,0,300,"Sub-basin 8"
2,1000,339.941,0,1000,"Sub-basin 8"
3,400,140.0592,0,400,"Sub-basin 8"
4,1000,300,0,1000,"Sub-basin 8"
5,300,78,0,300,"Sub-basin 8"
6,700,372.0003,0,700,"Sub-basin 8"
7,800,240,0,800,"Sub-basin 8"
8,4600,1319,6700,11300,"Sub-basin 8"
9,1900,622,5400,7300,"Sub-basin 8"
10,2600,696,5900,8500,"Sub-basin 8"
11,4700,1757.83,8300,13000,"Sub-basin 8"
12,400,27,1100,1500,"Sub-basin 8"
13,9500,4398,11400,20900,"Sub-basin 8"
14,200,4,400,600,"Sub-basin 8"
15,7900,1196,8100,16000,"Sub-basin 8"
16,100,6,800,900,"Sub-basin 8"
17,3000,575,6700,9700,"Sub-basin 8"
18,400,43,1000,1400,"Sub-basin 8"
19,2500,455,5500,8000,"Sub-basin 8"
20,900,109,4100,5000,"Sub-basin 8"
21,200,5,1600,1800,"Sub-basin 8"
22,400,19,3900,4300,"Sub-basin 8"
23,600,43,5100,5700,"Sub-basin 8"
24,700,82,6600,7300,"Sub-basin 8"
25,5800,845,18700,24500,"Sub-basin 8"
26,8100,1984,18400,26500,"Sub-basin 8"
27,700,77,6000,6700,"Sub-basin 8"
28,400,50,500,900,"Sub-basin 8"
29,13700,7602,15000,28700,"Sub-basin 8"
30,200,4,1700,1900,"Sub-basin 8"
31,2500,803,7000,9500,"Sub-basin 8"
32,6900,2107,13200,20100,"Sub-basin 8"
33,800,164,1400,2200,"Sub-basin 8"
34,300,13,2500,2800,"Sub-basin 8"
35,800,152,2300,3100,"Sub-basin 8"
36,2200,816,10300,12500,"Sub-basin 8"
37,700,58,3000,3700,"Sub-basin 8"
38,100,4,800,900,"Sub-basin 8"
39,100,1,600,700,"Sub-basin 8"
40,100,4,600,700,"Sub-basin 8"
41,900,138,3700,4600,"Sub-basin 8"
42,400,27,1600,2000,"Sub-basin 8"
43,1400,432,4600,6000,"Sub-basin 8"
44,3200,846,8000,11200,"Sub-basin 8"
45,13600,1708,33300,46900,"Sub-basin 8"
46,100,1,1100,1200,"Sub-basin 8"
47,100,5,800,900,"Sub-basin 8"
48,2200,906,6600,8800,"Sub-basin 8"
49,500,38,2200,2700,"Sub-basin 8"
50,100,1,900,1000,"Sub-basin 8"
51,100,5,1000,1100,"Sub-basin 8"
52,100,2,1000,1100,"Sub-basin 8"
53,100,4,1000,1100,"Sub-basin 8"
54,100,2,1300,1400,"Sub-basin 8"
55,300,33,900,1200,"Sub-basin 8"
56,800,94,3000,3800,"Sub-basin 8"
57,100,2,700,800,"Sub-basin 8"
58,1600,382,3700,5300,"Sub-basin 8"
59,200,15,1900,2100,"Sub-basin 8"
60,2300,154,10800,13100,"Sub-basin 8"
61,1200,248,3900,5100,"Sub-basin 8"
62,500,59,3000,3500,"Sub-basin 8"
63,2400,356,8800,11200,"Sub-basin 8"
64,100,10,1900,2000,"Sub-basin 8"
65,100,1,1100,1200,"Sub-basin 8"
66,3300,529,10200,13500,"Sub-basin 8"
67,3300,366,18600,21900,"Sub-basin 8"
68,1700,195,10600,12300,"Sub-basin 8"
69,1800,146,8100,9900,"Sub-basin 8"
70,1800,225,2300,4100,"Sub-basin 8"
71,900,82,5100,6000,"Sub-basin 8"
72,300,3,1500,1800,"Sub-basin 8"
73,900,44,4000,4900,"Sub-basin 8"
74,1400,130,7800,9200,"Sub-basin 8"
75,100,1,1900,2000,"Sub-basin 8"
76,700,162,3300,4000,"Sub-basin 8"
77,400,11,1600,2000,"Sub-basin 8"
78,3400,403,11900,15300,"Sub-basin 8"
79,800,129,4900,5700,"Sub-basin 8"
80,600,34,3100,3700,"Sub-basin 8"
81,200,10,3500,3700,"Sub-basin 8"
82,1500,178,5200,6700,"Sub-basin 8"
83,400,18,2600,3000,"Sub-basin 8"
84,1600,283,4200,5800,"Sub-basin 8"
85,300,7,2600,2900,"Sub-basin 8"
86,1100,121,9200,10300,"Sub-basin 8"
87,4400,566,10800,15200,"Sub-basin 8"
88,400,10,900,1300,"Sub-basin 8"
89,3500,440,17000,20500,"Sub-basin 8"
90,100,19,1200,1300,"Sub-basin 8"
91,200,10,3600,3800,"Sub-basin 8"
92,1100,75,5800,6900,"Sub-basin 8"
93,100,2,1200,1300,"Sub-basin 8"
94,200,5,1500,1700,"Sub-basin 8"
95,300,15,3800,4100,"Sub-basin 8"
96,2700,206,17300,20000,"Sub-basin 8"
97,1800,342,5800,7600,"Sub-basin 8"
98,500,30,2600,3100,"Sub-basin 8"
99,100,1,1100,1200,"Sub-basin 8"
100,100,2,2100,2200,"Sub-basin 8"
101,100,1,2400,2500,"Sub-basin 8"
102,800,49,8700,9500,"Sub-basin 8"
103,700,43,4300,5000,"Sub-basin 8"
104,200,10,2100,2300,"Sub-basin 8"
105,2600,434,9700,12300,"Sub-basin 8"
106,2200,179,10200,12400,"Sub-basin 8"
107,200,4,2900,3100,"Sub-basin 8"
108,3300,362,12300,15600,"Sub-basin 8"
109,100,4,500,600,"Sub-basin 8"
110,800,88,2600,3400,"Sub-basin 8"
111,100,4,2100,2200,"Sub-basin 8"
112,500,23,8300,8800,"Sub-basin 8"
113,100,2,1800,1900,"Sub-basin 8"
114,1000,228,1400,2400,"Sub-basin 8"
115,900,77,5300,6200,"Sub-basin 8"
116,1200,100,5600,6800,"Sub-basin 8"
117,200,6,400,600,"Sub-basin 8"
118,1100,87,4400,5500,"Sub-basin 8"
119,300,5,3100,3400,"Sub-basin 8"
120,200,2,2700,2900,"Sub-basin 8"
121,300,22,800,1100,"Sub-basin 8"
122,100,2,600,700,"Sub-basin 8"
123,1200,106,6300,7500,"Sub-basin 8"
124,400,30,3800,4200,"Sub-basin 8"
125,2600,264.66,10600,13200,"Sub-basin 8"
126,100,2,1200,1300,"Sub-basin 8"
127,400,10,3800,4200,"Sub-basin 8"
128,200,4,1400,1600,"Sub-basin 8"
129,300,9,4200,4500,"Sub-basin 8"
130,200,6,2500,2700,"Sub-basin 8"
131,100,3,2200,2300,"Sub-basin 8"
132,2600,557.5,4800,7400,"Sub-basin 8"
133,1000,89,1600,2600,"Sub-basin 8"
134,100,1,1100,1200,"Sub-basin 8"
135,200,5,4200,4400,"Sub-basin 8"
136,6400,855,33000,39400,"Sub-basin 8"
137,300,7,2100,2400,"Sub-basin 8"
138,400,10,3000,3400,"Sub-basin 8"
139,100,1,0,100,"Sub-basin 8"
140,100,2,2200,2300,"Sub-basin 8"
141,900,86,6800,7700,"Sub-basin 8"
142,4200,634,15200,19400,"Sub-basin 8"
143,2400,316,13000,15400,"Sub-basin 8"
144,2200,149,20700,22900,"Sub-basin 8"
145,500,8,2600,3100,"Sub-basin 8"
146,3300,218,20100,23400,"Sub-basin 8"
147,100,2,700,800,"Sub-basin 8"
148,1200,112,9100,10300,"Sub-basin 8"
149,600,52,3800,4400,"Sub-basin 8"
150,800,62,2900,3700,"Sub-basin 8"
151,2000,285,5100,7100,"Sub-basin 8"
152,1200,156,10300,11500,"Sub-basin 8"
153,400,10,400,800,"Sub-basin 8"
154,300,7,2300,2600,"Sub-basin 8"
155,400,7,4600,5000,"Sub-basin 8"
156,100,1,2100,2200,"Sub-basin 8"
157,400,20,1400,1800,"Sub-basin 8"
158,1100,82,6900,8000,"Sub-basin 8"
159,3400,447,11500,14900,"Sub-basin 8"
160,100,3,3000,3100,"Sub-basin 8"
161,100,1,1000,1100,"Sub-basin 8"
162,400,16,1600,2000,"Sub-basin 8"
163,1600,281,4600,6200,"Sub-basin 8"
164,400,12,5000,5400,"Sub-basin 8"
165,800,43,6200,7000,"Sub-basin 8"
166,600,58,2400,3000,"Sub-basin 8"
167,900,121,3900,4800,"Sub-basin 8"
168,100,3,1900,2000,"Sub-basin 8"
169,2900,275,21500,24400,"Sub-basin 8"
170,600,32,4000,4600,"Sub-basin 8"
171,1200,98,11600,12800,"Sub-basin 8"
172,100,6,1300,1400,"Sub-basin 8"
173,100,1,900,1000,"Sub-basin 8"
174,1200,171,4600,5800,"Sub-basin 8"
175,200,14,2300,2500,"Sub-basin 8"
176,100,2,1400,1500,"Sub-basin 8"
177,700,68,4800,5500,"Sub-basin 8"
178,1000,71,5200,6200,"Sub-basin 8"
179,1900,186,7300,9200,"Sub-basin 8"
180,500,19,1200,1700,"Sub-basin 8"
181,1500,205,4800,6300,"Sub-basin 8"
182,200,5,1300,1500,"Sub-basin 8"
183,100,1,2000,2100,"Sub-basin 8"
184,600,35,3900,4500,"Sub-basin 8"
185,500,27,3000,3500,"Sub-basin 8"
186,500,25,4500,5000,"Sub-basin 8"
187,900,37,9900,10800,"Sub-basin 8"
188,1500,138,7300,8800,"Sub-basin 8"
189,2900,353,15100,18000,"Sub-basin 8"
190,1300,208,5200,6500,"Sub-basin 8"
191,100,1,2100,2200,"Sub-basin 8"
192,12900,2353,64200,77100,"Sub-basin 8"
193,200,5,1100,1300,"Sub-basin 8"
194,900,42,10400,11300,"Sub-basin 8"
195,300,19,800,1100,"Sub-basin 8"
196,28800,8747,38300,67100,"Sub-basin 8"
197,900,154,4600,5500,"Sub-basin 8"
198,9900,1600,46300,56200,"Sub-basin 8"
199,600,71,5100,5700,"Sub-basin 8"
200,100,3,2200,2300,"Sub-basin 8"
201,100,1,1900,2000,"Sub-basin 8"
202,100,2,400,500,"Sub-basin 8"
203,200,22,1900,2100,"Sub-basin 8"
204,700,52,5000,5700,"Sub-basin 8"
205,100,5,800,900,"Sub-basin 8"
206,100,2,1300,1400,"Sub-basin 8"
207,400,12,2900,3300,"Sub-basin 8"
208,1400,64,9700,11100,"Sub-basin 8"
209,200,2,2200,2400,"Sub-basin 8"
210,600,113,4000,4600,"Sub-basin 8"
211,1400,342,5300,6700,"Sub-basin 8"
212,1500,189,6400,7900,"Sub-basin 8"
213,1100,52,7800,8900,"Sub-basin 8"
214,100,3,1100,1200,"Sub-basin 8"
215,100,1,2000,2100,"Sub-basin 8"
216,100,2,1300,1400,"Sub-basin 8"
217,200,4,500,700,"Sub-basin 8"
218,700,61,2400,3100,"Sub-basin 8"
219,2200,513,7800,10000,"Sub-basin 8"
220,200,30,1100,1300,"Sub-basin 8"
221,1200,147,3900,5100,"Sub-basin 8"
222,100,1,600,700,"Sub-basin 8"
223,100,1,700,800,"Sub-basin 8"
224,200,20,1100,1300,"Sub-basin 8"
225,700,96,5300,6000,"Sub-basin 8"
226,1600,225,11100,12700,"Sub-basin 8"
227,2200,245,5400,7600,"Sub-basin 8"
228,200,28,1900,2100,"Sub-basin 8"
229,100,5,1600,1700,"Sub-basin 8"
230,200,26,1100,1300,"Sub-basin 8"
231,1600,293,3700,5300,"Sub-basin 8"
232,700,107,8500,9200,"Sub-basin 8"
233,100,1,600,700,"Sub-basin 8"
234,300,5,2300,2600,"Sub-basin 8"
235,100,2,1500,1600,"Sub-basin 8"
236,200,3,2400,2600,"Sub-basin 8"
237,300,12,3700,4000,"Sub-basin 8"
238,100,2,2300,2400,"Sub-basin 8"
239,600,66,4700,5300,"Sub-basin 8"
240,400,45,3600,4000,"Sub-basin 8"
241,500,21,4100,4600,"Sub-basin 8"
242,2000,96,23300,25300,"Sub-basin 8"
243,100,2,2100,2200,"Sub-basin 8"
244,900,300,2100,3000,"Sub-basin 8"
245,2900,252,12700,15600,"Sub-basin 8"
246,700,55,3700,4400,"Sub-basin 8"
247,100,2,1500,1600,"Sub-basin 8"
248,200,7,6400,6600,"Sub-basin 8"
249,3600,667,11200,14800,"Sub-basin 8"
250,200,7,2700,2900,"Sub-basin 8"
251,100,3,1800,1900,"Sub-basin 8"
252,1200,145,5900,7100,"Sub-basin 8"
253,1400,214,6200,7600,"Sub-basin 8"
254,700,48,5300,6000,"Sub-basin 8"
255,400,16,5000,5400,"Sub-basin 8"
256,100,1,1700,1800,"Sub-basin 8"
257,200,6,1800,2000,"Sub-basin 8"
258,6600,475,54000,60600,"Sub-basin 8"
259,100,8,1600,1700,"Sub-basin 8"
260,500,44,2400,2900,"Sub-basin 8"
261,400,21,4000,4400,"Sub-basin 8"
262,1200,91,9200,10400,"Sub-basin 8"
263,300,6,3800,4100,"Sub-basin 8"
264,300,12,1300,1600,"Sub-basin 8"
265,400,17,5200,5600,"Sub-basin 8"
266,100,1,2000,2100,"Sub-basin 8"
267,100,1,1700,1800,"Sub-basin 8"
268,500,85,1300,1800,"Sub-basin 8"
269,400,30,2400,2800,"Sub-basin 8"
270,300,5,2700,3000,"Sub-basin 8"
271,400,64,2700,3100,"Sub-basin 8"
272,1300,202,4600,5900,"Sub-basin 8"
273,400,40,5900,6300,"Sub-basin 8"
274,2600,484,11100,13700,"Sub-basin 8"
275,100,1,1200,1300,"Sub-basin 8"
276,200,5,1300,1500,"Sub-basin 8"
277,500,17,3500,4000,"Sub-basin 8"
278,900,49,5500,6400,"Sub-basin 8"
279,1200,191,7100,8300,"Sub-basin 8"
280,700,32,4700,5400,"Sub-basin 8"
281,300,6,1900,2200,"Sub-basin 8"
282,100,1,1400,1500,"Sub-basin 8"
283,500,18,4200,4700,"Sub-basin 8"
284,2600,235,13300,15900,"Sub-basin 8"
285,100,2,2000,2100,"Sub-basin 8"
286,4400,576.5,37100,41500,"Sub-basin 8"
287,600,69,6500,7100,"Sub-basin 8"
288,600,39,5900,6500,"Sub-basin 8"
289,1000,149,8400,9400,"Sub-basin 8"
290,1800,328,7500,9300,"Sub-basin 8"
291,200,2,1500,1700,"Sub-basin 8"
292,400,15,2200,2600,"Sub-basin 8"
293,2400,352,10200,12600,"Sub-basin 8"
294,200,9,3100,3300,"Sub-basin 8"
295,600,47,4100,4700,"Sub-basin 8"
296,200,4,900,1100,"Sub-basin 8"
297,900,214,1500,2400,"Sub-basin 8"
298,400,19,4800,5200,"Sub-basin 8"
299,1200,78,11500,12700,"Sub-basin 8"
300,200,6,700,900,"Sub-basin 8"
301,1600,150,9100,10700,"Sub-basin 8"
302,200,10,1400,1600,"Sub-basin 8"
303,1100,78,6600,7700,"Sub-basin 8"
304,600,53,3200,3800,"Sub-basin 8"
305,12500,2295,41900,54400,"Sub-basin 8"
306,100,4,1900,2000,"Sub-basin 8"
307,100,2,1100,1200,"Sub-basin 8"
308,200,2,2000,2200,"Sub-basin 8"
309,100,3,1000,1100,"Sub-basin 8"
310,200,7,1200,1400,"Sub-basin 8"
311,2000,357,11500,13500,"Sub-basin 8"
312,100,6,1300,1400,"Sub-basin 8"
313,100,4,1300,1400,"Sub-basin 8"
314,1300,136,5500,6800,"Sub-basin 8"
315,800,60,2100,2900,"Sub-basin 8"
316,5800,1005.17,15300,21100,"Sub-basin 8"
317,600,77,6100,6700,"Sub-basin 8"
318,2900,245,13500,16400,"Sub-basin 8"
319,800,40,4200,5000,"Sub-basin 8"
320,900,108,4200,5100,"Sub-basin 8"
321,100,2,500,600,"Sub-basin 8"
322,700,69,3000,3700,"Sub-basin 8"
323,800,50,6400,7200,"Sub-basin 8"
324,300,3,800,1100,"Sub-basin 8"
325,400,16,2200,2600,"Sub-basin 8"
326,100,1,1700,1800,"Sub-basin 8"
327,1300,125,7400,8700,"Sub-basin 8"
328,100,3,1300,1400,"Sub-basin 8"
329,600,50,5400,6000,"Sub-basin 8"
330,700,40,4900,5600,"Sub-basin 8"
331,400,9,3900,4300,"Sub-basin 8"
332,600,24,2500,3100,"Sub-basin 8"
333,1000,32,8300,9300,"Sub-basin 8"
334,400,33,2700,3100,"Sub-basin 8"
335,100,2,900,1000,"Sub-basin 8"
336,3400,362,8700,12100,"Sub-basin 8"
337,700,32,4900,5600,"Sub-basin 8"
338,400,9,2400,2800,"Sub-basin 8"
339,800,57,3900,4700,"Sub-basin 8"
340,500,28,3100,3600,"Sub-basin 8"
341,400,11,4200,4600,"Sub-basin 8"
342,800,68,6600,7400,"Sub-basin 8"
343,200,12,2900,3100,"Sub-basin 8"
344,2300,261,13800,16100,"Sub-basin 8"
345,100,1,700,800,"Sub-basin 8"
346,200,5,1700,1900,"Sub-basin 8"
347,300,6,2600,2900,"Sub-basin 8"
348,2800,236,12700,15500,"Sub-basin 8"
349,3000,705,4900,7900,"Sub-basin 8"
350,600,25,4200,4800,"Sub-basin 8"
351,1000,136,5100,6100,"Sub-basin 8"
352,100,1,700,800,"Sub-basin 8"
353,500,28,4100,4600,"Sub-basin 8"
354,500,15,3800,4300,"Sub-basin 8"
355,100,1,400,500,"Sub-basin 8"
356,100,9,400,500,"Sub-basin 8"
357,100,2,1900,2000,"Sub-basin 8"
358,1600,264,13200,14800,"Sub-basin 8"
359,400,21,3000,3400,"Sub-basin 8"
360,200,16,2000,2200,"Sub-basin 8"
361,1600,255,10900,12500,"Sub-basin 8"
362,200,4,4500,4700,"Sub-basin 8"
363,1100,142,6700,7800,"Sub-basin 8"
364,800,75,6000,6800,"Sub-basin 8"
365,200,16,1400,1600,"Sub-basin 8"
366,300,18,4600,4900,"Sub-basin 8"
367,100,1,1800,1900,"Sub-basin 8"
368,400,23,3100,3500,"Sub-basin 8"
369,3100,313,11100,14200,"Sub-basin 8"
370,100,10,700,800,"Sub-basin 8"
371,300,17,6800,7100,"Sub-basin 8"
372,600,16,5200,5800,"Sub-basin 8"
373,400,13,3900,4300,"Sub-basin 8"
374,400,34,2300,2700,"Sub-basin 8"
375,2100,114,8100,10200,"Sub-basin 8"
376,100,9,700,800,"Sub-basin 8"
377,200,6,3300,3500,"Sub-basin 8"
378,1300,238,10000,11300,"Sub-basin 8"
379,100,2,800,900,"Sub-basin 8"
380,1000,112,5000,6000,"Sub-basin 8"
381,800,60,3300,4100,"Sub-basin 8"
382,600,65,3200,3800,"Sub-basin 8"
383,1100,202,6400,7500,"Sub-basin 8"
384,100,1,700,800,"Sub-basin 8"
385,400,18,5000,5400,"Sub-basin 8"
386,100,2,1700,1800,"Sub-basin 8"
387,300,8,2200,2500,"Sub-basin 8"
388,3000,312,17000,20000,"Sub-basin 8"
389,100,1,600,700,"Sub-basin 8"
390,100,3,1700,1800,"Sub-basin 8"
391,1300,58,4300,5600,"Sub-basin 8"
392,400,31,4100,4500,"Sub-basin 8"
393,100,8,700,800,"Sub-basin 8"
394,900,173,1800,2700,"Sub-basin 8"
395,1300,144,11500,12800,"Sub-basin 8"
396,100,2,1200,1300,"Sub-basin 8"
397,1500,332,3800,5300,"Sub-basin 8"
398,500,111,1500,2000,"Sub-basin 8"
399,200,4,1000,1200,"Sub-basin 8"
400,400,12,100,500,"Sub-basin 8"
401,400,26,5000,5400,"Sub-basin 8"
402,2300,768,5100,7400,"Sub-basin 8"
403,400,62,1300,1700,"Sub-basin 8"
404,39300,13711,50600,89900,"Sub-basin 8"
405,100,4,0,100,"Sub-basin 8"
406,1500,84,8600,10100,"Sub-basin 8"
407,500,25,1400,1900,"Sub-basin 8"
408,100,1,1700,1800,"Sub-basin 8"
409,100,5,1400,1500,"Sub-basin 8"
410,100,1,900,1000,"Sub-basin 8"
411,4200,1252,7500,11700,"Sub-basin 8"
412,200,6,2700,2900,"Sub-basin 8"
413,1200,243,3500,4700,"Sub-basin 8"
414,200,12,1200,1400,"Sub-basin 8"
415,200,4,1600,1800,"Sub-basin 8"
416,11200,1798,88800,1e+05,"Sub-basin 8"
417,900,75,4000,4900,"Sub-basin 8"
418,1800,233,5500,7300,"Sub-basin 8"
419,8200,3626,14800,23000,"Sub-basin 8"
420,100,1,1100,1200,"Sub-basin 8"
421,1300,326,4300,5600,"Sub-basin 8"
422,100,1,700,800,"Sub-basin 8"
423,400,27,3400,3800,"Sub-basin 8"
424,400,15,3400,3800,"Sub-basin 8"
425,1400,149,5500,6900,"Sub-basin 8"
426,400,30,1900,2300,"Sub-basin 8"
427,100,2,1400,1500,"Sub-basin 8"
428,1200,172,3700,4900,"Sub-basin 8"
429,100,2,1000,1100,"Sub-basin 8"
430,300,4,3400,3700,"Sub-basin 8"
431,100,1,1700,1800,"Sub-basin 8"
432,400,77,2900,3300,"Sub-basin 8"
433,800,88,3700,4500,"Sub-basin 8"
434,600,31,3300,3900,"Sub-basin 8"
435,1900,290,5700,7600,"Sub-basin 8"
436,1000,90,6600,7600,"Sub-basin 8"
437,800,54,7700,8500,"Sub-basin 8"
438,400,8,4700,5100,"Sub-basin 8"
439,300,10,3200,3500,"Sub-basin 8"
440,100,3,1700,1800,"Sub-basin 8"
441,700,78,7900,8600,"Sub-basin 8"
442,100,3,1200,1300,"Sub-basin 8"
443,100,1,2000,2100,"Sub-basin 8"
444,500,48,3200,3700,"Sub-basin 8"
445,800,121,2400,3200,"Sub-basin 8"
446,300,10,3200,3500,"Sub-basin 8"
447,1700,112,10800,12500,"Sub-basin 8"
448,700,39,9200,9900,"Sub-basin 8"
449,1200,123,7600,8800,"Sub-basin 8"
450,800,473,5000,5800,"Sub-basin 8"
451,100,1,1300,1400,"Sub-basin 8"
452,100,2,1400,1500,"Sub-basin 8"
453,200,10,1000,1200,"Sub-basin 8"
454,1900,155,12400,14300,"Sub-basin 8"
455,600,69,1500,2100,"Sub-basin 8"
456,4000,662,14300,18300,"Sub-basin 8"
457,400,93,2400,2800,"Sub-basin 8"
458,100,3,400,500,"Sub-basin 8"
459,47800,16870,105900,153700,"Sub-basin 8"
460,200,5,1600,1800,"Sub-basin 8"
461,100,4,800,900,"Sub-basin 8"
462,200,29,3700,3900,"Sub-basin 8"
463,100,1,1600,1700,"Sub-basin 8"
464,1100,110,7600,8700,"Sub-basin 8"
465,200,8,2000,2200,"Sub-basin 8"
466,400,23,800,1200,"Sub-basin 8"
467,300,20,2400,2700,"Sub-basin 8"
468,100,7,1000,1100,"Sub-basin 8"
469,2400,435,11700,14100,"Sub-basin 8"
470,6400,947,28300,34700,"Sub-basin 8"
471,1700,251,11100,12800,"Sub-basin 8"
472,900,61,9400,10300,"Sub-basin 8"
473,1400,124,13900,15300,"Sub-basin 8"
474,1900,549,7600,9500,"Sub-basin 8"
475,800,110,2000,2800,"Sub-basin 8"
476,500,17,4700,5200,"Sub-basin 8"
477,600,57,3600,4200,"Sub-basin 8"
478,200,6,3700,3900,"Sub-basin 8"
479,900,132,3800,4700,"Sub-basin 8"
480,100,7,2800,2900,"Sub-basin 8"
481,100,5,1500,1600,"Sub-basin 8"
482,200,15,3000,3200,"Sub-basin 8"
483,100,6,1000,1100,"Sub-basin 8"
484,100,5,1700,1800,"Sub-basin 8"
485,100,2,2400,2500,"Sub-basin 8"
486,300,8,3700,4000,"Sub-basin 8"
487,100,1,2400,2500,"Sub-basin 8"
488,1300,230,11600,12900,"Sub-basin 8"
489,200,9,3700,3900,"Sub-basin 8"
490,100,3,2900,3000,"Sub-basin 8"
491,200,8,2300,2500,"Sub-basin 8"
492,400,21,4400,4800,"Sub-basin 8"
493,100,1,2600,2700,"Sub-basin 8"
494,400,19,5400,5800,"Sub-basin 8"
495,400,26,4800,5200,"Sub-basin 8"
496,200,18,2100,2300,"Sub-basin 8"
497,100,4,700,800,"Sub-basin 8"
498,300,9,3700,4000,"Sub-basin 8"
499,300,17,3400,3700,"Sub-basin 8"
500,100,1,1600,1700,"Sub-basin 8"
501,3700,955,9400,13100,"Sub-basin 8"
502,100,1,1600,1700,"Sub-basin 8"
503,100,2,1300,1400,"Sub-basin 8"
504,1400,239,7400,8800,"Sub-basin 8"
505,200,24,1600,1800,"Sub-basin 8"
506,100,1,3000,3100,"Sub-basin 8"
507,100,2,2500,2600,"Sub-basin 8"
508,600,84,4100,4700,"Sub-basin 8"
509,1300,209,4200,5500,"Sub-basin 8"
510,11100,1414,44300,55400,"Sub-basin 8"
511,100,1,2300,2400,"Sub-basin 8"
512,400,32,3700,4100,"Sub-basin 8"
513,100,2,2000,2100,"Sub-basin 8"
514,200,2,4400,4600,"Sub-basin 8"
515,400,17,6800,7200,"Sub-basin 8"
516,100,1,1700,1800,"Sub-basin 8"
517,200,5,1800,2000,"Sub-basin 8"
518,100,1,2200,2300,"Sub-basin 8"
519,100,1,1900,2000,"Sub-basin 8"
520,900,69,5500,6400,"Sub-basin 8"
521,1300,153,8000,9300,"Sub-basin 8"
522,1400,99,9600,11000,"Sub-basin 8"
523,300,20,5100,5400,"Sub-basin 8"
524,3600,332,30100,33700,"Sub-basin 8"
525,400,14,3700,4100,"Sub-basin 8"
526,3800,507,25700,29500,"Sub-basin 8"
527,300,24,2300,2600,"Sub-basin 8"
528,1700,202,11800,13500,"Sub-basin 8"
529,600,111,3600,4200,"Sub-basin 8"
530,1000,52,5100,6100,"Sub-basin 8"
531,500,48,6100,6600,"Sub-basin 8"
532,100,5,1900,2000,"Sub-basin 8"
533,5900,535,45800,51700,"Sub-basin 8"
534,500,27,9200,9700,"Sub-basin 8"
535,300,17,4100,4400,"Sub-basin 8"
536,1100,207,8300,9400,"Sub-basin 8"
537,900,50,5200,6100,"Sub-basin 8"
538,400,20,3300,3700,"Sub-basin 8"
539,300,9,3500,3800,"Sub-basin 8"
540,900,88,11500,12400,"Sub-basin 8"
541,100,2,2400,2500,"Sub-basin 8"
542,100,2,2400,2500,"Sub-basin 8"
543,200,11,2100,2300,"Sub-basin 8"
544,300,12,5400,5700,"Sub-basin 8"
545,1200,101.84,7100,8300,"Sub-basin 8"
546,100,2,2600,2700,"Sub-basin 8"
547,100,1,2400,2500,"Sub-basin 8"
548,600,58,5900,6500,"Sub-basin 8"
549,2800,309,26600,29400,"Sub-basin 8"
550,100,2,2200,2300,"Sub-basin 8"
551,100,8,1400,1500,"Sub-basin 8"
552,500,79,1200,1700,"Sub-basin 8"
553,200,13,1600,1800,"Sub-basin 8"
554,900,73,7800,8700,"Sub-basin 8"
555,100,3,1200,1300,"Sub-basin 8"
556,900,107,7500,8400,"Sub-basin 8"
557,400,16,5700,6100,"Sub-basin 8"
558,200,6,1600,1800,"Sub-basin 8"
559,2000,299,10100,12100,"Sub-basin 8"
560,800,54,8000,8800,"Sub-basin 8"
561,1600,129,18800,20400,"Sub-basin 8"
562,100,1,1100,1200,"Sub-basin 8"
563,300,21,4000,4300,"Sub-basin 8"
564,300,17,6800,7100,"Sub-basin 8"
565,200,18,1500,1700,"Sub-basin 8"
566,700,44,10900,11600,"Sub-basin 8"
567,800,66,4200,5000,"Sub-basin 8"
568,11200,1833.33,48000,59200,"Sub-basin 8"
569,200,8,3200,3400,"Sub-basin 8"
570,200,2,2600,2800,"Sub-basin 8"
571,10000,5524,19900,29900,"Sub-basin 8"
572,200,20,1500,1700,"Sub-basin 8"
573,500,20,5900,6400,"Sub-basin 8"
574,900,124,4200,5100,"Sub-basin 8"
575,1000,69,10000,11000,"Sub-basin 8"
576,300,12,2400,2700,"Sub-basin 8"
577,1100,196,5200,6300,"Sub-basin 8"
578,1100,63,8100,9200,"Sub-basin 8"
579,1900,843,10700,12600,"Sub-basin 8"
580,100,2,600,700,"Sub-basin 8"
581,300,9,3800,4100,"Sub-basin 8"
582,4400,824,27000,31400,"Sub-basin 8"
583,1500,143,15600,17100,"Sub-basin 8"
584,600,46,3600,4200,"Sub-basin 8"
585,100,2,1100,1200,"Sub-basin 8"
586,2000,253.5,13800,15800,"Sub-basin 8"
587,500,32,6100,6600,"Sub-basin 8"
588,400,13,6700,7100,"Sub-basin 8"
589,600,29,7000,7600,"Sub-basin 8"
590,81200,103714.34,94000,175200,"Sub-basin 8"
591,200,15,3900,4100,"Sub-basin 8"
592,600,31,9500,10100,"Sub-basin 8"
593,100,6,1600,1700,"Sub-basin 8"
594,1000,137.5,7200,8200,"Sub-basin 8"
595,100,1,2100,2200,"Sub-basin 8"
596,700,42.17,9600,10300,"Sub-basin 8"
597,500,40.83,4300,4800,"Sub-basin 8"
598,300,9,5100,5400,"Sub-basin 8"
599,400,39.83,1000,1400,"Sub-basin 8"
600,100,1,2300,2400,"Sub-basin 8"
601,200,17,900,1100,"Sub-basin 8"
602,100,2,2400,2500,"Sub-basin 8"
603,1100,126,6400,7500,"Sub-basin 8"
604,1100,134,14800,15900,"Sub-basin 8"
605,400,16,4700,5100,"Sub-basin 8"
606,300,18,1900,2200,"Sub-basin 8"
607,200,2,2500,2700,"Sub-basin 8"
608,200,10,4400,4600,"Sub-basin 8"
609,400,18,5000,5400,"Sub-basin 8"
610,200,5,2300,2500,"Sub-basin 8"
611,100,8,1100,1200,"Sub-basin 8"
612,100,3,2400,2500,"Sub-basin 8"
613,100,2,1400,1500,"Sub-basin 8"
614,100,3,600,700,"Sub-basin 8"
615,500,41,5300,5800,"Sub-basin 8"
616,600,54,7000,7600,"Sub-basin 8"
617,100,6,1300,1400,"Sub-basin 8"
618,200,5,3100,3300,"Sub-basin 8"
619,200,5,1900,2100,"Sub-basin 8"
620,200,3,4300,4500,"Sub-basin 8"
621,2200,127,23100,25300,"Sub-basin 8"
622,400,43,2700,3100,"Sub-basin 8"
623,100,1,1800,1900,"Sub-basin 8"
624,300,5,7700,8000,"Sub-basin 8"
625,600,26,12300,12900,"Sub-basin 8"
626,500,23,7600,8100,"Sub-basin 8"
627,100,4,2200,2300,"Sub-basin 8"
628,400,24,2200,2600,"Sub-basin 8"
629,100,2,3300,3400,"Sub-basin 8"
630,500,37,6000,6500,"Sub-basin 8"
631,100,4,1300,1400,"Sub-basin 8"
632,500,25,5600,6100,"Sub-basin 8"
633,300,24,4800,5100,"Sub-basin 8"
634,500,26,7500,8000,"Sub-basin 8"
635,100,1,3100,3200,"Sub-basin 8"
636,9600,1169,33000,42600,"Sub-basin 8"
637,600,53,2900,3500,"Sub-basin 8"
638,100,1,1100,1200,"Sub-basin 8"
639,200,7,6800,7000,"Sub-basin 8"
640,100,3,2500,2600,"Sub-basin 8"
641,300,8,4000,4300,"Sub-basin 8"
642,200,3,1600,1800,"Sub-basin 8"
643,300,19,1400,1700,"Sub-basin 8"
644,100,1,1300,1400,"Sub-basin 8"
645,200,3,4900,5100,"Sub-basin 8"
646,100,2,1300,1400,"Sub-basin 8"
647,300,9,5400,5700,"Sub-basin 8"
648,1500,127,16500,18000,"Sub-basin 8"
649,1500,153,10200,11700,"Sub-basin 8"
650,100,2,1200,1300,"Sub-basin 8"
651,3600,259,56700,60300,"Sub-basin 8"
652,43900,17910,84500,128400,"Sub-basin 8"
653,200,5,2800,3000,"Sub-basin 8"
654,100,1,1500,1600,"Sub-basin 8"
655,100,6,1800,1900,"Sub-basin 8"
656,600,49,5500,6100,"Sub-basin 8"
657,100,2,2000,2100,"Sub-basin 8"
658,500,39,4400,4900,"Sub-basin 8"
659,200,7,2900,3100,"Sub-basin 8"
660,200,8,1400,1600,"Sub-basin 8"
661,500,18,2800,3300,"Sub-basin 8"
662,500,30,3900,4400,"Sub-basin 8"
663,800,54,6700,7500,"Sub-basin 8"
664,100,1,2700,2800,"Sub-basin 8"
665,600,326,5300,5900,"Sub-basin 8"
666,400,14,1900,2300,"Sub-basin 8"
667,300,3,4100,4400,"Sub-basin 8"
668,100,1,1300,1400,"Sub-basin 8"
669,100,3,1700,1800,"Sub-basin 8"
670,1000,77,14500,15500,"Sub-basin 8"
671,300,20,2600,2900,"Sub-basin 8"
672,100,2,1400,1500,"Sub-basin 8"
673,100,1,1300,1400,"Sub-basin 8"
674,100,4,2500,2600,"Sub-basin 8"
675,56800,53197.1336,118300,175100,"Sub-basin 8"
676,1100,211,10900,12000,"Sub-basin 8"
677,100,1,2500,2600,"Sub-basin 8"
678,500,40,1600,2100,"Sub-basin 8"
679,100,3,1500,1600,"Sub-basin 8"
680,400,11,11200,11600,"Sub-basin 8"
681,100,1,1700,1800,"Sub-basin 8"
682,100,2,2200,2300,"Sub-basin 8"
683,200,5,1500,1700,"Sub-basin 8"
684,900,66,5400,6300,"Sub-basin 8"
685,100,23,2000,2100,"Sub-basin 8"
686,300,5,2100,2400,"Sub-basin 8"
687,600,33,2000,2600,"Sub-basin 8"
688,3500,275,30700,34200,"Sub-basin 8"
689,300,6,4900,5200,"Sub-basin 8"
690,700,73,5300,6000,"Sub-basin 8"
691,100,1,100,200,"Sub-basin 8"
692,3500,770,22500,26000,"Sub-basin 8"
693,28500,7394.5,153700,182200,"Sub-basin 8"
694,200,3,4200,4400,"Sub-basin 8"
695,400,25,2100,2500,"Sub-basin 8"
696,600,55,2200,2800,"Sub-basin 8"
697,100,3,1400,1500,"Sub-basin 8"
698,1700,246,19300,21000,"Sub-basin 8"
699,200,14,2700,2900,"Sub-basin 8"
700,17300,7621,15700,33000,"Sub-basin 8"
701,600,85,700,1300,"Sub-basin 8"
702,500,49,2800,3300,"Sub-basin 8"
703,300,49,1300,1600,"Sub-basin 8"
704,200,7,600,800,"Sub-basin 8"
705,200,16,3000,3200,"Sub-basin 8"
706,3300,215,45800,49100,"Sub-basin 8"
707,100,2,2000,2100,"Sub-basin 8"
708,400,25,2800,3200,"Sub-basin 8"
709,200,33,1200,1400,"Sub-basin 8"
710,200,4,3900,4100,"Sub-basin 8"
711,200,10,3400,3600,"Sub-basin 8"
712,800,98,2500,3300,"Sub-basin 8"
713,200,6,4000,4200,"Sub-basin 8"
714,700,29,3100,3800,"Sub-basin 8"
715,6600,2666,7800,14400,"Sub-basin 8"
716,100,2,500,600,"Sub-basin 8"
717,600,44,4100,4700,"Sub-basin 8"
718,400,41,4400,4800,"Sub-basin 8"
719,200,8,600,800,"Sub-basin 8"
720,2400,130,14100,16500,"Sub-basin 8"
721,1800,152,22400,24200,"Sub-basin 8"
722,100,2,2200,2300,"Sub-basin 8"
723,400,19,6700,7100,"Sub-basin 8"
724,1100,172,11900,13000,"Sub-basin 8"
725,1700,220,5800,7500,"Sub-basin 8"
726,2800,269,11500,14300,"Sub-basin 8"
727,600,71,4100,4700,"Sub-basin 8"
728,100,2,1100,1200,"Sub-basin 8"
729,100,1,2100,2200,"Sub-basin 8"
730,58400,22254,71300,129700,"Sub-basin 8"
731,600,119,1300,1900,"Sub-basin 8"
732,500,34,2700,3200,"Sub-basin 8"
733,2000,289,12400,14400,"Sub-basin 8"
734,200,9,2600,2800,"Sub-basin 8"
735,500,27,3500,4000,"Sub-basin 8"
736,400,16,3500,3900,"Sub-basin 8"
737,400,51,2900,3300,"Sub-basin 8"
738,400,37,2400,2800,"Sub-basin 8"
739,100,1,2200,2300,"Sub-basin 8"
740,100,2,1800,1900,"Sub-basin 8"
741,110700,83879,205400,316100,"Sub-basin 8"
742,21800,8468,55800,77600,"Sub-basin 8"
743,100,1,2500,2600,"Sub-basin 8"
744,600,127,4700,5300,"Sub-basin 8"
745,600,213,4800,5400,"Sub-basin 8"
746,100,2,1400,1500,"Sub-basin 8"
747,200,29,1700,1900,"Sub-basin 8"
748,500,44,1300,1800,"Sub-basin 8"
749,200,11,1000,1200,"Sub-basin 8"
750,600,28,3400,4000,"Sub-basin 8"
751,300,17,2100,2400,"Sub-basin 8"
752,100,2,1900,2000,"Sub-basin 8"
753,200,14,4400,4600,"Sub-basin 8"
754,900,40,2800,3700,"Sub-basin 8"
755,500,26,4400,4900,"Sub-basin 8"
756,5800,1783,15600,21400,"Sub-basin 8"
757,1100,135,7600,8700,"Sub-basin 8"
758,100,1,1500,1600,"Sub-basin 8"
759,2000,171,30200,32200,"Sub-basin 8"
760,3600,743,11000,14600,"Sub-basin 8"
761,100,2,1600,1700,"Sub-basin 8"
762,300,16,5900,6200,"Sub-basin 8"
763,700,77,4100,4800,"Sub-basin 8"
764,700,54,2700,3400,"Sub-basin 8"
765,300,10,1000,1300,"Sub-basin 8"
766,200,2,4000,4200,"Sub-basin 8"
767,100,2,700,800,"Sub-basin 8"
768,200,2,3900,4100,"Sub-basin 8"
769,100,1,2500,2600,"Sub-basin 8"
770,800,62,5800,6600,"Sub-basin 8"
771,200,5,2400,2600,"Sub-basin 8"
772,200,7,3500,3700,"Sub-basin 8"
773,100,2,2200,2300,"Sub-basin 8"
774,100,1,1500,1600,"Sub-basin 8"
775,400,29,1300,1700,"Sub-basin 8"
776,1400,211,11200,12600,"Sub-basin 8"
777,100,1,1100,1200,"Sub-basin 8"
778,200,5,1500,1700,"Sub-basin 8"
779,300,8,3300,3600,"Sub-basin 8"
780,400,17,7300,7700,"Sub-basin 8"
781,1700,252,6700,8400,"Sub-basin 8"
782,300,8,1700,2000,"Sub-basin 8"
783,300,12,3000,3300,"Sub-basin 8"
784,200,9,2200,2400,"Sub-basin 8"
785,500,10,8400,8900,"Sub-basin 8"
786,600,26,13000,13600,"Sub-basin 8"
787,300,16,3000,3300,"Sub-basin 8"
788,100,1,1800,1900,"Sub-basin 8"
789,100,1,2000,2100,"Sub-basin 8"
790,100,1,1900,2000,"Sub-basin 8"
791,100,1,1500,1600,"Sub-basin 8"
792,200,6,2400,2600,"Sub-basin 8"
793,1500,113,5900,7400,"Sub-basin 8"
794,100,1,3100,3200,"Sub-basin 8"
795,6300,939,71300,77600,"Sub-basin 8"
796,300,31,3500,3800,"Sub-basin 8"
797,400,26,3200,3600,"Sub-basin 8"
798,600,64,4800,5400,"Sub-basin 8"
799,2300,287,18500,20800,"Sub-basin 8"
800,200,2,1800,2000,"Sub-basin 8"
801,100,2,1400,1500,"Sub-basin 8"
802,1900,259,7900,9800,"Sub-basin 8"
803,1100,95,3700,4800,"Sub-basin 8"
804,400,19,4200,4600,"Sub-basin 8"
805,200,2,2000,2200,"Sub-basin 8"
806,1100,146,3500,4600,"Sub-basin 8"
807,100,6,1800,1900,"Sub-basin 8"
808,300,4,1300,1600,"Sub-basin 8"
809,200,5,900,1100,"Sub-basin 8"
810,1400,177,2000,3400,"Sub-basin 8"
811,2900,568,15800,18700,"Sub-basin 8"
812,100,1,900,1000,"Sub-basin 8"
813,500,83,2400,2900,"Sub-basin 8"
814,4400,1787,11900,16300,"Sub-basin 8"
815,900,85,8900,9800,"Sub-basin 8"
816,200,14,3400,3600,"Sub-basin 8"
817,200,5,900,1100,"Sub-basin 8"
818,700,89,4600,5300,"Sub-basin 8"
819,1600,301,7200,8800,"Sub-basin 8"
820,1200,161,6400,7600,"Sub-basin 8"
821,1700,199,2400,4100,"Sub-basin 8"
822,100,4,500,600,"Sub-basin 8"
823,800,91,6300,7100,"Sub-basin 8"
824,900,329,2000,2900,"Sub-basin 8"
825,1300,302,5000,6300,"Sub-basin 8"
826,100,1,1600,1700,"Sub-basin 8"
827,100,2,700,800,"Sub-basin 8"
828,900,138,1600,2500,"Sub-basin 8"
829,200,2,200,400,"Sub-basin 8"
830,1100,176,3900,5000,"Sub-basin 8"
831,200,5,3400,3600,"Sub-basin 8"
832,500,17,1400,1900,"Sub-basin 8"
833,700,22,19200,19900,"Sub-basin 8"
834,100,5,1600,1700,"Sub-basin 8"
835,100,4,1100,1200,"Sub-basin 8"
836,200,7,1600,1800,"Sub-basin 8"
837,100,4,600,700,"Sub-basin 8"
838,500,21,1900,2400,"Sub-basin 8"
839,200,3,2200,2400,"Sub-basin 8"
840,100,14,1000,1100,"Sub-basin 8"
841,300,26,2800,3100,"Sub-basin 8"
842,200,5,1500,1700,"Sub-basin 8"
843,200,2,700,900,"Sub-basin 8"
844,1000,91,2800,3800,"Sub-basin 8"
845,300,14,1600,1900,"Sub-basin 8"
846,100,7,800,900,"Sub-basin 8"
847,300,22,1700,2000,"Sub-basin 8"
848,1300,76,6900,8200,"Sub-basin 8"
849,900,56,3200,4100,"Sub-basin 8"
850,400,20,800,1200,"Sub-basin 8"
851,200,5,900,1100,"Sub-basin 8"
852,300,5,1200,1500,"Sub-basin 8"
853,100,3,2300,2400,"Sub-basin 8"
854,1100,106,10500,11600,"Sub-basin 8"
855,100,1,3200,3300,"Sub-basin 8"
856,1100,126,3700,4800,"Sub-basin 8"
857,100,5,1600,1700,"Sub-basin 8"
858,1600,334,6100,7700,"Sub-basin 8"
859,55300,17560.5,94900,150200,"Sub-basin 8"
860,2900,196,10200,13100,"Sub-basin 8"
861,600,11,4600,5200,"Sub-basin 8"
862,2600,241,10400,13000,"Sub-basin 8"
863,2200,168,8600,10800,"Sub-basin 8"
864,5900,869,14100,20000,"Sub-basin 8"
865,100,4,1100,1200,"Sub-basin 8"
866,200,5,2600,2800,"Sub-basin 8"
867,100,1,2600,2700,"Sub-basin 8"
868,100,1,3100,3200,"Sub-basin 8"
869,200,11,4300,4500,"Sub-basin 8"
870,200,3,2300,2500,"Sub-basin 8"
871,400,6,2400,2800,"Sub-basin 8"
872,100,1,1200,1300,"Sub-basin 8"
873,200,7,3800,4000,"Sub-basin 8"
874,800,45,2600,3400,"Sub-basin 8"
875,800,72,2000,2800,"Sub-basin 8"
876,1100,82,3700,4800,"Sub-basin 8"
877,2500,578,4900,7400,"Sub-basin 8"
878,1300,180,3000,4300,"Sub-basin 8"
879,500,46,8400,8900,"Sub-basin 8"
880,400,14,4400,4800,"Sub-basin 8"
881,100,1,2600,2700,"Sub-basin 8"
882,700,34,5700,6400,"Sub-basin 8"
883,100,1,700,800,"Sub-basin 8"
884,600,28,4700,5300,"Sub-basin 8"
885,500,32,3100,3600,"Sub-basin 8"
886,300,13,5400,5700,"Sub-basin 8"
887,300,9,1900,2200,"Sub-basin 8"
888,1100,124,8000,9100,"Sub-basin 8"
889,100,1,900,1000,"Sub-basin 8"
890,500,17,1400,1900,"Sub-basin 8"
891,100,4,500,600,"Sub-basin 8"
892,500,12,5400,5900,"Sub-basin 8"
893,1000,86,2200,3200,"Sub-basin 8"
894,500,18,3400,3900,"Sub-basin 8"
895,1700,135,7600,9300,"Sub-basin 8"
896,200,13,1400,1600,"Sub-basin 8"
897,100,1,200,300,"Sub-basin 8"
898,200,6,1400,1600,"Sub-basin 8"
899,100,2,1500,1600,"Sub-basin 8"
900,300,4,5500,5800,"Sub-basin 8"
901,100,8,4000,4100,"Sub-basin 8"
902,100,2,3600,3700,"Sub-basin 8"
903,400,28,5000,5400,"Sub-basin 8"
904,100,8,100,200,"Sub-basin 8"
905,400,21,3200,3600,"Sub-basin 8"
906,100,5,900,1000,"Sub-basin 8"
907,300,14,2900,3200,"Sub-basin 8"
908,200,4,500,700,"Sub-basin 8"
909,200,4,2100,2300,"Sub-basin 8"
910,100,2,1600,1700,"Sub-basin 8"
911,1000,119,5600,6600,"Sub-basin 8"
912,1300,127,11400,12700,"Sub-basin 8"
913,100,4,5000,5100,"Sub-basin 8"
914,700,58,2700,3400,"Sub-basin 8"
915,200,3,3300,3500,"Sub-basin 8"
916,100,4,2500,2600,"Sub-basin 8"
917,300,12,900,1200,"Sub-basin 8"
918,200,5,200,400,"Sub-basin 8"
919,200,26,1800,2000,"Sub-basin 8"
920,100,9,800,900,"Sub-basin 8"
921,100,1,1100,1200,"Sub-basin 8"
922,400,30,2500,2900,"Sub-basin 8"
923,100,1,2800,2900,"Sub-basin 8"
924,100,2,2100,2200,"Sub-basin 8"
925,100,1,2000,2100,"Sub-basin 8"
926,300,22,1400,1700,"Sub-basin 8"
927,100,2,800,900,"Sub-basin 8"
928,300,43,2900,3200,"Sub-basin 8"
929,900,338,3400,4300,"Sub-basin 8"
930,400,48,2200,2600,"Sub-basin 8"
931,3000,332,12400,15400,"Sub-basin 8"
932,100,2,1200,1300,"Sub-basin 8"
933,600,28,3600,4200,"Sub-basin 8"
934,200,7,700,900,"Sub-basin 8"
935,1000,274,3300,4300,"Sub-basin 8"
936,400,21,3800,4200,"Sub-basin 8"
937,500,50,1400,1900,"Sub-basin 8"
938,100,4,2900,3000,"Sub-basin 8"
939,100,6,2200,2300,"Sub-basin 8"
940,100,1,800,900,"Sub-basin 8"
941,100,1,500,600,"Sub-basin 8"
942,4700,1186,23900,28600,"Sub-basin 8"
943,300,8,4600,4900,"Sub-basin 8"
944,400,40,1300,1700,"Sub-basin 8"
945,300,12,900,1200,"Sub-basin 8"
946,4400,2226,8300,12700,"Sub-basin 8"
947,200,23,2200,2400,"Sub-basin 8"
948,400,27,2600,3000,"Sub-basin 8"
949,600,17,2400,3000,"Sub-basin 8"
950,800,55,8000,8800,"Sub-basin 8"
951,500,21,2400,2900,"Sub-basin 8"
952,200,7,8700,8900,"Sub-basin 8"
953,100,1,1400,1500,"Sub-basin 8"
954,1000,170,4600,5600,"Sub-basin 8"
955,800,37,4900,5700,"Sub-basin 8"
956,100,4,1100,1200,"Sub-basin 8"
957,600,28,3400,4000,"Sub-basin 8"
958,800,126,2100,2900,"Sub-basin 8"
959,400,21,2000,2400,"Sub-basin 8"
960,1000,228,3200,4200,"Sub-basin 8"
961,100,3,1000,1100,"Sub-basin 8"
962,2600,377,23700,26300,"Sub-basin 8"
963,100,26,1000,1100,"Sub-basin 8"
964,1500,338,2700,4200,"Sub-basin 8"
965,18500,10692,27200,45700,"Sub-basin 8"
966,100,1,600,700,"Sub-basin 8"
967,500,33,3300,3800,"Sub-basin 8"
968,1200,162,11900,13100,"Sub-basin 8"
969,3300,1118,11000,14300,"Sub-basin 8"
970,700,29,5200,5900,"Sub-basin 8"
971,1800,162,11300,13100,"Sub-basin 8"
972,400,29,2500,2900,"Sub-basin 8"
973,500,35,2200,2700,"Sub-basin 8"
974,200,5,2000,2200,"Sub-basin 8"
975,500,76,2000,2500,"Sub-basin 8"
976,300,33,1600,1900,"Sub-basin 8"
977,1100,85,15800,16900,"Sub-basin 8"
978,100,4,3000,3100,"Sub-basin 8"
979,900,71,5000,5900,"Sub-basin 8"
980,100,3,1300,1400,"Sub-basin 8"
981,100,4,1600,1700,"Sub-basin 8"
982,200,21,1300,1500,"Sub-basin 8"
983,500,42,4000,4500,"Sub-basin 8"
984,200,5,1800,2000,"Sub-basin 8"
985,200,11,1800,2000,"Sub-basin 8"
986,1200,140,4300,5500,"Sub-basin 8"
987,400,8,3300,3700,"Sub-basin 8"
988,800,179,2300,3100,"Sub-basin 8"
989,100,1,700,800,"Sub-basin 8"
990,200,3,1800,2000,"Sub-basin 8"
991,400,52,6600,7000,"Sub-basin 8"
992,400,24,5000,5400,"Sub-basin 8"
993,200,19,1100,1300,"Sub-basin 8"
994,500,41,2300,2800,"Sub-basin 8"
995,100,2,300,400,"Sub-basin 8"
996,100,1,2000,2100,"Sub-basin 8"
997,400,26,2200,2600,"Sub-basin 8"
998,1600,99,9100,10700,"Sub-basin 8"
999,100,3,0,100,"Sub-basin 8"
1000,1000,133,4500,5500,"Sub-basin 8"
1001,500,31,6900,7400,"Sub-basin 8"
1002,100,2,2600,2700,"Sub-basin 8"
1003,300,5,4400,4700,"Sub-basin 8"
1004,400,9,4900,5300,"Sub-basin 8"
1005,1200,74,5200,6400,"Sub-basin 8"
1006,1100,1055,6000,7100,"Sub-basin 8"
1007,2800,777,12500,15300,"Sub-basin 8"
1008,900,53,3400,4300,"Sub-basin 8"
1009,300,8,1800,2100,"Sub-basin 8"
1010,5900,1046,13000,18900,"Sub-basin 8"
1011,100,3,1600,1700,"Sub-basin 8"
1012,100,2,800,900,"Sub-basin 8"
1013,300,29,700,1000,"Sub-basin 8"
1014,1300,92,10600,11900,"Sub-basin 8"
1015,500,31,3300,3800,"Sub-basin 8"
1016,800,127,6000,6800,"Sub-basin 8"
1017,200,2,1500,1700,"Sub-basin 8"
1018,300,5,1400,1700,"Sub-basin 8"
1019,600,26,4500,5100,"Sub-basin 8"
1020,200,7,1200,1400,"Sub-basin 8"
1021,1800,373,6200,8000,"Sub-basin 8"
1022,200,4,2200,2400,"Sub-basin 8"
1023,1200,137,12900,14100,"Sub-basin 8"
1024,200,14,300,500,"Sub-basin 8"
1025,200,5,1900,2100,"Sub-basin 8"
1026,900,205,5800,6700,"Sub-basin 8"
1027,1000,253,6900,7900,"Sub-basin 8"
1028,100,1,800,900,"Sub-basin 8"
1029,600,50,3000,3600,"Sub-basin 8"
1030,400,12,6900,7300,"Sub-basin 8"
1031,100,2,2300,2400,"Sub-basin 8"
1032,100,3,5100,5200,"Sub-basin 8"
1033,300,11,4500,4800,"Sub-basin 8"
1034,100,2,100,200,"Sub-basin 8"
1035,1600,135,8700,10300,"Sub-basin 8"
1036,200,14,1800,2000,"Sub-basin 8"
1037,400,11,2600,3000,"Sub-basin 8"
1038,400,9,4900,5300,"Sub-basin 8"
1039,600,33,6600,7200,"Sub-basin 8"
1040,100,5,800,900,"Sub-basin 8"
1041,700,59,5300,6000,"Sub-basin 8"
1042,800,33,12800,13600,"Sub-basin 8"
1043,300,22,2400,2700,"Sub-basin 8"
1044,300,18,1700,2000,"Sub-basin 8"
1045,2300,130,8000,10300,"Sub-basin 8"
1046,1500,131,5900,7400,"Sub-basin 8"
1047,1200,87,5600,6800,"Sub-basin 8"
1048,200,3,3500,3700,"Sub-basin 8"
1049,100,1,2800,2900,"Sub-basin 8"
1050,100,10,2900,3000,"Sub-basin 8"
1051,800,67,9400,10200,"Sub-basin 8"
1052,100,2,1600,1700,"Sub-basin 8"
1053,900,43,13300,14200,"Sub-basin 8"
1054,500,49,3400,3900,"Sub-basin 8"
1055,2600,355,9100,11700,"Sub-basin 8"
1056,1400,195,5300,6700,"Sub-basin 8"
1057,2100,385,6500,8600,"Sub-basin 8"
1058,200,4,400,600,"Sub-basin 8"
1059,500,42,5100,5600,"Sub-basin 8"
1060,100,1,900,1000,"Sub-basin 8"
1061,200,3,2100,2300,"Sub-basin 8"
1062,400,21,3300,3700,"Sub-basin 8"
1063,800,76,5000,5800,"Sub-basin 8"
1064,700,46,6200,6900,"Sub-basin 8"
1065,700,42,3500,4200,"Sub-basin 8"
1066,1100,274,5100,6200,"Sub-basin 8"
1067,1000,115,3600,4600,"Sub-basin 8"
1068,1400,105,5200,6600,"Sub-basin 8"
1069,1500,58,6600,8100,"Sub-basin 8"
1070,1600,163.72,8600,10200,"Sub-basin 8"
1071,200,12,3300,3500,"Sub-basin 8"
1072,200,3,1600,1800,"Sub-basin 8"
1073,100,6,700,800,"Sub-basin 8"
1074,200,9,2700,2900,"Sub-basin 8"
1075,8100,1102.16,34200,42300,"Sub-basin 8"
1076,200,14,1000,1200,"Sub-basin 8"
1077,100,2,400,500,"Sub-basin 8"
1078,200,11,3200,3400,"Sub-basin 8"
1079,200,6,3100,3300,"Sub-basin 8"
1080,200,4,800,1000,"Sub-basin 8"
1081,600,45,4700,5300,"Sub-basin 8"
1082,400,7,5400,5800,"Sub-basin 8"
1083,700,24,8800,9500,"Sub-basin 8"
1084,100,2,2100,2200,"Sub-basin 8"
1085,800,50,9500,10300,"Sub-basin 8"
1086,200,4,2000,2200,"Sub-basin 8"
1087,600,13,5000,5600,"Sub-basin 8"
1088,400,31,2400,2800,"Sub-basin 8"
1089,600,72,4200,4800,"Sub-basin 8"
1090,100,5,1100,1200,"Sub-basin 8"
1091,100,1,1800,1900,"Sub-basin 8"
1092,1200,82,14100,15300,"Sub-basin 8"
1093,600,54,7700,8300,"Sub-basin 8"
1094,100,4,2400,2500,"Sub-basin 8"
1095,2000,178,13500,15500,"Sub-basin 8"
1096,600,80,4000,4600,"Sub-basin 8"
1097,200,4,2100,2300,"Sub-basin 8"
1098,100,3,1000,1100,"Sub-basin 8"
1099,400,50,2400,2800,"Sub-basin 8"
1100,200,9,1300,1500,"Sub-basin 8"
1101,100,1,2100,2200,"Sub-basin 8"
1102,100,2,2300,2400,"Sub-basin 8"
1103,600,38,2300,2900,"Sub-basin 8"
1104,200,6,1600,1800,"Sub-basin 8"
1105,100,3,900,1000,"Sub-basin 8"
1106,200,7,1700,1900,"Sub-basin 8"
1107,300,15,3400,3700,"Sub-basin 8"
1108,100,4,2000,2100,"Sub-basin 8"
1109,500,36,6700,7200,"Sub-basin 8"
1110,100,0.17,1200,1300,"Sub-basin 8"
1111,4200,558.33,9300,13500,"Sub-basin 8"
1112,100,1,700,800,"Sub-basin 8"
1113,800,51,5400,6200,"Sub-basin 8"
1114,2000,171,19200,21200,"Sub-basin 8"
1115,5000,578,21400,26400,"Sub-basin 8"
1116,3200,355,13800,17000,"Sub-basin 8"
1117,200,19,2100,2300,"Sub-basin 8"
1118,900,45.34,5800,6700,"Sub-basin 8"
1119,300,39.33,2800,3100,"Sub-basin 8"
1120,400,4.33,4500,4900,"Sub-basin 8"
1121,100,1,3000,3100,"Sub-basin 8"
1122,600,31,3300,3900,"Sub-basin 8"
1123,100,2,1600,1700,"Sub-basin 8"
1124,2700,409,14300,17000,"Sub-basin 8"
1125,300,19,1900,2200,"Sub-basin 8"
1126,100,4,2100,2200,"Sub-basin 8"
1127,1200,91,6300,7500,"Sub-basin 8"
1128,200,10,900,1100,"Sub-basin 8"
1129,700,28,13100,13800,"Sub-basin 8"
1130,100,1,1700,1800,"Sub-basin 8"
1131,700,42,2300,3000,"Sub-basin 8"
1132,100,2,9700,15800,"Sub-basin 8"
1133,200,7,700,800,"Sub-basin 8"
1134,100,8,2100,2300,"Sub-basin 8"
1135,1000,103,1400,1500,"Sub-basin 8"
1136,3100,442,3900,4900,"Sub-basin 8"
1137,100,3,7800,10900,"Sub-basin 8"
1138,500,18,1300,1400,"Sub-basin 8"
1139,100,2,3000,3500,"Sub-basin 8"
1140,200,4,600,700,"Sub-basin 8"
1141,1200,271,2800,3000,"Sub-basin 8"
1142,300,12,7700,8900,"Sub-basin 8"
1143,600,9,1700,2000,"Sub-basin 8"
1144,6000,5546.562,4500,5100,"Sub-basin 8"
1145,300,39,4500,4800,"Sub-basin 8"
1146,2700,271,9700,12400,"Sub-basin 8"
1147,200,16,1600,1800,"Sub-basin 8"
1148,2800,2072,8000,10800,"Sub-basin 8"
1149,100,5,2600,2700,"Sub-basin 8"
1150,500,61,7300,7800,"Sub-basin 8"
1151,300,11,3300,3600,"Sub-basin 8"
1152,400,27,3100,3500,"Sub-basin 8"
1153,100,1,800,900,"Sub-basin 8"
1154,1100,175,4100,5200,"Sub-basin 8"
1155,200,4,1600,1800,"Sub-basin 8"
1156,100,2,2000,2100,"Sub-basin 8"
1157,100,2,1000,1100,"Sub-basin 8"
1158,3300,676,12200,15500,"Sub-basin 8"
1159,800,43,5300,6100,"Sub-basin 8"
1160,3400,525,10300,13700,"Sub-basin 8"
1161,5200,1934,14600,19800,"Sub-basin 8"
1162,200,10,3600,3800,"Sub-basin 8"
1163,200,24,5600,5800,"Sub-basin 8"
1164,400,14,4100,4500,"Sub-basin 8"
1165,56300,28885,55700,112000,"Sub-basin 8"
1166,200,11,1500,1700,"Sub-basin 8"
1167,300,14,3400,3700,"Sub-basin 8"
1168,400,9,1700,2100,"Sub-basin 8"
1169,700,72,600,1300,"Sub-basin 8"
1170,100,1,500,600,"Sub-basin 8"
1171,100,1,700,800,"Sub-basin 8"
1172,900,49,7100,8000,"Sub-basin 8"
1173,1800,154,10400,12200,"Sub-basin 8"
1174,800,40,8700,9500,"Sub-basin 8"
1175,1600,92,6200,7800,"Sub-basin 8"
1176,500,8,2200,2700,"Sub-basin 8"
1177,200,9,1700,1900,"Sub-basin 8"
1178,900,112,3400,4300,"Sub-basin 8"
1179,100,1,2700,2800,"Sub-basin 8"
1180,400,15,7300,7700,"Sub-basin 8"
1181,100,1,1400,1500,"Sub-basin 8"
1182,200,4,1600,1800,"Sub-basin 8"
1183,600,7,4400,5000,"Sub-basin 8"
1184,100,2,2200,2300,"Sub-basin 8"
1185,700,40,4800,5500,"Sub-basin 8"
1186,1000,73,3200,4200,"Sub-basin 8"
1187,100,3,3500,3600,"Sub-basin 8"
1188,200,6,3900,4100,"Sub-basin 8"
1189,300,7,3300,3600,"Sub-basin 8"
1190,800,48,14000,14800,"Sub-basin 8"
1191,200,8,2500,2700,"Sub-basin 8"
1192,100,1,1000,1100,"Sub-basin 8"
1193,300,21,2200,2500,"Sub-basin 8"
1194,4200,475,9300,13500,"Sub-basin 8"
1195,900,58,11700,12600,"Sub-basin 8"
1196,1700,159,13500,15200,"Sub-basin 8"
1197,100,2,1700,1800,"Sub-basin 8"
1198,200,5,1300,1500,"Sub-basin 8"
1199,600,46,5500,6100,"Sub-basin 8"
1200,1200,88,3200,4400,"Sub-basin 8"
1201,1900,161,8300,10200,"Sub-basin 8"
1202,400,9,9500,9900,"Sub-basin 8"
1203,200,5,2500,2700,"Sub-basin 8"
1204,1000,92,4800,5800,"Sub-basin 8"
1205,200,15,2300,2500,"Sub-basin 8"
1206,200,3,2100,2300,"Sub-basin 8"
1207,400,15,2300,2700,"Sub-basin 8"
1208,200,9,2000,2200,"Sub-basin 8"
1209,100,2,500,600,"Sub-basin 8"
1210,6800,2890,7900,14700,"Sub-basin 8"
1211,100,6,1500,1600,"Sub-basin 8"
1212,1200,67,9300,10500,"Sub-basin 8"
1213,100,2,1700,1800,"Sub-basin 8"
1214,200,9,1000,1200,"Sub-basin 8"
1215,500,38,3500,4000,"Sub-basin 8"
1216,100,9,1100,1200,"Sub-basin 8"
1217,400,22,2500,2900,"Sub-basin 8"
1218,1200,93,5200,6400,"Sub-basin 8"
1219,100,1,1600,1700,"Sub-basin 8"
1220,500,26,1400,1900,"Sub-basin 8"
1221,900,62,6700,7600,"Sub-basin 8"
1222,2800,693,18700,21500,"Sub-basin 8"
1223,200,8,3500,3700,"Sub-basin 8"
1224,1800,195,12400,14200,"Sub-basin 8"
1225,800,31,9700,10500,"Sub-basin 8"
1226,700,53,8700,9400,"Sub-basin 8"
1227,200,6,1600,1800,"Sub-basin 8"
1228,800,57,4900,5700,"Sub-basin 8"
1229,200,8,1800,2000,"Sub-basin 8"
1230,100,4,600,700,"Sub-basin 8"
1231,100,1,2100,2200,"Sub-basin 8"
1232,2400,733,4600,7000,"Sub-basin 8"
1233,900,84,4200,5100,"Sub-basin 8"
1234,100,5,2500,2600,"Sub-basin 8"
1235,1000,86,4700,5700,"Sub-basin 8"
1236,900,102,3100,4000,"Sub-basin 8"
1237,21300,5540,55100,76400,"Sub-basin 8"
1238,100,1,1700,1800,"Sub-basin 8"
1239,200,4,2000,2200,"Sub-basin 8"
1240,200,2,2100,2300,"Sub-basin 8"
1241,100,5,3400,3500,"Sub-basin 8"
1242,100,6,700,800,"Sub-basin 8"
1243,800,46,2500,3300,"Sub-basin 8"
1244,700,79,2400,3100,"Sub-basin 8"
1245,1700,115,8200,9900,"Sub-basin 8"
1246,1000,73,3900,4900,"Sub-basin 8"
1247,1200,89,7500,8700,"Sub-basin 8"
1248,600,66,2900,3500,"Sub-basin 8"
1249,100,1,700,800,"Sub-basin 8"
1250,700,22,7600,8300,"Sub-basin 8"
1251,200,10,1300,1500,"Sub-basin 8"
1252,100,2,1800,1900,"Sub-basin 8"
1253,200,2,2900,3100,"Sub-basin 8"
1254,200,4,2100,2300,"Sub-basin 8"
1255,1300,208,5800,7100,"Sub-basin 8"
1256,200,4,1600,1800,"Sub-basin 8"
1257,400,15,3900,4300,"Sub-basin 8"
1258,100,2,1000,1100,"Sub-basin 8"
1259,300,8,1700,2000,"Sub-basin 8"
1260,100,1,2500,2600,"Sub-basin 8"
1261,400,28,6100,6500,"Sub-basin 8"
1262,200,3,5000,5200,"Sub-basin 8"
1263,400,53,2100,2500,"Sub-basin 8"
1264,900,69,8400,9300,"Sub-basin 8"
1265,400,10,1600,2000,"Sub-basin 8"
1266,1000,67,5100,6100,"Sub-basin 8"
1267,100,3,1700,1800,"Sub-basin 8"
1268,500,62,4300,4800,"Sub-basin 8"
1269,200,2,1200,1400,"Sub-basin 8"
1270,1800,695,2500,4300,"Sub-basin 8"
1271,700,44,5000,5700,"Sub-basin 8"
1272,200,4,4900,5100,"Sub-basin 8"
1273,1000,45,15700,16700,"Sub-basin 8"
1274,700,25,11300,12000,"Sub-basin 8"
1275,400,37,4700,5100,"Sub-basin 8"
1276,900,24,8000,8900,"Sub-basin 8"
1277,200,9,900,1100,"Sub-basin 8"
1278,800,64,3700,4500,"Sub-basin 8"
1279,700,19,8000,8700,"Sub-basin 8"
1280,100,1,1600,1700,"Sub-basin 8"
1281,100,4,3700,3800,"Sub-basin 8"
1282,100,1,5200,5300,"Sub-basin 8"
1283,700,58,9000,9700,"Sub-basin 8"
1284,400,9,5400,5800,"Sub-basin 8"
1285,1300,113,13300,14600,"Sub-basin 8"
1286,600,30,2200,2800,"Sub-basin 8"
1287,100,1,600,700,"Sub-basin 8"
1288,300,12,2000,2300,"Sub-basin 8"
1289,200,9,2400,2600,"Sub-basin 8"
1290,1200,159,5700,6900,"Sub-basin 8"
1291,8400,2787,25100,33500,"Sub-basin 8"
1292,4600,1907,14200,18800,"Sub-basin 8"
1293,100,1,1700,1800,"Sub-basin 8"
1294,200,4,3300,3500,"Sub-basin 8"
1295,100,1,2400,2500,"Sub-basin 8"
1296,7900,1685,32200,40100,"Sub-basin 8"
1297,7100,2444,10100,17200,"Sub-basin 8"
1298,200,5,1500,1700,"Sub-basin 8"
1299,200,8,1800,2000,"Sub-basin 8"
1300,1400,97,7800,9200,"Sub-basin 8"
1301,2300,269,14800,17100,"Sub-basin 8"
1302,300,9,2700,3000,"Sub-basin 8"
1303,300,9,6500,6800,"Sub-basin 8"
1304,500,12,5900,6400,"Sub-basin 8"
1305,100,1,2700,2800,"Sub-basin 8"
1306,100,2,2300,2400,"Sub-basin 8"
1307,600,42,7200,7800,"Sub-basin 8"
1308,300,19,2800,3100,"Sub-basin 8"
1309,100,2,300,400,"Sub-basin 8"
1310,100,1,1300,1400,"Sub-basin 8"
1311,400,24,3100,3500,"Sub-basin 8"
1312,2600,989,3900,6500,"Sub-basin 8"
1313,200,2,3200,3400,"Sub-basin 8"
1314,100,1,3400,3500,"Sub-basin 8"
1315,300,8,3400,3700,"Sub-basin 8"
1316,400,50,2500,2900,"Sub-basin 8"
1317,300,17,2200,2500,"Sub-basin 8"
1318,1200,165,5100,6300,"Sub-basin 8"
1319,200,5,2000,2200,"Sub-basin 8"
1320,1100,58,13100,14200,"Sub-basin 8"
1321,600,107,3200,3800,"Sub-basin 8"
1322,800,69,3000,3800,"Sub-basin 8"
1323,100,1,900,1000,"Sub-basin 8"
1324,500,25,5400,5900,"Sub-basin 8"
1325,300,6,6500,6800,"Sub-basin 8"
1326,100,6,2300,2400,"Sub-basin 8"
1327,2500,415.5,10600,13100,"Sub-basin 8"
1328,700,47,2900,3600,"Sub-basin 8"
1329,100,3,1100,1200,"Sub-basin 8"
1330,400,57,1600,2000,"Sub-basin 8"
1331,394200,230279.1689,497900,892100,"Sub-basin 8"
1332,200,7,2600,2800,"Sub-basin 8"
1333,400,74,1600,2000,"Sub-basin 8"
1334,200,6,1800,2000,"Sub-basin 8"
1335,400,17,5000,5400,"Sub-basin 8"
1336,200,3,3300,3500,"Sub-basin 8"
1337,500,22,2200,2700,"Sub-basin 8"
1338,300,12,1900,2200,"Sub-basin 8"
1339,1000,102,6900,7900,"Sub-basin 8"
1340,600,91,4300,4900,"Sub-basin 8"
1341,1100,82,11300,12400,"Sub-basin 8"
1342,400,13,9300,9700,"Sub-basin 8"
1343,100,3,3200,3300,"Sub-basin 8"
1344,100,1,2400,2500,"Sub-basin 8"
1345,400,21,2000,2400,"Sub-basin 8"
1346,500,14,5300,5800,"Sub-basin 8"
1347,400,30,1700,2100,"Sub-basin 8"
1348,500,16,3300,3800,"Sub-basin 8"
1349,500,75,3300,3800,"Sub-basin 8"
1350,200,4,1200,1400,"Sub-basin 8"
1351,200,4,1500,1700,"Sub-basin 8"
1352,500,35,1100,1600,"Sub-basin 8"
1353,1000,196,3500,4500,"Sub-basin 8"
1354,1300,367,19900,21200,"Sub-basin 8"
1355,100,2,1200,1300,"Sub-basin 8"
1356,100,2,900,1000,"Sub-basin 8"
1357,100,1,300,400,"Sub-basin 8"
1358,100,1,700,800,"Sub-basin 8"
1359,1300,75,8100,9400,"Sub-basin 8"
1360,1400,70,8800,10200,"Sub-basin 8"
1361,500,24,2600,3100,"Sub-basin 8"
1362,3300,1331,5300,8600,"Sub-basin 8"
1363,200,34,1700,1900,"Sub-basin 8"
1364,100,3,400,500,"Sub-basin 8"
1365,100,2,1200,1300,"Sub-basin 8"
1366,300,7,3000,3300,"Sub-basin 8"
1367,400,52,2000,2400,"Sub-basin 8"
1368,200,4,4300,4500,"Sub-basin 8"
1369,100,1,1800,1900,"Sub-basin 8"
1370,600,20,2400,3000,"Sub-basin 8"
1371,400,27,4300,4700,"Sub-basin 8"
1372,100,4,800,900,"Sub-basin 8"
1373,1000,95,5100,6100,"Sub-basin 8"
1374,200,3,2000,2200,"Sub-basin 8"
1375,9400,888,28600,38000,"Sub-basin 8"
1376,500,32,3500,4000,"Sub-basin 8"
1377,4100,1440,13100,17200,"Sub-basin 8"
1378,500,27,4900,5400,"Sub-basin 8"
1379,100,1,900,1000,"Sub-basin 8"
1380,100,1,1000,1100,"Sub-basin 8"
1381,100,5,2400,2500,"Sub-basin 8"
1382,200,16,800,1000,"Sub-basin 8"
1383,100,1,800,900,"Sub-basin 8"
1384,200,2,1600,1800,"Sub-basin 8"
1385,200,6,1400,1600,"Sub-basin 8"
1386,400,6,2800,3200,"Sub-basin 8"
1387,100,6,800,900,"Sub-basin 8"
1388,800,46,5300,6100,"Sub-basin 8"
1389,800,33,7000,7800,"Sub-basin 8"
1390,1100,177,8500,9600,"Sub-basin 8"
1391,100,3,2300,2400,"Sub-basin 8"
1392,1100,115,8000,9100,"Sub-basin 8"
1393,700,68,2200,2900,"Sub-basin 8"
1394,1100,112,5700,6800,"Sub-basin 8"
1395,600,79,5700,6300,"Sub-basin 8"
1396,1100,71,9700,10800,"Sub-basin 8"
1397,200,8,1600,1800,"Sub-basin 8"
1398,200,4,1100,1300,"Sub-basin 8"
1399,5600,949,18700,24300,"Sub-basin 8"
1400,6300,2455,16200,22500,"Sub-basin 8"
1401,100,2,1500,1600,"Sub-basin 8"
1402,800,84,3800,4600,"Sub-basin 8"
1403,200,3,3200,3400,"Sub-basin 8"
1404,700,56,4000,4700,"Sub-basin 8"
1405,4000,1152,6900,10900,"Sub-basin 8"
1406,200,13,400,600,"Sub-basin 8"
1407,200,12,2400,2600,"Sub-basin 8"
1408,200,4,1600,1800,"Sub-basin 8"
1409,2400,149,11500,13900,"Sub-basin 8"
1410,700,19,6200,6900,"Sub-basin 8"
1411,400,39,2800,3200,"Sub-basin 8"
1412,200,3,1200,1400,"Sub-basin 8"
1413,1100,147,5800,6900,"Sub-basin 8"
1414,1300,131,5500,6800,"Sub-basin 8"
1415,1800,521,5800,7600,"Sub-basin 8"
1416,100,4,2600,2700,"Sub-basin 8"
1417,100,5,3100,3200,"Sub-basin 8"
1418,100,1,1000,1100,"Sub-basin 8"
1419,500,26,2200,2700,"Sub-basin 8"
1420,100,4,800,900,"Sub-basin 8"
1421,3600,801,15000,18600,"Sub-basin 8"
1422,1700,66,10500,12200,"Sub-basin 8"
1423,600,50,5600,6200,"Sub-basin 8"
1424,200,2,3000,3200,"Sub-basin 8"
1425,1200,59,5600,6800,"Sub-basin 8"
1426,700,40,4200,4900,"Sub-basin 8"
1427,200,18,2400,2600,"Sub-basin 8"
1428,200,9,2100,2300,"Sub-basin 8"
1429,2500,487,6700,9200,"Sub-basin 8"
1430,200,6,3100,3300,"Sub-basin 8"
1431,1700,125,9300,11000,"Sub-basin 8"
1432,200,7,1400,1600,"Sub-basin 8"
1433,600,76,6000,6600,"Sub-basin 8"
1434,800,80,4500,5300,"Sub-basin 8"
1435,300,9,1800,2100,"Sub-basin 8"
1436,100,1,1700,1800,"Sub-basin 8"
1437,500,42,1300,1800,"Sub-basin 8"
1438,300,11,2800,3100,"Sub-basin 8"
1439,100,4,1200,1300,"Sub-basin 8"
1440,500,19,5900,6400,"Sub-basin 8"
1441,500,85,2800,3300,"Sub-basin 8"
1442,400,28,700,1100,"Sub-basin 8"
1443,100,4,2000,2100,"Sub-basin 8"
1444,400,13,2500,2900,"Sub-basin 8"
1445,200,10,1200,1400,"Sub-basin 8"
1446,100,1,1500,1600,"Sub-basin 8"
1447,400,37,4900,5300,"Sub-basin 8"
1448,100,1,2500,2600,"Sub-basin 8"
1449,200,3,7600,7800,"Sub-basin 8"
1450,600,50,3800,4400,"Sub-basin 8"
1451,600,30,5500,6100,"Sub-basin 8"
1452,1000,154,3200,4200,"Sub-basin 8"
1453,600,59,2900,3500,"Sub-basin 8"
1454,400,90,2300,2700,"Sub-basin 8"
1455,100,8,1300,1400,"Sub-basin 8"
1456,900,83,8100,9000,"Sub-basin 8"
1457,100,3,800,900,"Sub-basin 8"
1458,200,12,3700,3900,"Sub-basin 8"
1459,100,2,2600,2700,"Sub-basin 8"
1460,1100,42,8300,9400,"Sub-basin 8"
1461,1300,100,5100,6400,"Sub-basin 8"
1462,300,8,1200,1500,"Sub-basin 8"
1463,400,55,3900,4300,"Sub-basin 8"
1464,100,7,400,500,"Sub-basin 8"
1465,200,4,1600,1800,"Sub-basin 8"
1466,100,2,800,900,"Sub-basin 8"
1467,100,1,2200,2300,"Sub-basin 8"
1468,500,48,3200,3700,"Sub-basin 8"
1469,700,44,4800,5500,"Sub-basin 8"
1470,400,30,1900,2300,"Sub-basin 8"
1471,500,53,2600,3100,"Sub-basin 8"
1472,800,62,5200,6000,"Sub-basin 8"
1473,100,2,1100,1200,"Sub-basin 8"
1474,800,170,3200,4000,"Sub-basin 8"
1475,500,33,2000,2500,"Sub-basin 8"
1476,900,145,6700,7600,"Sub-basin 8"
1477,900,103,3800,4700,"Sub-basin 8"
1478,600,49,3800,4400,"Sub-basin 8"
1479,2300,512,7200,9500,"Sub-basin 8"
1480,100,1,3600,3700,"Sub-basin 8"
1481,500,58,5800,6300,"Sub-basin 8"
1482,400,10,2500,2900,"Sub-basin 8"
1483,200,4,1600,1800,"Sub-basin 8"
1484,300,26,500,800,"Sub-basin 8"
1485,200,12,1600,1800,"Sub-basin 8"
1486,400,50,2000,2400,"Sub-basin 8"
1487,1000,109,2500,3500,"Sub-basin 8"
1488,700,68,3100,3800,"Sub-basin 8"
1489,300,16,1200,1500,"Sub-basin 8"
1490,700,134,3100,3800,"Sub-basin 8"
1491,900,181,3900,4800,"Sub-basin 8"
1492,400,20,3400,3800,"Sub-basin 8"
1493,12000,2101,34200,46200,"Sub-basin 8"
1494,100,2,1800,1900,"Sub-basin 8"
1495,200,4,4100,4300,"Sub-basin 8"
1496,300,14,2200,2500,"Sub-basin 8"
1497,100,3,600,700,"Sub-basin 8"
1498,600,74,2400,3000,"Sub-basin 8"
1499,400,8,2200,2600,"Sub-basin 8"
1500,1700,206,5700,7400,"Sub-basin 8"
1501,600,38.1164,5200,5800,"Sub-basin 8"
1502,500,22,2800,3300,"Sub-basin 8"
1503,400,11,4700,5100,"Sub-basin 8"
1504,500,14,12700,13200,"Sub-basin 8"
1505,900,93,9000,9900,"Sub-basin 8"
1506,600,31,3400,4000,"Sub-basin 8"
1507,1500,102,11000,12500,"Sub-basin 8"
1508,200,5,3100,3300,"Sub-basin 8"
1509,400,20,3100,3500,"Sub-basin 8"
1510,300,15,2300,2600,"Sub-basin 8"
1511,200,11,2400,2600,"Sub-basin 8"
1512,100,4,2100,2200,"Sub-basin 8"
1513,500,24,5000,5500,"Sub-basin 8"
1514,200,13,1500,1700,"Sub-basin 8"
1515,500,14,2600,3100,"Sub-basin 8"
1516,500,55,1600,2100,"Sub-basin 8"
1517,1200,131,3100,4300,"Sub-basin 8"
1518,300,13,2100,2400,"Sub-basin 8"
1519,300,11,3600,3900,"Sub-basin 8"
1520,300,53,6200,6500,"Sub-basin 8"
1521,100,2,1500,1600,"Sub-basin 8"
1522,200,3,2400,2600,"Sub-basin 8"
1523,400,47,1700,2100,"Sub-basin 8"
1524,200,7,2200,2400,"Sub-basin 8"
1525,200,4,400,600,"Sub-basin 8"
1526,700,36,5000,5700,"Sub-basin 8"
1527,2100,325,5200,7300,"Sub-basin 8"
1528,1400,170,6300,7700,"Sub-basin 8"
1529,100,3,1800,1900,"Sub-basin 8"
1530,100,1,2700,2800,"Sub-basin 8"
1531,2700,379,20000,22700,"Sub-basin 8"
1532,200,8,1900,2100,"Sub-basin 8"
1533,100,3,1200,1300,"Sub-basin 8"
1534,100,2,300,400,"Sub-basin 8"
1535,1200,98,8500,9700,"Sub-basin 8"
1536,200,6,3200,3400,"Sub-basin 8"
1537,500,25,2900,3400,"Sub-basin 8"
1538,600,78,1800,2400,"Sub-basin 8"
1539,1100,79,11700,12800,"Sub-basin 8"
1540,200,11,3300,3500,"Sub-basin 8"
1541,100,2,800,900,"Sub-basin 8"
1542,200,8,6000,6200,"Sub-basin 8"
1543,100,2,3700,3800,"Sub-basin 8"
1544,300,23,900,1200,"Sub-basin 8"
1545,1000,45,3300,4300,"Sub-basin 8"
1546,700,47,3100,3800,"Sub-basin 8"
1547,8500,2534,21800,30300,"Sub-basin 8"
1548,3500,1040,8200,11700,"Sub-basin 8"
1549,200,6,1200,1400,"Sub-basin 8"
1550,200,11,1500,1700,"Sub-basin 8"
1551,400,11,3200,3600,"Sub-basin 8"
1552,400,39,3800,4200,"Sub-basin 8"
1553,100,9,900,1000,"Sub-basin 8"
1554,400,49,3200,3600,"Sub-basin 8"
1555,400,9,1800,2200,"Sub-basin 8"
1556,2700,174,12200,14900,"Sub-basin 8"
1557,100,4,1300,1400,"Sub-basin 8"
1558,8000,3615,10900,18900,"Sub-basin 8"
1559,100,3,1200,1300,"Sub-basin 8"
1560,200,4,2800,3000,"Sub-basin 8"
1561,400,6,6200,6600,"Sub-basin 8"
1562,300,11,5700,6000,"Sub-basin 8"
1563,800,51,4800,5600,"Sub-basin 8"
1564,500,30,3600,4100,"Sub-basin 8"
1565,200,3,900,1100,"Sub-basin 8"
1566,400,22,2000,2400,"Sub-basin 8"
1567,1000,101,7700,8700,"Sub-basin 8"
1568,400,10,6000,6400,"Sub-basin 8"
1569,1100,73,7300,8400,"Sub-basin 8"
1570,200,9,1100,1300,"Sub-basin 8"
1571,900,122,3300,4200,"Sub-basin 8"
1572,1300,333,3300,4600,"Sub-basin 8"
1573,2900,386,17200,20100,"Sub-basin 8"
1574,1700,121,14700,16400,"Sub-basin 8"
1575,300,14,3500,3800,"Sub-basin 8"
1576,3100,671,6200,9300,"Sub-basin 8"
1577,1500,140,4400,5900,"Sub-basin 8"
1578,500,48,3500,4000,"Sub-basin 8"
1579,400,59,2200,2600,"Sub-basin 8"
1580,700,96,4100,4800,"Sub-basin 8"
1581,700,44,3100,3800,"Sub-basin 8"
1582,200,4,2100,2300,"Sub-basin 8"
1583,600,73,3300,3900,"Sub-basin 8"
1584,1200,287,3400,4600,"Sub-basin 8"
1585,100,1,2800,2900,"Sub-basin 8"
1586,200,5,1200,1400,"Sub-basin 8"
1587,200,3,1100,1300,"Sub-basin 8"
1588,100,1,1700,1800,"Sub-basin 8"
1589,100,1,400,500,"Sub-basin 8"
1590,100,7,3200,3300,"Sub-basin 8"
1591,400,13,9400,9800,"Sub-basin 8"
1592,900,100,4600,5500,"Sub-basin 8"
1593,200,5,1700,1900,"Sub-basin 8"
1594,200,2,1800,2000,"Sub-basin 8"
1595,900,27,8300,9200,"Sub-basin 8"
1596,100,3,1300,1400,"Sub-basin 8"
1597,400,75,3800,4200,"Sub-basin 8"
1598,100,2,1400,1500,"Sub-basin 8"
1599,600,29,2600,3200,"Sub-basin 8"
1600,300,6,2700,3000,"Sub-basin 8"
1601,200,8,5000,5200,"Sub-basin 8"
1602,600,88,2500,3100,"Sub-basin 8"
1603,200,7,1300,1500,"Sub-basin 8"
1604,200,12,700,900,"Sub-basin 8"
1605,200,16,500,700,"Sub-basin 8"
1606,200,8,1400,1600,"Sub-basin 8"
1607,100,1,1900,2000,"Sub-basin 8"
1608,200,4,3500,3700,"Sub-basin 8"
1609,900,101,2900,3800,"Sub-basin 8"
1610,400,66,6100,6500,"Sub-basin 8"
1611,300,27,5000,5300,"Sub-basin 8"
1612,1400,315,7800,9200,"Sub-basin 8"
1613,100,4,400,500,"Sub-basin 8"
1614,200,4,2600,2800,"Sub-basin 8"
1615,100,2,1700,1800,"Sub-basin 8"
1616,200,4,2700,2900,"Sub-basin 8"
1617,200,30,600,800,"Sub-basin 8"
1618,1900,563,8300,10200,"Sub-basin 8"
1619,1100,289,8600,9700,"Sub-basin 8"
1620,1000,62,12200,13200,"Sub-basin 8"
1621,2800,256,11300,14100,"Sub-basin 8"
1622,400,47,2300,2700,"Sub-basin 8"
1623,100,4,600,700,"Sub-basin 8"
1624,100,2,1100,1200,"Sub-basin 8"
1625,100,3,1500,1600,"Sub-basin 8"
1626,300,7,5200,5500,"Sub-basin 8"
1627,100,2,900,1000,"Sub-basin 8"
1628,500,25,3500,4000,"Sub-basin 8"
1629,200,3,2100,2300,"Sub-basin 8"
1630,100,1,700,800,"Sub-basin 8"
1631,100,1,200,300,"Sub-basin 8"
1632,1000,119,3600,4600,"Sub-basin 8"
1633,400,32,2000,2400,"Sub-basin 8"
1634,400,64,1600,2000,"Sub-basin 8"
1635,300,17,7700,8000,"Sub-basin 8"
1636,100,1,2100,2200,"Sub-basin 8"
1637,1000,77,9900,10900,"Sub-basin 8"
1638,500,32,7300,7800,"Sub-basin 8"
1639,900,116,5700,6600,"Sub-basin 8"
1640,200,3,1700,1900,"Sub-basin 8"
1641,700,90,3500,4200,"Sub-basin 8"
1642,100,1,1300,1400,"Sub-basin 8"
1643,1300,219,4100,5400,"Sub-basin 8"
1644,200,7,2900,3100,"Sub-basin 8"
1645,100,3,1100,1200,"Sub-basin 8"
1646,600,22,3600,4200,"Sub-basin 8"
1647,800,110,2300,3100,"Sub-basin 8"
1648,100,1,3100,3200,"Sub-basin 8"
1649,500,21,1800,2300,"Sub-basin 8"
1650,900,144,5500,6400,"Sub-basin 8"
1651,600,62,1600,2200,"Sub-basin 8"
1652,100,1,1000,1100,"Sub-basin 8"
1653,1300,136,6700,8000,"Sub-basin 8"
1654,100,1,500,600,"Sub-basin 8"
1655,3000,162,16300,19300,"Sub-basin 8"
1656,200,16,11400,11600,"Sub-basin 8"
1657,200,27,3300,3500,"Sub-basin 8"
1658,800,156,5700,6500,"Sub-basin 8"
1659,3200,902,7000,10200,"Sub-basin 8"
1660,600,63,2100,2700,"Sub-basin 8"
1661,800,116,3600,4400,"Sub-basin 8"
1662,400,54,2000,2400,"Sub-basin 8"
1663,100,1,1700,1800,"Sub-basin 8"
1664,400,16,2300,2700,"Sub-basin 8"
1665,800,45,4900,5700,"Sub-basin 8"
1666,600,142,3600,4200,"Sub-basin 8"
1667,700,156,5700,6400,"Sub-basin 8"
1668,100,2,1000,1100,"Sub-basin 8"
1669,700,148,2300,3000,"Sub-basin 8"
1670,900,127,5800,6700,"Sub-basin 8"
1671,300,6,3500,3800,"Sub-basin 8"
1672,100,1,900,1000,"Sub-basin 8"
1673,3800,268,27600,31400,"Sub-basin 8"
1674,2000,340,7900,9900,"Sub-basin 8"
1675,400,31,3100,3500,"Sub-basin 8"
1676,200,8,1600,1800,"Sub-basin 8"
1677,800,142,3600,4400,"Sub-basin 8"
1678,600,23,2700,3300,"Sub-basin 8"
1679,1100,233,3400,4500,"Sub-basin 8"
1680,1000,83,9800,10800,"Sub-basin 8"
1681,400,22,2900,3300,"Sub-basin 8"
1682,200,3,500,700,"Sub-basin 8"
1683,200,4,3300,3500,"Sub-basin 8"
1684,900,60,4400,5300,"Sub-basin 8"
1685,600,37,4800,5400,"Sub-basin 8"
1686,14700,4392.331,28000,42700,"Sub-basin 8"
1687,300,20,3000,3300,"Sub-basin 8"
1688,2000,325,7600,9600,"Sub-basin 8"
1689,300,10,1600,1900,"Sub-basin 8"
1690,300,10,2800,3100,"Sub-basin 8"
1691,9900,3682,17900,27800,"Sub-basin 8"
1692,800,184,5000,5800,"Sub-basin 8"
1693,300,26,1100,1400,"Sub-basin 8"
1694,800,145,4100,4900,"Sub-basin 8"
1695,3900,971,9300,13200,"Sub-basin 8"
1696,400,18,2100,2500,"Sub-basin 8"
1697,1300,140,8200,9500,"Sub-basin 8"
1698,800,128,3900,4700,"Sub-basin 8"
1699,200,5,1300,1500,"Sub-basin 8"
1700,100,3,900,1000,"Sub-basin 8"
1701,3400,669,10500,13900,"Sub-basin 8"
1702,100,1,2100,2200,"Sub-basin 8"
1703,100,4,2400,2500,"Sub-basin 8"
1704,100,1,1800,1900,"Sub-basin 8"
1705,200,14,3100,3300,"Sub-basin 8"
1706,400,20,1300,1700,"Sub-basin 8"
1707,200,4,1500,1700,"Sub-basin 8"
1708,300,17,2100,2400,"Sub-basin 8"
1709,1400,429,11300,12700,"Sub-basin 8"
1710,100,3,1500,1600,"Sub-basin 8"
1711,100,1,1400,1500,"Sub-basin 8"
1712,1200,187,5300,6500,"Sub-basin 8"
1713,700,53,3200,3900,"Sub-basin 8"
1714,200,5,3500,3700,"Sub-basin 8"
1715,200,9,3500,3700,"Sub-basin 8"
1716,2200,704,5400,7600,"Sub-basin 8"
1717,300,22,1200,1500,"Sub-basin 8"
1718,3100,672.124,7700,10800,"Sub-basin 8"
1719,600,41.024,2400,3000,"Sub-basin 8"
1720,700,72,3800,4500,"Sub-basin 8"
1721,400,24,3000,3400,"Sub-basin 8"
1722,900,37,5200,6100,"Sub-basin 8"
1723,900,49,5100,6000,"Sub-basin 8"
1724,1800,204,9500,11300,"Sub-basin 8"
1725,1300,83,16000,17300,"Sub-basin 8"
1726,300,28,5500,5800,"Sub-basin 8"
1727,300,8,4000,4300,"Sub-basin 8"
1728,100,2,1600,1700,"Sub-basin 8"
1729,1700,206,3400,5100,"Sub-basin 8"
1730,9600,2901,12700,22300,"Sub-basin 8"
1731,100,5,2000,2100,"Sub-basin 8"
1732,700,59,2700,3400,"Sub-basin 8"
1733,500,23,2900,3400,"Sub-basin 8"
1734,200,8,1900,2100,"Sub-basin 8"
1735,800,116,2400,3200,"Sub-basin 8"
1736,84400,34528.6641,63700,148100,"Sub-basin 8"
1737,600,27,3500,4100,"Sub-basin 8"
1738,300,12,900,1200,"Sub-basin 8"
1739,300,20,4800,5100,"Sub-basin 8"
1740,300,12,2300,2600,"Sub-basin 8"
1741,400,88,3000,3400,"Sub-basin 8"
1742,700,62,3400,4100,"Sub-basin 8"
1743,3200,1273,13300,16500,"Sub-basin 8"
1744,100,2,1800,1900,"Sub-basin 8"
1745,3500,922,11200,14700,"Sub-basin 8"
1746,200,13,1400,1600,"Sub-basin 8"
1747,600,38,3600,4200,"Sub-basin 8"
1748,100,1,900,1000,"Sub-basin 8"
1749,300,12,4400,4700,"Sub-basin 8"
1750,300,46,5100,5400,"Sub-basin 8"
1751,1100,47,6800,7900,"Sub-basin 8"
1752,500,38,5100,5600,"Sub-basin 8"
1753,100,1,600,700,"Sub-basin 8"
1754,700,41,4200,4900,"Sub-basin 8"
1755,100,3,900,1000,"Sub-basin 8"
1756,1200,100,6700,7900,"Sub-basin 8"
1757,600,37,3800,4400,"Sub-basin 8"
1758,600,42,6200,6800,"Sub-basin 8"
1759,200,8,2900,3100,"Sub-basin 8"
1760,100,5,1400,1500,"Sub-basin 8"
1761,200,12,1100,1300,"Sub-basin 8"
1762,700,34,3800,4500,"Sub-basin 8"
1763,100,2,2200,2300,"Sub-basin 8"
1764,1700,252,6100,7800,"Sub-basin 8"
1765,100,5,2000,2100,"Sub-basin 8"
1766,900,113,2400,3300,"Sub-basin 8"
1767,100,3,1800,1900,"Sub-basin 8"
1768,800,77,3600,4400,"Sub-basin 8"
1769,1500,251,5300,6800,"Sub-basin 8"
1770,200,10,2000,2200,"Sub-basin 8"
1771,500,23,4900,5400,"Sub-basin 8"
1772,29300,14050,35100,64400,"Sub-basin 8"
1773,100,1,2200,2300,"Sub-basin 8"
1774,7300,2260,17200,24500,"Sub-basin 8"
1775,3500,937,8400,11900,"Sub-basin 8"
1776,800,40,4500,5300,"Sub-basin 8"
1777,1800,225,6200,8000,"Sub-basin 8"
1778,400,30,3600,4000,"Sub-basin 8"
1779,100,3,1100,1200,"Sub-basin 8"
1780,500,11,4200,4700,"Sub-basin 8"
1781,200,5,2400,2600,"Sub-basin 8"
1782,200,53,1200,1400,"Sub-basin 8"
1783,2600,744,4300,6900,"Sub-basin 8"
1784,3300,364,12300,15600,"Sub-basin 8"
1785,1200,250,6000,7200,"Sub-basin 8"
1786,400,17,2600,3000,"Sub-basin 8"
1787,100,1,1300,1400,"Sub-basin 8"
1788,200,7,1000,1200,"Sub-basin 8"
1789,600,57,3800,4400,"Sub-basin 8"
1790,100,3,900,1000,"Sub-basin 8"
1791,300,5,2200,2500,"Sub-basin 8"
1792,100,1,2500,2600,"Sub-basin 8"
1793,500,35,2500,3000,"Sub-basin 8"
1794,300,12,2400,2700,"Sub-basin 8"
1795,300,12,1100,1400,"Sub-basin 8"
1796,800,95,2400,3200,"Sub-basin 8"
1797,400,17,3400,3800,"Sub-basin 8"
1798,700,56,1800,2500,"Sub-basin 8"
1799,100,2,1200,1300,"Sub-basin 8"
1800,800,93.33,4200,5000,"Sub-basin 8"
1801,1500,228,5000,6500,"Sub-basin 8"
1802,100,1,5300,5400,"Sub-basin 8"
1803,1300,100,10100,11400,"Sub-basin 8"
1804,100,1,1700,1800,"Sub-basin 8"
1805,100,1,1100,1200,"Sub-basin 8"
1806,2800,1054,5300,8100,"Sub-basin 8"
1807,100,3,1100,1200,"Sub-basin 8"
1808,800,63,4800,5600,"Sub-basin 8"
1809,600,50,3600,4200,"Sub-basin 8"
1810,6300,2868,25800,32100,"Sub-basin 8"
1811,400,56,700,1100,"Sub-basin 8"
1812,400,60.004,1700,2100,"Sub-basin 8"
1813,4700,1186,10300,15000,"Sub-basin 8"
1814,600,22,3300,3900,"Sub-basin 8"
1815,200,11,800,1000,"Sub-basin 8"
1816,100,3,1800,1900,"Sub-basin 8"
1817,100,5,3500,3600,"Sub-basin 8"
1818,700,74,2100,2800,"Sub-basin 8"
1819,100,2,1500,1600,"Sub-basin 8"
1820,2200,406,7200,9400,"Sub-basin 8"
1821,100,2,600,700,"Sub-basin 8"
1822,200,9,3400,3600,"Sub-basin 8"
1823,100,1,1900,2000,"Sub-basin 8"
1824,200,8,2900,3100,"Sub-basin 8"
1825,100,1,600,700,"Sub-basin 8"
1826,900,75,4100,5000,"Sub-basin 8"
1827,600,36,4000,4600,"Sub-basin 8"
1828,100,2,800,900,"Sub-basin 8"
1829,1100,263,2000,3100,"Sub-basin 8"
1830,100,4,2400,2500,"Sub-basin 8"
1831,1900,198,9100,11000,"Sub-basin 8"
1832,100,4,1800,1900,"Sub-basin 8"
1833,100,2,2300,2400,"Sub-basin 8"
1834,500,56,2000,2500,"Sub-basin 8"
1835,400,55,2000,2400,"Sub-basin 8"
1836,1500,299,2500,4000,"Sub-basin 8"
1837,500,78,4000,4500,"Sub-basin 8"
1838,100,2,2700,2800,"Sub-basin 8"
1839,300,14,3100,3400,"Sub-basin 8"
1840,200,2,3200,3400,"Sub-basin 8"
1841,1600,242.0174,6400,8000,"Sub-basin 8"
1842,700,50,6000,6700,"Sub-basin 8"
1843,1000,91,2900,3900,"Sub-basin 8"
1844,800,274,4200,5000,"Sub-basin 8"
1845,1000,205,4300,5300,"Sub-basin 8"
1846,600,29,5800,6400,"Sub-basin 8"
1847,100,1,1000,1100,"Sub-basin 8"
1848,1300,94,6300,7600,"Sub-basin 8"
1849,100,1,1000,1100,"Sub-basin 8"
1850,100,1,700,800,"Sub-basin 8"
1851,100,1,1400,1500,"Sub-basin 8"
1852,400,27,2500,2900,"Sub-basin 8"
1853,100,3,800,900,"Sub-basin 8"
1854,500,41,3400,3900,"Sub-basin 8"
1855,300,45,1400,1700,"Sub-basin 8"
1856,300,14,1900,2200,"Sub-basin 8"
1857,100,2,1200,1300,"Sub-basin 8"
1858,7500,3369,9000,16500,"Sub-basin 8"
1859,1800,496,4000,5800,"Sub-basin 8"
1860,700,59,4900,5600,"Sub-basin 8"
1861,100,4,1100,1200,"Sub-basin 8"
1862,300,9,1500,1800,"Sub-basin 8"
1863,400,17,1700,2100,"Sub-basin 8"
1864,100,1,1500,1600,"Sub-basin 8"
1865,1300,406,3900,5200,"Sub-basin 8"
1866,400,31,2900,3300,"Sub-basin 8"
1867,100,2,900,1000,"Sub-basin 8"
1868,400,30,2900,3300,"Sub-basin 8"
1869,400,52,800,1200,"Sub-basin 8"
1870,200,6,1000,1200,"Sub-basin 8"
1871,600,39,1700,2300,"Sub-basin 8"
1872,500,34,3400,3900,"Sub-basin 8"
1873,2200,512,5800,8000,"Sub-basin 8"
1874,500,38,3100,3600,"Sub-basin 8"
1875,1900,234,9600,11500,"Sub-basin 8"
1876,3800,898,8800,12600,"Sub-basin 8"
1877,200,6,3600,3800,"Sub-basin 8"
1878,8800,3026,18400,27200,"Sub-basin 8"
1879,100,4,800,900,"Sub-basin 8"
1880,200,12,3200,3400,"Sub-basin 8"
1881,300,25,4000,4300,"Sub-basin 8"
1882,100,1,1100,1200,"Sub-basin 8"
1883,900,203,4900,5800,"Sub-basin 8"
1884,1600,132,11500,13100,"Sub-basin 8"
1885,800,70,4900,5700,"Sub-basin 8"
1886,500,41,2800,3300,"Sub-basin 8"
1887,1000,73,17000,18000,"Sub-basin 8"
1888,100,1,500,600,"Sub-basin 8"
1889,400,31,2000,2400,"Sub-basin 8"
1890,400,7,2400,2800,"Sub-basin 8"
1891,100,1,1300,1400,"Sub-basin 8"
1892,2200,730,6700,8900,"Sub-basin 8"
1893,2100,242,5800,7900,"Sub-basin 8"
1894,100,1,1300,1400,"Sub-basin 8"
1895,1100,171,5500,6600,"Sub-basin 8"
1896,600,34,6100,6700,"Sub-basin 8"
1897,100,1,3000,3100,"Sub-basin 8"
1898,500,24,6200,6700,"Sub-basin 8"
1899,200,10,1100,1300,"Sub-basin 8"
1900,2600,683,3200,5800,"Sub-basin 8"
1901,100,1,1100,1200,"Sub-basin 8"
1902,700,232,2100,2800,"Sub-basin 8"
1903,4400,1769,7000,11400,"Sub-basin 8"
1904,200,4,2700,2900,"Sub-basin 8"
1905,200,5,2700,2900,"Sub-basin 8"
1906,16300,2461.7084,68600,84900,"Sub-basin 8"
1907,700,59,4200,4900,"Sub-basin 8"
1908,200,5,1500,1700,"Sub-basin 8"
1909,100,2,800,900,"Sub-basin 8"
1910,3100,438,9800,12900,"Sub-basin 8"
1911,400,15,800,1200,"Sub-basin 8"
1912,200,10,3800,4000,"Sub-basin 8"
1913,1900,230,12000,13900,"Sub-basin 8"
1914,2800,2305,17200,20000,"Sub-basin 8"
1915,300,14,2800,3100,"Sub-basin 8"
1916,900,71,7300,8200,"Sub-basin 8"
1917,300,13,2700,3000,"Sub-basin 8"
1918,2500,1055,3300,5800,"Sub-basin 8"
1919,800,234,5000,5800,"Sub-basin 8"
1920,1000,62,6500,7500,"Sub-basin 8"
1921,800,55,4300,5100,"Sub-basin 8"
1922,100,1,400,500,"Sub-basin 8"
1923,7000,2272,18500,25500,"Sub-basin 8"
1924,500,24,5900,6400,"Sub-basin 8"
1925,1300,304,4900,6200,"Sub-basin 8"
1926,200,9,2900,3100,"Sub-basin 8"
1927,100,1,900,1000,"Sub-basin 8"
1928,1200,581,3200,4400,"Sub-basin 8"
1929,100,4,1700,1800,"Sub-basin 8"
1930,100,7,1500,1600,"Sub-basin 8"
1931,100,1,2500,2600,"Sub-basin 8"
1932,100,1,3100,3200,"Sub-basin 8"
1933,200,7,1000,1200,"Sub-basin 8"
1934,800,82,5900,6700,"Sub-basin 8"
1935,1400,107,7600,9000,"Sub-basin 8"
1936,200,24,3300,3500,"Sub-basin 8"
1937,100,2,1800,1900,"Sub-basin 8"
1938,100,1,1600,1700,"Sub-basin 8"
1939,600,94,2800,3400,"Sub-basin 8"
1940,11600,2710,39800,51400,"Sub-basin 8"
1941,1200,226,3100,4300,"Sub-basin 8"
1942,1700,192,17400,19100,"Sub-basin 8"
1943,700,27,4500,5200,"Sub-basin 8"
1944,800,60,4100,4900,"Sub-basin 8"
1945,7100,1641,15000,22100,"Sub-basin 8"
1946,600,19,5900,6500,"Sub-basin 8"
1947,300,10,4400,4700,"Sub-basin 8"
1948,200,16,2200,2400,"Sub-basin 8"
1949,300,8,7500,7800,"Sub-basin 8"
1950,900,53,6600,7500,"Sub-basin 8"
1951,1100,199,2900,4000,"Sub-basin 8"
1952,200,6,2400,2600,"Sub-basin 8"
1953,900,48,2100,3000,"Sub-basin 8"
1954,100,1,800,900,"Sub-basin 8"
1955,1100,81,9700,10800,"Sub-basin 8"
1956,1100,201,7500,8600,"Sub-basin 8"
1957,100,1,1000,1100,"Sub-basin 8"
1958,1100,109,14700,15800,"Sub-basin 8"
1959,2400,299,15900,18300,"Sub-basin 8"
1960,2300,647,11300,13600,"Sub-basin 8"
1961,200,14,2700,2900,"Sub-basin 8"
1962,10300,3087.16,15800,26100,"Sub-basin 8"
1963,200,3,1000,1200,"Sub-basin 8"
1964,100,3,1600,1700,"Sub-basin 8"
1965,400,105,2100,2500,"Sub-basin 8"
1966,100,1,2400,2500,"Sub-basin 8"
1967,100,2,1300,1400,"Sub-basin 8"
1968,200,6,1900,2100,"Sub-basin 8"
1969,400,12,3300,3700,"Sub-basin 8"
1970,4000,1922,7800,11800,"Sub-basin 8"
1971,3600,904,9000,12600,"Sub-basin 8"
1972,200,2,2400,2600,"Sub-basin 8"
1973,1700,162,9000,10700,"Sub-basin 8"
1974,400,23,3600,4000,"Sub-basin 8"
1975,500,42,3900,4400,"Sub-basin 8"
1976,100,5,1300,1400,"Sub-basin 8"
1977,500,13,2500,3000,"Sub-basin 8"
1978,1500,108,12400,13900,"Sub-basin 8"
1979,600,61,5800,6400,"Sub-basin 8"
1980,1700,59,5300,7000,"Sub-basin 8"
1981,300,12,2900,3200,"Sub-basin 8"
1982,2100,305,10300,12400,"Sub-basin 8"
1983,800,40,10400,11200,"Sub-basin 8"
1984,200,8,1200,1400,"Sub-basin 8"
1985,100,4,1300,1400,"Sub-basin 8"
1986,20700,11577.8368,23400,44100,"Sub-basin 8"
1987,100,3,1600,1700,"Sub-basin 8"
1988,300,23,2500,2800,"Sub-basin 8"
1989,1100,155,4300,5400,"Sub-basin 8"
1990,400,11,4400,4800,"Sub-basin 8"
1991,100,3,1000,1100,"Sub-basin 8"
1992,2300,177,21200,23500,"Sub-basin 8"
1993,100,2,1200,1300,"Sub-basin 8"
1994,1100,172,1500,2600,"Sub-basin 8"
1995,400,29,2000,2400,"Sub-basin 8"
1996,500,16,3600,4100,"Sub-basin 8"
1997,100,1,1800,1900,"Sub-basin 8"
1998,1700,101,5000,6700,"Sub-basin 8"
1999,1700,155,5400,7100,"Sub-basin 8"
2000,3200,954,10100,13300,"Sub-basin 8"
2001,2900,697,11100,14000,"Sub-basin 8"
2002,200,6,1800,2000,"Sub-basin 8"
2003,1700,475,6900,8600,"Sub-basin 8"
2004,200,3,1700,1900,"Sub-basin 8"
2005,1600,151,5000,6600,"Sub-basin 8"
2006,100,1,2300,2400,"Sub-basin 8"
2007,200,3,300,500,"Sub-basin 8"
2008,100,1,1000,1100,"Sub-basin 8"
2009,1100,168,8500,9600,"Sub-basin 8"
2010,400,26,2900,3300,"Sub-basin 8"
2011,400,14,4100,4500,"Sub-basin 8"
2012,900,108,4500,5400,"Sub-basin 8"
2013,600,39,4100,4700,"Sub-basin 8"
2014,100,4,1100,1200,"Sub-basin 8"
2015,100,3,1600,1700,"Sub-basin 8"
2016,100,5,800,900,"Sub-basin 8"
2017,200,4,300,500,"Sub-basin 8"
2018,2000,102,6500,8500,"Sub-basin 8"
2019,800,60,6700,7500,"Sub-basin 8"
2020,200,2,3400,3600,"Sub-basin 8"
2021,1700,615,5300,7000,"Sub-basin 8"
2022,500,37,1300,1800,"Sub-basin 8"
2023,2100,237,11300,13400,"Sub-basin 8"
2024,200,14,1600,1800,"Sub-basin 8"
2025,400,20,1300,1700,"Sub-basin 8"
2026,18000,7823.858,16300,34300,"Sub-basin 8"
2027,56100,30765.67,59500,115600,"Sub-basin 8"
2028,300,16,3200,3500,"Sub-basin 8"
2029,2900,448,9800,12700,"Sub-basin 8"
2030,600,20,6000,6600,"Sub-basin 8"
2031,1100,128,4200,5300,"Sub-basin 8"
2032,1400,83,10800,12200,"Sub-basin 8"
2033,1200,91,7000,8200,"Sub-basin 8"
2034,100,4,600,700,"Sub-basin 8"
2035,500,90,800,1300,"Sub-basin 8"
2036,9100,2715,20100,29200,"Sub-basin 8"
2037,100,1,600,700,"Sub-basin 8"
2038,700,34,6700,7400,"Sub-basin 8"
2039,1800,270.5,8600,10400,"Sub-basin 8"
2040,6100,2629.85,25200,31300,"Sub-basin 8"
2041,5400,2083.82,13300,18700,"Sub-basin 8"
2042,300,17,1500,1800,"Sub-basin 8"
2043,2000,636,6900,8900,"Sub-basin 8"
2044,900,62,9300,10200,"Sub-basin 8"
2045,6700,2048.99,13500,20200,"Sub-basin 8"
2046,100,5,0,100,"Sub-basin 8"
2047,400,8,2900,3300,"Sub-basin 8"
2048,100,2,1100,1200,"Sub-basin 8"
2049,100,3,3000,3100,"Sub-basin 8"
2050,8500,3412.68,18500,27000,"Sub-basin 8"
2051,800,124.83,7300,8100,"Sub-basin 8"
2052,100,2,1800,1900,"Sub-basin 8"
2053,1800,328.67,12500,14300,"Sub-basin 8"
2054,3100,351.5,21400,24500,"Sub-basin 8"
2055,300,65,5300,5600,"Sub-basin 8"
2056,300,13,1400,1700,"Sub-basin 8"
2057,600,69.84,2400,3000,"Sub-basin 8"
2058,700,40.67,4100,4800,"Sub-basin 8"
2059,400,12,6100,6500,"Sub-basin 8"
2060,2600,401,5400,8000,"Sub-basin 8"
2061,800,87,4300,5100,"Sub-basin 8"
2062,500,53,4100,4600,"Sub-basin 8"
2063,100,2,1000,1100,"Sub-basin 8"
2064,600,41,3300,3900,"Sub-basin 8"
2065,100,1,1800,1900,"Sub-basin 8"
2066,200,4,2500,2700,"Sub-basin 8"
2067,400,8,5500,5900,"Sub-basin 8"
2068,100,1,1100,1200,"Sub-basin 8"
2069,1200,216,6300,7500,"Sub-basin 8"
2070,100,1,1100,1200,"Sub-basin 8"
2071,200,10,1400,1600,"Sub-basin 8"
2072,500,17,3900,4400,"Sub-basin 8"
2073,3200,879,6800,10000,"Sub-basin 8"
2074,100,1,2600,2700,"Sub-basin 8"
2075,200,12,3800,4000,"Sub-basin 8"
2076,300,9,1700,2000,"Sub-basin 8"
2077,500,14,4500,5000,"Sub-basin 8"
2078,100,5,1000,1100,"Sub-basin 8"
2079,400,15,4500,4900,"Sub-basin 8"
2080,600,43,10100,10700,"Sub-basin 8"
2081,100,2,800,900,"Sub-basin 8"
2082,600,158,4000,4600,"Sub-basin 8"
2083,100,2,1400,1500,"Sub-basin 8"
2084,200,10,2200,2400,"Sub-basin 8"
2085,1200,75,3000,4200,"Sub-basin 8"
2086,100,1,1100,1200,"Sub-basin 8"
2087,200,4,2900,3100,"Sub-basin 8"
2088,300,23,5100,5400,"Sub-basin 8"
2089,100,3,700,800,"Sub-basin 8"
2090,600,39,4700,5300,"Sub-basin 8"
2091,200,7,1200,1400,"Sub-basin 8"
2092,500,12,5400,5900,"Sub-basin 8"
2093,4900,614,21500,26400,"Sub-basin 8"
2094,600,44,2700,3300,"Sub-basin 8"
2095,400,35,2600,3000,"Sub-basin 8"
2096,400,21,4900,5300,"Sub-basin 8"
2097,3800,515,12100,15900,"Sub-basin 8"
2098,100,1,200,300,"Sub-basin 8"
2099,200,2,1700,1900,"Sub-basin 8"
2100,300,8,1400,1700,"Sub-basin 8"
2101,800,110,6500,7300,"Sub-basin 8"
2102,200,10,700,900,"Sub-basin 8"
2103,600,35,5600,6200,"Sub-basin 8"
2104,1100,70,12800,13900,"Sub-basin 8"
2105,100,5,2600,2700,"Sub-basin 8"
2106,100,1,1600,1700,"Sub-basin 8"
2107,4400,1512,5300,9700,"Sub-basin 8"
2108,800,143,2600,3400,"Sub-basin 8"
2109,200,15,3000,3200,"Sub-basin 8"
2110,1100,199,6700,7800,"Sub-basin 8"
2111,100,2,2400,2500,"Sub-basin 8"
2112,400,67,2200,2600,"Sub-basin 8"
2113,1600,128,9000,10600,"Sub-basin 8"
2114,400,20,2100,2500,"Sub-basin 8"
2115,300,10,4800,5100,"Sub-basin 8"
2116,100,1,500,600,"Sub-basin 8"
2117,100,1,1000,1100,"Sub-basin 8"
2118,5100,459,39500,44600,"Sub-basin 8"
2119,100,4,1000,1100,"Sub-basin 8"
2120,18000,7231.4956,22400,40400,"Sub-basin 8"
2121,100,1,1500,1600,"Sub-basin 8"
2122,400,41,4500,4900,"Sub-basin 8"
2123,3300,900,15100,18400,"Sub-basin 8"
2124,400,22,5700,6100,"Sub-basin 8"
2125,400,23.0649,5100,5500,"Sub-basin 8"
2126,400,36,1300,1700,"Sub-basin 8"
2127,2200,493,11700,13900,"Sub-basin 8"
2128,300,11,900,1200,"Sub-basin 8"
2129,800,134,4400,5200,"Sub-basin 8"
2130,400,32,3500,3900,"Sub-basin 8"
2131,100,1,1800,1900,"Sub-basin 8"
2132,2100,284,5500,7600,"Sub-basin 8"
2133,400,49,3700,4100,"Sub-basin 8"
2134,500,30,5300,5800,"Sub-basin 8"
2135,300,20,2100,2400,"Sub-basin 8"
2136,900,54,4700,5600,"Sub-basin 8"
2137,100,1,1800,1900,"Sub-basin 8"
2138,600,39,7800,8400,"Sub-basin 8"
2139,2900,642,10700,13600,"Sub-basin 8"
2140,100,1,1700,1800,"Sub-basin 8"
2141,20800,5045,57900,78700,"Sub-basin 8"
2142,3200,906,7300,10500,"Sub-basin 8"
2143,100,3,800,900,"Sub-basin 8"
2144,500,20,4800,5300,"Sub-basin 8"
2145,500,12,5000,5500,"Sub-basin 8"
2146,200,5,3300,3500,"Sub-basin 8"
2147,49600,21391.1859,42400,92000,"Sub-basin 8"
2148,200,9,800,1000,"Sub-basin 8"
2149,400,18,2900,3300,"Sub-basin 8"
2150,1400,394,7000,8400,"Sub-basin 8"
2151,200,3,1700,1900,"Sub-basin 8"
2152,300,3,5500,5800,"Sub-basin 8"
2153,3900,227,26500,30400,"Sub-basin 8"
2154,100,2,1500,1600,"Sub-basin 8"
2155,100,5,200,300,"Sub-basin 8"
2156,300,5.0071,1900,2200,"Sub-basin 8"
2157,500,30,4200,4700,"Sub-basin 8"
2158,600,31,3700,4300,"Sub-basin 8"
2159,4600,766.1823,10600,15200,"Sub-basin 8"
2160,200,9,2500,2700,"Sub-basin 8"
2161,500,40,2500,3000,"Sub-basin 8"
2162,100,1,600,700,"Sub-basin 8"
2163,6700,1161,57200,63900,"Sub-basin 8"
2164,600,23,1900,2500,"Sub-basin 8"
2165,200,4,1600,1800,"Sub-basin 8"
2166,500,24,5300,5800,"Sub-basin 8"
2167,1000,137,2600,3600,"Sub-basin 8"
2168,100,2,1000,1100,"Sub-basin 8"
2169,1000,83,6000,7000,"Sub-basin 8"
2170,400,25,7100,7500,"Sub-basin 8"
2171,1100,180,3300,4400,"Sub-basin 8"
2172,7400,2319,10400,17800,"Sub-basin 8"
2173,300,35,5900,6200,"Sub-basin 8"
2174,100,1,1500,1600,"Sub-basin 8"
2175,200,25,900,1100,"Sub-basin 8"
2176,2500,279,11400,13900,"Sub-basin 8"
2177,5200,1066.3976,18100,23300,"Sub-basin 8"
2178,100,3,600,700,"Sub-basin 8"
2179,500,53,2500,3000,"Sub-basin 8"
2180,6300,962,18400,24700,"Sub-basin 8"
2181,900,43,7800,8700,"Sub-basin 8"
2182,400,38,3200,3600,"Sub-basin 8"
2183,100,7,1000,1100,"Sub-basin 8"
2184,1000,162,3100,4100,"Sub-basin 8"
2185,500,13,5600,6100,"Sub-basin 8"
2186,1400,100,6200,7600,"Sub-basin 8"
2187,200,12,1900,2100,"Sub-basin 8"
2188,2300,404,6600,8900,"Sub-basin 8"
2189,200,12,2100,2300,"Sub-basin 8"
2190,100,4,1100,1200,"Sub-basin 8"
2191,300,18,3700,4000,"Sub-basin 8"
2192,100,1,2400,2500,"Sub-basin 8"
2193,700,44,5000,5700,"Sub-basin 8"
2194,3800,573,19600,23400,"Sub-basin 8"
2195,600,44,1700,2300,"Sub-basin 8"
2196,1400,177,3700,5100,"Sub-basin 8"
2197,100,2,2300,2400,"Sub-basin 8"
2198,100,8,1500,1600,"Sub-basin 8"
2199,500,19,2100,2600,"Sub-basin 8"
2200,100,2,3000,3100,"Sub-basin 8"
2201,400,15,4600,5000,"Sub-basin 8"
2202,200,4,1200,1400,"Sub-basin 8"
2203,100,1,1400,1500,"Sub-basin 8"
2204,200,17,5300,5500,"Sub-basin 8"
2205,100,2,2700,2800,"Sub-basin 8"
2206,400,15,1500,1900,"Sub-basin 8"
2207,200,2,1600,1800,"Sub-basin 8"
2208,3000,1079,6700,9700,"Sub-basin 8"
2209,300,10,6000,6300,"Sub-basin 8"
2210,700,51,12200,12900,"Sub-basin 8"
2211,100,1,4800,4900,"Sub-basin 8"
2212,100,5,900,1000,"Sub-basin 8"
2213,100,10,800,900,"Sub-basin 8"
2214,2100,456,3200,5300,"Sub-basin 8"
2215,700,108,3000,3700,"Sub-basin 8"
2216,600,24,7400,8000,"Sub-basin 8"
2217,100,1,1600,1700,"Sub-basin 8"
2218,500,39,13400,13900,"Sub-basin 8"
2219,100,7,2400,2500,"Sub-basin 8"
2220,900,45,4300,5200,"Sub-basin 8"
2221,400,18,4700,5100,"Sub-basin 8"
2222,100,1,1100,1200,"Sub-basin 8"
2223,200,8,1500,1700,"Sub-basin 8"
2224,100,9,1000,1100,"Sub-basin 8"
2225,300,31,6400,6700,"Sub-basin 8"
2226,1100,49,9900,11000,"Sub-basin 8"
2227,99800,25971.0882,176100,275900,"Sub-basin 8"
2228,200,7,600,800,"Sub-basin 8"
2229,100,4,800,900,"Sub-basin 8"
2230,100,1,1400,1500,"Sub-basin 8"
2231,3000,1142,12500,15500,"Sub-basin 8"
2232,900,126,15500,16400,"Sub-basin 8"
2233,1600,151,6500,8100,"Sub-basin 8"
2234,700,90,4900,5600,"Sub-basin 8"
2235,300,9,3100,3400,"Sub-basin 8"
2236,11400,2420,28700,40100,"Sub-basin 8"
2237,1200,128,9700,10900,"Sub-basin 8"
2238,700,58,4600,5300,"Sub-basin 8"
2239,400,18,4900,5300,"Sub-basin 8"
2240,400,15,1500,1900,"Sub-basin 8"
2241,1000,140,2800,3800,"Sub-basin 8"
2242,100,3,1600,1700,"Sub-basin 8"
2243,200,16,1800,2000,"Sub-basin 8"
2244,900,85,4400,5300,"Sub-basin 8"
2245,2600,808,7500,10100,"Sub-basin 8"
2246,1800,357,8500,10300,"Sub-basin 8"
2247,100,5,1700,1800,"Sub-basin 8"
2248,200,2,1800,2000,"Sub-basin 8"
2249,200,7,4300,4500,"Sub-basin 8"
2250,100,3,1700,1800,"Sub-basin 8"
2251,1400,125,8000,9400,"Sub-basin 8"
2252,10200,5089,12600,22800,"Sub-basin 8"
2253,200,8,1500,1700,"Sub-basin 8"
2254,100,2,1600,1700,"Sub-basin 8"
2255,700,38,4000,4700,"Sub-basin 8"
2256,100,4,1000,1100,"Sub-basin 8"
2257,700,24,7800,8500,"Sub-basin 8"
2258,1600,402,3500,5100,"Sub-basin 8"
2259,500,46,5400,5900,"Sub-basin 8"
2260,900,158,6500,7400,"Sub-basin 8"
2261,100,6,2900,3000,"Sub-basin 8"
2262,200,8,5400,5600,"Sub-basin 8"
2263,100,1,1000,1100,"Sub-basin 8"
2264,2500,388.1225,5300,7800,"Sub-basin 8"
2265,700,55,1800,2500,"Sub-basin 8"
2266,100,1,2500,2600,"Sub-basin 8"
2267,100,2,2000,2100,"Sub-basin 8"
2268,500,33,5200,5700,"Sub-basin 8"
2269,1000,67,5000,6000,"Sub-basin 8"
2270,1100,88,11400,12500,"Sub-basin 8"
2271,300,4,3600,3900,"Sub-basin 8"
2272,2900,363,8800,11700,"Sub-basin 8"
2273,200,3.0098,4100,4300,"Sub-basin 8"
2274,800,210,1600,2400,"Sub-basin 8"
2275,24800,9927,18200,43000,"Sub-basin 8"
2276,1200,202,3400,4600,"Sub-basin 8"
2277,800,116,3800,4600,"Sub-basin 8"
2278,100,1,700,800,"Sub-basin 8"
2279,200,6,2300,2500,"Sub-basin 8"
2280,700,105,1900,2600,"Sub-basin 8"
2281,100,2,200,300,"Sub-basin 8"
2282,100,5,300,400,"Sub-basin 8"
2283,40200,15490,34800,75000,"Sub-basin 8"
2284,300,8,900,1200,"Sub-basin 8"
2285,100,13,1200,1300,"Sub-basin 8"
2286,400,21,6900,7300,"Sub-basin 8"
2287,100,4,800,900,"Sub-basin 8"
2288,1900,527,4600,6500,"Sub-basin 8"
2289,100,1,2500,2600,"Sub-basin 8"
2290,400,84,10700,11100,"Sub-basin 8"
2291,300,7,1400,1700,"Sub-basin 8"
2292,100,9,600,700,"Sub-basin 8"
2293,1500,336,3200,4700,"Sub-basin 8"
2294,400,19,1900,2300,"Sub-basin 8"
2295,100,1,1300,1400,"Sub-basin 8"
2296,500,23,2100,2600,"Sub-basin 8"
2297,300,22,700,1000,"Sub-basin 8"
2298,100,4,500,600,"Sub-basin 8"
2299,600,53,1600,2200,"Sub-basin 8"
2300,100,3,1100,1200,"Sub-basin 8"
2301,100,12,1700,1800,"Sub-basin 8"
2302,400,34,5300,5700,"Sub-basin 8"
2303,1800,695,6900,8700,"Sub-basin 8"
2304,100,1,1800,1900,"Sub-basin 8"
2305,17100,5685,31600,48700,"Sub-basin 8"
2306,100,1,300,400,"Sub-basin 8"
2307,1400,135,4200,5600,"Sub-basin 8"
2308,2500,475,16100,18600,"Sub-basin 8"
2309,1500,649,2200,3700,"Sub-basin 8"
2310,400,23,3000,3400,"Sub-basin 8"
2311,200,11,3600,3800,"Sub-basin 8"
2312,1600,518,3300,4900,"Sub-basin 8"
2313,300,37,1600,1900,"Sub-basin 8"
2314,800,289,3400,4200,"Sub-basin 8"
2315,600,130,3000,3600,"Sub-basin 8"
2316,47100,25965,33600,80700,"Sub-basin 8"
2317,2200,620,4400,6600,"Sub-basin 8"
2318,100,6,1600,1700,"Sub-basin 8"
2319,300,16,3200,3500,"Sub-basin 8"
2320,400,18,6100,6500,"Sub-basin 8"
2321,100,1,700,800,"Sub-basin 8"
2322,2200,836,2500,4700,"Sub-basin 8"
2323,300,38,1500,1800,"Sub-basin 8"
2324,1700,479,3900,5600,"Sub-basin 8"
2325,1600,285,7000,8600,"Sub-basin 8"
2326,1700,329,6800,8500,"Sub-basin 8"
2327,2100,450,7700,9800,"Sub-basin 8"
2328,200,3,1600,1800,"Sub-basin 8"
2329,900,195,2000,2900,"Sub-basin 8"
2330,7500,4219,12700,20200,"Sub-basin 8"
2331,500,38,3400,3900,"Sub-basin 8"
2332,100,1,1200,1300,"Sub-basin 8"
2333,100,1,900,1000,"Sub-basin 8"
2334,100,4,700,800,"Sub-basin 8"
2335,1000,192,3200,4200,"Sub-basin 8"
2336,200,9,600,800,"Sub-basin 8"
2337,400,18,2900,3300,"Sub-basin 8"
2338,100,1,3000,3100,"Sub-basin 8"
2339,500,31,3100,3600,"Sub-basin 8"
2340,16500,6425.83,13300,29800,"Sub-basin 8"
2341,400,17,6200,6600,"Sub-basin 8"
2342,100,2,1000,1100,"Sub-basin 8"
2343,300,4,7600,7900,"Sub-basin 8"
2344,400,14,1500,1900,"Sub-basin 8"
2345,900,90,2700,3600,"Sub-basin 8"
2346,1100,110,1900,3000,"Sub-basin 8"
2347,500,24,800,1300,"Sub-basin 8"
2348,9300,2652,10200,19500,"Sub-basin 8"
2349,400,13,1500,1900,"Sub-basin 8"
2350,2500,778,3700,6200,"Sub-basin 8"
2351,100,1,1900,2000,"Sub-basin 8"
2352,100,2,4100,4200,"Sub-basin 8"
2353,100,3,1100,1200,"Sub-basin 8"
2354,400,35,2400,2800,"Sub-basin 8"
2355,500,30,1600,2100,"Sub-basin 8"
2356,3100,256,7700,10800,"Sub-basin 8"
2357,100,1,500,600,"Sub-basin 8"
2358,9100,2647,36100,45200,"Sub-basin 8"
2359,1200,280,3600,4800,"Sub-basin 8"
2360,600,153,2700,3300,"Sub-basin 8"
2361,1100,554,2800,3900,"Sub-basin 8"
2362,100,3,1400,1500,"Sub-basin 8"
2363,400,21,3700,4100,"Sub-basin 8"
2364,100,2,2800,2900,"Sub-basin 8"
2365,400,24,2800,3200,"Sub-basin 8"
2366,200,15,1900,2100,"Sub-basin 8"
2367,300,25,600,900,"Sub-basin 8"
2368,3200,951,5900,9100,"Sub-basin 8"
2369,500,18,2700,3200,"Sub-basin 8"
2370,700,32,4100,4800,"Sub-basin 8"
2371,5000,2002,6300,11300,"Sub-basin 8"
2372,200,2,7200,7400,"Sub-basin 8"
2373,2800,667,6000,8800,"Sub-basin 8"
2374,100,6,1300,1400,"Sub-basin 8"
2375,700,37,6700,7400,"Sub-basin 8"
2376,400,14,4100,4500,"Sub-basin 8"
2377,6900,1269,39500,46400,"Sub-basin 8"
2378,1500,85,6900,8400,"Sub-basin 8"
2379,1200,211,2000,3200,"Sub-basin 8"
2380,1900,412,5200,7100,"Sub-basin 8"
2381,1200,58,4000,5200,"Sub-basin 8"
2382,100,1,800,900,"Sub-basin 8"
2383,100,7,1400,1500,"Sub-basin 8"
2384,1000,441,3900,4900,"Sub-basin 8"
2385,200,10,2600,2800,"Sub-basin 8"
2386,100,1,1400,1500,"Sub-basin 8"
2387,1000,86,12600,13600,"Sub-basin 8"
2388,400,29,900,1300,"Sub-basin 8"
2389,10200,4145,16300,26500,"Sub-basin 8"
2390,200,3,1300,1500,"Sub-basin 8"
2391,600,36,2200,2800,"Sub-basin 8"
2392,3000,668,7400,10400,"Sub-basin 8"
2393,300,23,700,1000,"Sub-basin 8"
2394,700,53,5300,6000,"Sub-basin 8"
2395,30400,16800,31200,61600,"Sub-basin 8"
2396,100,2,1000,1100,"Sub-basin 8"
2397,200,3,1200,1400,"Sub-basin 8"
2398,2200,728,3400,5600,"Sub-basin 8"
2399,200,2,1100,1300,"Sub-basin 8"
2400,100,5,1200,1300,"Sub-basin 8"
2401,200,20,900,1100,"Sub-basin 8"
2402,2900,878,7000,9900,"Sub-basin 8"
2403,100,2,600,700,"Sub-basin 8"
2404,100,1,1300,1400,"Sub-basin 8"
2405,2400,771,3600,6000,"Sub-basin 8"
2406,400,19,1700,2100,"Sub-basin 8"
2407,500,52,7800,8300,"Sub-basin 8"
2408,400,9,6100,6500,"Sub-basin 8"
2409,300,10,5400,5700,"Sub-basin 8"
2410,1200,73,3300,4500,"Sub-basin 8"
2411,400,85,400,800,"Sub-basin 8"
2412,9900,3169,16900,26800,"Sub-basin 8"
2413,900,50,10000,10900,"Sub-basin 8"
2414,4500,2210,7900,12400,"Sub-basin 8"
2415,1100,54,9100,10200,"Sub-basin 8"
2416,100,4,2100,2200,"Sub-basin 8"
2417,400,22,600,1000,"Sub-basin 8"
2418,500,16,9000,9500,"Sub-basin 8"
2419,100,1,2000,2100,"Sub-basin 8"
2420,100,2,3200,3300,"Sub-basin 8"
2421,1600,127,18100,19700,"Sub-basin 8"
2422,1200,41,4000,5200,"Sub-basin 8"
2423,200,19,700,900,"Sub-basin 8"
2424,100,1,400,500,"Sub-basin 8"
2425,800,56,6600,7400,"Sub-basin 8"
2426,300,15,5000,5300,"Sub-basin 8"
2427,3300,1023,8800,12100,"Sub-basin 8"
2428,200,5,600,800,"Sub-basin 8"
2429,4500,1429,5200,9700,"Sub-basin 8"
2430,4200,1594,8100,12300,"Sub-basin 8"
2431,400,77,1000,1400,"Sub-basin 8"
2432,200,25,1100,1300,"Sub-basin 8"
2433,600,175,1100,1700,"Sub-basin 8"
2434,100,7,1400,1500,"Sub-basin 8"
2435,200,3,3500,3700,"Sub-basin 8"
2436,400,7,2400,2800,"Sub-basin 8"
2437,100,8,800,900,"Sub-basin 8"
2438,100,1,1800,1900,"Sub-basin 8"
2439,100,3,2300,2400,"Sub-basin 8"
2440,600,84,1600,2200,"Sub-basin 8"
2441,100,4,400,500,"Sub-basin 8"
2442,100,3,1200,1300,"Sub-basin 8"
2443,400,12,1500,1900,"Sub-basin 8"
2444,200,3,1000,1200,"Sub-basin 8"
2445,4100,641,25700,29800,"Sub-basin 8"
2446,400,19,1800,2200,"Sub-basin 8"
2447,100,27.0011,900,1000,"Sub-basin 8"
2448,100,2,1300,1400,"Sub-basin 8"
2449,100,2,2900,3000,"Sub-basin 8"
2450,400,19,1400,1800,"Sub-basin 8"
2451,200,4,1200,1400,"Sub-basin 8"
2452,300,10,5400,5700,"Sub-basin 8"
2453,100,2,2200,2300,"Sub-basin 8"
2454,2500,297,18900,21400,"Sub-basin 8"
2455,4500,658,11200,15700,"Sub-basin 8"
2456,100,4,2200,2300,"Sub-basin 8"
2457,200,11,4300,4500,"Sub-basin 8"
2458,38900,19094,29100,68000,"Sub-basin 8"
2459,200,4,1300,1500,"Sub-basin 8"
2460,1200,142,4600,5800,"Sub-basin 8"
2461,400,25,1200,1600,"Sub-basin 8"
2462,600,94,2100,2700,"Sub-basin 8"
2463,100,3,700,800,"Sub-basin 8"
2464,1900,221,13000,14900,"Sub-basin 8"
2465,200,6,1800,2000,"Sub-basin 8"
2466,400,13,2100,2500,"Sub-basin 8"
2467,3200,2289,8000,11200,"Sub-basin 8"
2468,1900,536,5800,7700,"Sub-basin 8"
2469,300,35,2000,2300,"Sub-basin 8"
2470,100,1,600,700,"Sub-basin 8"
2471,900,43,7200,8100,"Sub-basin 8"
2472,500,10,2300,2800,"Sub-basin 8"
2473,500,23,7200,7700,"Sub-basin 8"
2474,200,5,3100,3300,"Sub-basin 8"
2475,400,23,2200,2600,"Sub-basin 8"
2476,600,28,4400,5000,"Sub-basin 8"
2477,100,3,2700,2800,"Sub-basin 8"
2478,300,10,4200,4500,"Sub-basin 8"
2479,1700,194,6600,8300,"Sub-basin 8"
2480,100,3,600,700,"Sub-basin 8"
2481,200,5,5500,5700,"Sub-basin 8"
2482,300,23,6900,7200,"Sub-basin 8"
2483,700,47,5500,6200,"Sub-basin 8"
2484,200,7,1300,1500,"Sub-basin 8"
2485,800,62,1100,1900,"Sub-basin 8"
2486,300,6,5200,5500,"Sub-basin 8"
2487,600,35,7100,7700,"Sub-basin 8"
2488,100,8,2400,2500,"Sub-basin 8"
2489,6200,1496.266,13200,19400,"Sub-basin 8"
2490,1300,37,10100,11400,"Sub-basin 8"
2491,100,1,2800,2900,"Sub-basin 8"
2492,400,84,500,900,"Sub-basin 8"
2493,500,68,1100,1600,"Sub-basin 8"
2494,1800,97,14400,16200,"Sub-basin 8"
2495,100,1,1400,1500,"Sub-basin 8"
2496,100,2,1700,1800,"Sub-basin 8"
2497,100,4,600,700,"Sub-basin 8"
2498,1000,229,2000,3000,"Sub-basin 8"
2499,1400,185,3000,4400,"Sub-basin 8"
2500,100,4.0011,700,800,"Sub-basin 8"
2501,100,3,3700,3800,"Sub-basin 8"
2502,100,4,1600,1700,"Sub-basin 8"
2503,400,19,6800,7200,"Sub-basin 8"
2504,800,26,8200,9000,"Sub-basin 8"
2505,109200,52355.84,87300,196500,"Sub-basin 8"
2506,100,5,200,300,"Sub-basin 8"
2507,100,1,700,800,"Sub-basin 8"
2508,1200,344,3000,4200,"Sub-basin 8"
2509,800,134,1600,2400,"Sub-basin 8"
2510,400,55,2300,2700,"Sub-basin 8"
2511,700,47,2500,3200,"Sub-basin 8"
2512,3300,345,30300,33600,"Sub-basin 8"
2513,300,9,3600,3900,"Sub-basin 8"
2514,900,120,6100,7000,"Sub-basin 8"
2515,200,15,1000,1200,"Sub-basin 8"
2516,15200,8768.0728,14500,29700,"Sub-basin 8"
2517,100,2,500,600,"Sub-basin 8"
2518,300,4,3100,3400,"Sub-basin 8"
2519,100,1,900,1000,"Sub-basin 8"
2520,800,76,4300,5100,"Sub-basin 8"
2521,100,3,1800,1900,"Sub-basin 8"
2522,400,12,2600,3000,"Sub-basin 8"
2523,1900,717,3900,5800,"Sub-basin 8"
2524,200,3,2300,2500,"Sub-basin 8"
2525,100,1,800,900,"Sub-basin 8"
2526,600,49,9200,9800,"Sub-basin 8"
2527,100,3,900,1000,"Sub-basin 8"
2528,700,33,11700,12400,"Sub-basin 8"
2529,200,4,4200,4400,"Sub-basin 8"
2530,500,40,5800,6300,"Sub-basin 8"
2531,400,15,1100,1500,"Sub-basin 8"
2532,34900,18894.51,33700,68600,"Sub-basin 8"
2533,400,13,1700,2100,"Sub-basin 8"
2534,5500,1569,11200,16700,"Sub-basin 8"
2535,200,4,4300,4500,"Sub-basin 8"
2536,200,3,1800,2000,"Sub-basin 8"
2537,500,23,1700,2200,"Sub-basin 8"
2538,500,21,2700,3200,"Sub-basin 8"
2539,400,10,5300,5700,"Sub-basin 8"
2540,100,1,1900,2000,"Sub-basin 8"
2541,100,1,1100,1200,"Sub-basin 8"
2542,500,30,2200,2700,"Sub-basin 8"
2543,100,3,700,800,"Sub-basin 8"
2544,800,101,4400,5200,"Sub-basin 8"
2545,1100,84,4200,5300,"Sub-basin 8"
2546,3200,406,14300,17500,"Sub-basin 8"
2547,100,4,200,300,"Sub-basin 8"
2548,200,8,800,1000,"Sub-basin 8"
2549,100,3,2600,2700,"Sub-basin 8"
2550,400,7,9000,9400,"Sub-basin 8"
2551,100,5,800,900,"Sub-basin 8"
2552,400,11,1900,2300,"Sub-basin 8"
2553,200,5,3100,3300,"Sub-basin 8"
2554,1500,86,4900,6400,"Sub-basin 8"
2555,200,4.0029,1200,1400,"Sub-basin 8"
2556,900,81,6100,7000,"Sub-basin 8"
2557,200,5,3200,3400,"Sub-basin 8"
2558,100,3,1300,1400,"Sub-basin 8"
2559,100,5,900,1000,"Sub-basin 8"
2560,100,2,2000,2100,"Sub-basin 8"
2561,500,13,6600,7100,"Sub-basin 8"
2562,2000,631,4500,6500,"Sub-basin 8"
2563,300,6,3700,4000,"Sub-basin 8"
2564,800,216,1800,2600,"Sub-basin 8"
2565,8700,1724.67,63400,72100,"Sub-basin 8"
2566,500,24,1800,2300,"Sub-basin 8"
2567,800,36,1600,2400,"Sub-basin 8"
2568,100,2,1600,1700,"Sub-basin 8"
2569,900,77,5100,6000,"Sub-basin 8"
2570,400,14,1900,2300,"Sub-basin 8"
2571,4900,1032,7300,12200,"Sub-basin 8"
2572,400,73,1100,1500,"Sub-basin 8"
2573,100,1,1000,1100,"Sub-basin 8"
2574,900,33,5100,6000,"Sub-basin 8"
2575,3900,1732,8700,12600,"Sub-basin 8"
2576,200,2,3500,3700,"Sub-basin 8"
2577,17200,3651.7616,26000,43200,"Sub-basin 8"
2578,900,292,1600,2500,"Sub-basin 8"
2579,500,49,4200,4700,"Sub-basin 8"
2580,100,2,1100,1200,"Sub-basin 8"
2581,100,2,300,400,"Sub-basin 8"
2582,3300,301,13100,16400,"Sub-basin 8"
2583,12100,5379,15400,27500,"Sub-basin 8"
2584,200,7,900,1100,"Sub-basin 8"
2585,200,6,1700,1900,"Sub-basin 8"
2586,200,11,2100,2300,"Sub-basin 8"
2587,600,30,3800,4400,"Sub-basin 8"
2588,300,7,5100,5400,"Sub-basin 8"
2589,100,2,1400,1500,"Sub-basin 8"
2590,4900,1009.83,25100,30000,"Sub-basin 8"
2591,100,5,800,900,"Sub-basin 8"
2592,100,4,1000,1100,"Sub-basin 8"
2593,100,3,300,400,"Sub-basin 8"
2594,14600,8006,20600,35200,"Sub-basin 8"
2595,200,5.0062,2600,2800,"Sub-basin 8"
2596,600,43,6500,7100,"Sub-basin 8"
2597,700,55,5000,5700,"Sub-basin 8"
2598,7700,2410,13600,21300,"Sub-basin 8"
2599,2000,501,6700,8700,"Sub-basin 8"
2600,200,2,400,600,"Sub-basin 8"
2601,100,1,800,900,"Sub-basin 8"
2602,1000,135,3800,4800,"Sub-basin 8"
2603,200,2,3800,4000,"Sub-basin 8"
2604,700,48,4100,4800,"Sub-basin 8"
2605,400,11,8200,8600,"Sub-basin 8"
2606,100,1.0031,2000,2100,"Sub-basin 8"
2607,7400,1806,13700,21100,"Sub-basin 8"
2608,100,2,300,400,"Sub-basin 8"
2609,300,8,2600,2900,"Sub-basin 8"
2610,2200,643,7900,10100,"Sub-basin 8"
2611,100,11,1900,2000,"Sub-basin 8"
2612,700,55,4800,5500,"Sub-basin 8"
2613,700,107,1500,2200,"Sub-basin 8"
2614,100,2,1000,1100,"Sub-basin 8"
2615,200,15,2600,2800,"Sub-basin 8"
2616,300,7,3800,4100,"Sub-basin 8"
2617,3100,1254,5700,8800,"Sub-basin 8"
2618,300,31,1500,1800,"Sub-basin 8"
2619,400,12,6400,6800,"Sub-basin 8"
2620,1600,204,7200,8800,"Sub-basin 8"
2621,500,45.0155,7500,8000,"Sub-basin 8"
2622,600,61,3500,4100,"Sub-basin 8"
2623,200,13,700,900,"Sub-basin 8"
2624,100,2,200,300,"Sub-basin 8"
2625,100,1,1100,1200,"Sub-basin 8"
2626,100,1,2300,2400,"Sub-basin 8"
2627,100,4,1000,1100,"Sub-basin 8"
2628,100,1,1100,1200,"Sub-basin 8"
2629,15400,9490.99,15700,31100,"Sub-basin 8"
2630,1200,77,10800,12000,"Sub-basin 8"
2631,2800,475.83,12600,15400,"Sub-basin 8"
2632,400,21,6200,6600,"Sub-basin 8"
2633,100,5,1400,1500,"Sub-basin 8"
2634,500,12,1500,2000,"Sub-basin 8"
2635,1700,61,12200,13900,"Sub-basin 8"
2636,100,1,1600,1700,"Sub-basin 8"
2637,200,3,700,900,"Sub-basin 8"
2638,400,16,1000,1400,"Sub-basin 8"
2639,200,24,2100,2300,"Sub-basin 8"
2640,400,19,6000,6400,"Sub-basin 8"
2641,200,14,400,600,"Sub-basin 8"
2642,100,1,700,800,"Sub-basin 8"
2643,800,90,2700,3500,"Sub-basin 8"
2644,2700,974.84,6800,9500,"Sub-basin 8"
2645,400,28,4200,4600,"Sub-basin 8"
2646,700,117.66,3200,3900,"Sub-basin 8"
2647,200,15,3900,4100,"Sub-basin 8"
2648,1000,139.83,4100,5100,"Sub-basin 8"
2649,1700,422.84,3800,5500,"Sub-basin 8"
2650,300,26,1600,1900,"Sub-basin 8"
2651,2400,287.17,9800,12200,"Sub-basin 8"
2652,500,74,1100,1600,"Sub-basin 8"
2653,300,7,4200,4500,"Sub-basin 8"
2654,100,1,1200,1300,"Sub-basin 8"
2655,800,106,6100,6900,"Sub-basin 8"
2656,600,80,2100,2700,"Sub-basin 8"
2657,3500,1103,6200,9700,"Sub-basin 8"
2658,100,2,2800,2900,"Sub-basin 8"
2659,200,6,3600,3800,"Sub-basin 8"
2660,100,2,1000,1100,"Sub-basin 8"
2661,200,13,1400,1600,"Sub-basin 8"
2662,1000,61,5800,6800,"Sub-basin 8"
2663,700,71,2800,3500,"Sub-basin 8"
2664,200,5,1600,1800,"Sub-basin 8"
2665,100,4,1100,1200,"Sub-basin 8"
2666,700,305,1900,2600,"Sub-basin 8"
2667,1200,290,2600,3800,"Sub-basin 8"
2668,200,5,2100,2300,"Sub-basin 8"
2669,500,60,3200,3700,"Sub-basin 8"
2670,6700,1293,26600,33300,"Sub-basin 8"
2671,200,10,1500,1700,"Sub-basin 8"
2672,1800,230,6500,8300,"Sub-basin 8"
2673,2800,566,11400,14200,"Sub-basin 8"
2674,600,137,3300,3900,"Sub-basin 8"
2675,100,1,600,700,"Sub-basin 8"
2676,200,2,1700,1900,"Sub-basin 8"
2677,500,25,1600,2100,"Sub-basin 8"
2678,300,14,1300,1600,"Sub-basin 8"
2679,4200,1542,11100,15300,"Sub-basin 8"
2680,5000,1888,9900,14900,"Sub-basin 8"
2681,100,3,700,800,"Sub-basin 8"
2682,1800,666,3400,5200,"Sub-basin 8"
2683,400,19,4400,4800,"Sub-basin 8"
2684,900,71,3600,4500,"Sub-basin 8"
2685,1800,141,8000,9800,"Sub-basin 8"
2686,200,13,1900,2100,"Sub-basin 8"
2687,100,8,900,1000,"Sub-basin 8"
2688,400,26,4300,4700,"Sub-basin 8"
2689,100,3,1500,1600,"Sub-basin 8"
2690,1200,505,2200,3400,"Sub-basin 8"
2691,200,6,700,900,"Sub-basin 8"
2692,900,196,2000,2900,"Sub-basin 8"
2693,5600,1824,8900,14500,"Sub-basin 8"
2694,8800,3052,21400,30200,"Sub-basin 8"
2695,6900,3060,11100,18000,"Sub-basin 8"
2696,2300,575,6600,8900,"Sub-basin 8"
2697,3200,343,23700,26900,"Sub-basin 8"
2698,1600,254,5800,7400,"Sub-basin 8"
2699,15800,7421.01,17800,33600,"Sub-basin 8"
2700,500,40,9000,9500,"Sub-basin 8"
2701,600,67,4500,5100,"Sub-basin 8"
2702,600,36,2300,2900,"Sub-basin 8"
2703,1200,176,4800,6000,"Sub-basin 8"
2704,200,6,1000,1200,"Sub-basin 8"
2705,4200,410,18500,22700,"Sub-basin 8"
2706,2600,1174,12800,15400,"Sub-basin 8"
2707,5600,2151,17100,22700,"Sub-basin 8"
2708,100,1,800,900,"Sub-basin 8"
2709,400,18,2800,3200,"Sub-basin 8"
2710,800,185,3300,4100,"Sub-basin 8"
2711,300,30,2000,2300,"Sub-basin 8"
2712,3300,935,9300,12600,"Sub-basin 8"
2713,100,1,1300,1400,"Sub-basin 8"
2714,200,14,400,600,"Sub-basin 8"
2715,200,8,1100,1300,"Sub-basin 8"
2716,600,23,4500,5100,"Sub-basin 8"
2717,100,8,600,700,"Sub-basin 8"
2718,800,110,2100,2900,"Sub-basin 8"
2719,1600,155,3800,5400,"Sub-basin 8"
2720,1800,300,5500,7300,"Sub-basin 8"
2721,2100,1327,3600,5700,"Sub-basin 8"
2722,3100,571,6700,9800,"Sub-basin 8"
2723,1600,355,2900,4500,"Sub-basin 8"
2724,3100,249,14500,17600,"Sub-basin 8"
2725,300,9,1800,2100,"Sub-basin 8"
2726,100,11,500,600,"Sub-basin 8"
2727,1700,449,5900,7600,"Sub-basin 8"
2728,300,18,3500,3800,"Sub-basin 8"
2729,500,31,1500,2000,"Sub-basin 8"
2730,4300,656,11400,15700,"Sub-basin 8"
2731,200,2,5200,5400,"Sub-basin 8"
2732,300,6,1100,1400,"Sub-basin 8"
2733,1100,189,4500,5600,"Sub-basin 8"
2734,100,2,700,800,"Sub-basin 8"
2735,400,9,2000,2400,"Sub-basin 8"
2736,200,10,2000,2200,"Sub-basin 8"
2737,600,59,800,1400,"Sub-basin 8"
2738,300,18,1700,2000,"Sub-basin 8"
2739,200,5,5600,5800,"Sub-basin 8"
2740,800,74,6400,7200,"Sub-basin 8"
2741,2600,268,7300,9900,"Sub-basin 8"
2742,100,6,500,600,"Sub-basin 8"
2743,1900,302,5900,7800,"Sub-basin 8"
2744,100,7,1100,1200,"Sub-basin 8"
2745,100,1,1200,1300,"Sub-basin 8"
2746,600,163,1700,2300,"Sub-basin 8"
2747,300,5,1900,2200,"Sub-basin 8"
2748,200,2,5300,5500,"Sub-basin 8"
2749,100,6,900,1000,"Sub-basin 8"
2750,800,40,2600,3400,"Sub-basin 8"
2751,1900,119,7000,8900,"Sub-basin 8"
2752,700,44,5300,6000,"Sub-basin 8"
2753,500,95,3100,3600,"Sub-basin 8"
2754,600,268,800,1400,"Sub-basin 8"
2755,1500,174,6000,7500,"Sub-basin 8"
2756,1800,76,9100,10900,"Sub-basin 8"
2757,2100,190,9700,11800,"Sub-basin 8"
2758,13600,4409,30600,44200,"Sub-basin 8"
2759,400,9,3100,3500,"Sub-basin 8"
2760,200,2,7400,7600,"Sub-basin 8"
2761,200,3,3800,4000,"Sub-basin 8"
2762,200,15.0012,2200,2400,"Sub-basin 8"
2763,100,1,2200,2300,"Sub-basin 8"
2764,400,18,2800,3200,"Sub-basin 8"
2765,8400,1710,19900,28300,"Sub-basin 8"
2766,1600,372,5300,6900,"Sub-basin 8"
2767,100,1,400,500,"Sub-basin 8"
2768,1600,99,13100,14700,"Sub-basin 8"
2769,1200,154,7900,9100,"Sub-basin 8"
2770,2800,310,5700,8500,"Sub-basin 8"
2771,1900,733,8100,10000,"Sub-basin 8"
2772,200,3,2800,3000,"Sub-basin 8"
2773,2900,352,10700,13600,"Sub-basin 8"
2774,5300,800,13500,18800,"Sub-basin 8"
2775,300,15,4600,4900,"Sub-basin 8"
2776,700,73,2900,3600,"Sub-basin 8"
2777,200,5,2400,2600,"Sub-basin 8"
2778,300,23,1800,2100,"Sub-basin 8"
2779,200,12,2200,2400,"Sub-basin 8"
2780,1500,95,13100,14600,"Sub-basin 8"
2781,2000,243,5000,7000,"Sub-basin 8"
2782,1100,52,11200,12300,"Sub-basin 8"
2783,700,31,6100,6800,"Sub-basin 8"
2784,1100,84,7400,8500,"Sub-basin 8"
2785,600,36,8800,9400,"Sub-basin 8"
2786,800,103,5200,6000,"Sub-basin 8"
2787,1100,47,11900,13000,"Sub-basin 8"
2788,400,18,4200,4600,"Sub-basin 8"
2789,1100,126,5500,6600,"Sub-basin 8"
2790,7900,1569,32900,40800,"Sub-basin 8"
2791,200,5,3100,3300,"Sub-basin 8"
2792,800,62,10100,10900,"Sub-basin 8"
2793,100,1,1400,1500,"Sub-basin 8"
2794,300,13.0048,3100,3400,"Sub-basin 8"
2795,100,1,400,500,"Sub-basin 8"
2796,300,15,2200,2500,"Sub-basin 8"
2797,10300,2021,52800,63100,"Sub-basin 8"
2798,100,1,1600,1700,"Sub-basin 8"
2799,1400,112,6400,7800,"Sub-basin 8"
2800,200,5,2600,2800,"Sub-basin 8"
2801,700,117,5000,5700,"Sub-basin 8"
2802,600,41,3400,4000,"Sub-basin 8"
2803,500,38,2100,2600,"Sub-basin 8"
2804,100,1,2900,3000,"Sub-basin 8"
2805,1500,163,6600,8100,"Sub-basin 8"
2806,400,18,2600,3000,"Sub-basin 8"
2807,200,6,2900,3100,"Sub-basin 8"
2808,200,2,1100,1300,"Sub-basin 8"
2809,800,118,2800,3600,"Sub-basin 8"
2810,200,13,3500,3700,"Sub-basin 8"
2811,100,1,1700,1800,"Sub-basin 8"
2812,2100,272.0364,9500,11600,"Sub-basin 8"
2813,300,11,2100,2400,"Sub-basin 8"
2814,600,28,3900,4500,"Sub-basin 8"
2815,100,4,1400,1500,"Sub-basin 8"
2816,300,6,3200,3500,"Sub-basin 8"
2817,100,1,2900,3000,"Sub-basin 8"
2818,6900,598,46000,52900,"Sub-basin 8"
2819,100,2,2200,2300,"Sub-basin 8"
2820,1400,153,9300,10700,"Sub-basin 8"
2821,400,14,1600,2000,"Sub-basin 8"
2822,600,21,3000,3600,"Sub-basin 8"
2823,200,6,2300,2500,"Sub-basin 8"
2824,1500,356,11500,13000,"Sub-basin 8"
2825,100,1,300,400,"Sub-basin 8"
2826,600,80,3700,4300,"Sub-basin 8"
2827,1700,195,4000,5700,"Sub-basin 8"
2828,200,8,1800,2000,"Sub-basin 8"
2829,100,1,1200,1300,"Sub-basin 8"
2830,700,17,6500,7200,"Sub-basin 8"
2831,1900,126,19300,21200,"Sub-basin 8"
2832,100,1,1700,1800,"Sub-basin 8"
2833,200,7,1500,1700,"Sub-basin 8"
2834,100,2,1600,1700,"Sub-basin 8"
2835,100,1,2600,2700,"Sub-basin 8"
2836,1100,155,4300,5400,"Sub-basin 8"
2837,500,33,2600,3100,"Sub-basin 8"
2838,100,1,1700,1800,"Sub-basin 8"
2839,11500,1395,58400,69900,"Sub-basin 8"
2840,2600,147,9200,11800,"Sub-basin 8"
2841,300,16,4000,4300,"Sub-basin 8"
2842,200,3,3200,3400,"Sub-basin 8"
2843,200,5,1700,1900,"Sub-basin 8"
2844,1900,286,6700,8600,"Sub-basin 8"
2845,100,1,1000,1100,"Sub-basin 8"
2846,300,9,3000,3300,"Sub-basin 8"
2847,600,101,1600,2200,"Sub-basin 8"
2848,400,6,3000,3400,"Sub-basin 8"
2849,6700,891,23700,30400,"Sub-basin 8"
2850,300,21,3400,3700,"Sub-basin 8"
2851,100,2,2200,2300,"Sub-basin 8"
2852,2300,350,12900,15200,"Sub-basin 8"
2853,200,8,1900,2100,"Sub-basin 8"
2854,300,13,1800,2100,"Sub-basin 8"
2855,1600,87,24500,26100,"Sub-basin 8"
2856,100,1,2400,2500,"Sub-basin 8"
2857,100,4,1200,1300,"Sub-basin 8"
2858,300,15,1400,1700,"Sub-basin 8"
2859,1800,328,4400,6200,"Sub-basin 8"
2860,200,4,2700,2900,"Sub-basin 8"
2861,100,3,0,100,"Sub-basin 8"
2862,1800,145,6600,8400,"Sub-basin 8"
2863,300,7,4300,4600,"Sub-basin 8"
2864,100,3,1700,1800,"Sub-basin 8"
2865,100,1,1900,2000,"Sub-basin 8"
2866,2300,210,4700,7000,"Sub-basin 8"
2867,500,15,5000,5500,"Sub-basin 8"
2868,100,1,800,900,"Sub-basin 8"
2869,14200,4651,26000,40200,"Sub-basin 8"
2870,1300,402,9600,10900,"Sub-basin 8"
2871,200,6,1200,1400,"Sub-basin 8"
2872,700,14,5100,5800,"Sub-basin 8"
2873,200,12,1500,1700,"Sub-basin 8"
2874,200,5,1800,2000,"Sub-basin 8"
2875,200,6,2100,2300,"Sub-basin 8"
2876,100,1,800,900,"Sub-basin 8"
2877,5400,2010,15600,21000,"Sub-basin 8"
2878,200,4,2400,2600,"Sub-basin 8"
2879,100,4,1700,1800,"Sub-basin 8"
2880,100,3,1500,1600,"Sub-basin 8"
2881,100,3,1000,1100,"Sub-basin 8"
2882,100,1,800,900,"Sub-basin 8"
2883,100,1,2800,2900,"Sub-basin 8"
2884,200,7,1400,1600,"Sub-basin 8"
2885,100,1,1300,1400,"Sub-basin 8"
2886,3200,553,10300,13500,"Sub-basin 8"
2887,100,1,700,800,"Sub-basin 8"
2888,100,3,1000,1100,"Sub-basin 8"
2889,300,18,1800,2100,"Sub-basin 8"
2890,200,5.0032,3200,3400,"Sub-basin 8"
2891,900,100,2700,3600,"Sub-basin 8"
2892,11800,3288,28200,40000,"Sub-basin 8"
2893,100,1,1100,1200,"Sub-basin 8"
2894,1400,121,5300,6700,"Sub-basin 8"
2895,2700,211,16400,19100,"Sub-basin 8"
2896,1700,65,15700,17400,"Sub-basin 8"
2897,600,27,4400,5000,"Sub-basin 8"
2898,4000,503,32900,36900,"Sub-basin 8"
2899,400,39,4800,5200,"Sub-basin 8"
2900,300,25,2000,2300,"Sub-basin 8"
2901,200,7,1400,1600,"Sub-basin 8"
2902,100,1,1500,1600,"Sub-basin 8"
2903,2300,206,10900,13200,"Sub-basin 8"
2904,100,3,2700,2800,"Sub-basin 8"
2905,600,59,7000,7600,"Sub-basin 8"
2906,500,23,4100,4600,"Sub-basin 8"
2907,300,11.0044,3100,3400,"Sub-basin 8"
2908,300,31,1200,1500,"Sub-basin 8"
2909,200,27,2900,3100,"Sub-basin 8"
2910,100,2,1000,1100,"Sub-basin 8"
2911,400,37,3600,4000,"Sub-basin 8"
2912,500,35,4100,4600,"Sub-basin 8"
2913,100,2,1000,1100,"Sub-basin 8"
2914,100,5,1600,1700,"Sub-basin 8"
2915,100,3,1200,1300,"Sub-basin 8"
2916,2200,138,13200,15400,"Sub-basin 8"
2917,200,7,1800,2000,"Sub-basin 8"
2918,700,20,6600,7300,"Sub-basin 8"
2919,200,2,1500,1700,"Sub-basin 8"
2920,100,2,100,200,"Sub-basin 8"
2921,200,2,3200,3400,"Sub-basin 8"
2922,1200,80,12600,13800,"Sub-basin 8"
2923,700,64,2200,2900,"Sub-basin 8"
2924,1000,183,8000,9000,"Sub-basin 8"
2925,100,2,400,500,"Sub-basin 8"
2926,200,26,4400,4600,"Sub-basin 8"
2927,1100,148,10500,11600,"Sub-basin 8"
2928,2200,421,8800,11000,"Sub-basin 8"
2929,400,25,4400,4800,"Sub-basin 8"
2930,300,10,4900,5200,"Sub-basin 8"
2931,2100,131,17600,19700,"Sub-basin 8"
2932,1200,201,4000,5200,"Sub-basin 8"
2933,200,5,1600,1800,"Sub-basin 8"
2934,100,1,2400,2500,"Sub-basin 8"
2935,1200,182,10000,11200,"Sub-basin 8"
2936,400,13,2600,3000,"Sub-basin 8"
2937,5700,1294,11200,16900,"Sub-basin 8"
2938,200,15,1400,1600,"Sub-basin 8"
2939,200,18,6100,6300,"Sub-basin 8"
2940,100,2,2800,2900,"Sub-basin 8"
2941,400,25,4900,5300,"Sub-basin 8"
2942,300,18,3300,3600,"Sub-basin 8"
2943,400,9,2800,3200,"Sub-basin 8"
2944,900,35,10300,11200,"Sub-basin 8"
2945,300,3,3700,4000,"Sub-basin 8"
2946,100,3,1000,1100,"Sub-basin 8"
2947,100,3,700,800,"Sub-basin 8"
2948,1800,197,6200,8000,"Sub-basin 8"
2949,100,3,900,1000,"Sub-basin 8"
2950,1400,58,5700,7100,"Sub-basin 8"
2951,400,16,2300,2700,"Sub-basin 8"
2952,700,37,6000,6700,"Sub-basin 8"
2953,800,43,3900,4700,"Sub-basin 8"
2954,900,85,1100,2000,"Sub-basin 8"
2955,2100,181,17500,19600,"Sub-basin 8"
2956,900,52,6100,7000,"Sub-basin 8"
2957,300,20,6500,6800,"Sub-basin 8"
2958,1700,402,5900,7600,"Sub-basin 8"
2959,100,2,900,1000,"Sub-basin 8"
2960,900,41,4300,5200,"Sub-basin 8"
2961,200,6,800,1000,"Sub-basin 8"
2962,100,2,700,800,"Sub-basin 8"
2963,100,1,1400,1500,"Sub-basin 8"
2964,100,2,1900,2000,"Sub-basin 8"
2965,500,20,8800,9300,"Sub-basin 8"
2966,500,23,7900,8400,"Sub-basin 8"
2967,400,107,2400,2800,"Sub-basin 8"
2968,9400,3779,19000,28400,"Sub-basin 8"
2969,600,78,1400,2000,"Sub-basin 8"
2970,2300,491,5400,7700,"Sub-basin 8"
2971,500,33,5000,5500,"Sub-basin 8"
2972,100,1,700,800,"Sub-basin 8"
2973,600,31,4900,5500,"Sub-basin 8"
2974,500,28,3500,4000,"Sub-basin 8"
2975,600,147,3000,3600,"Sub-basin 8"
2976,600,22,5600,6200,"Sub-basin 8"
2977,200,3,1700,1900,"Sub-basin 8"
2978,1200,221,3300,4500,"Sub-basin 8"
2979,100,1,1200,1300,"Sub-basin 8"
2980,400,5,3300,3700,"Sub-basin 8"
2981,3500,648,5400,8900,"Sub-basin 8"
2982,500,8,5800,6300,"Sub-basin 8"
2983,100,1,2300,2400,"Sub-basin 8"
2984,200,5,3400,3600,"Sub-basin 8"
2985,3600,1584,10100,13700,"Sub-basin 8"
2986,600,41,7300,7900,"Sub-basin 8"
2987,300,18,1600,1900,"Sub-basin 8"
2988,200,2,2200,2400,"Sub-basin 8"
2989,100,1,2000,2100,"Sub-basin 8"
2990,100,1,2500,2600,"Sub-basin 8"
2991,1700,89,12000,13700,"Sub-basin 8"
2992,100,1,600,700,"Sub-basin 8"
2993,2800,534,4200,7000,"Sub-basin 8"
2994,100,1,1800,1900,"Sub-basin 8"
2995,400,18,2300,2700,"Sub-basin 8"
2996,800,32,6900,7700,"Sub-basin 8"
2997,100,3,1300,1400,"Sub-basin 8"
2998,200,5,1300,1500,"Sub-basin 8"
2999,300,9,2200,2500,"Sub-basin 8"
3000,300,7,3200,3500,"Sub-basin 8"
3001,800,44,6200,7000,"Sub-basin 8"
3002,900,112,3500,4400,"Sub-basin 8"
3003,200,12,1200,1400,"Sub-basin 8"
3004,400,28,3900,4300,"Sub-basin 8"
3005,100,3,1000,1100,"Sub-basin 8"
3006,200,4,700,900,"Sub-basin 8"
3007,800,107,2300,3100,"Sub-basin 8"
3008,300,5,3100,3400,"Sub-basin 8"
3009,100,2,1300,1400,"Sub-basin 8"
3010,300,21,2500,2800,"Sub-basin 8"
3011,100,2,1100,1200,"Sub-basin 8"
3012,3100,928,6200,9300,"Sub-basin 8"
3013,100,1,2100,2200,"Sub-basin 8"
3014,200,12,1200,1400,"Sub-basin 8"
3015,1200,75,2000,3200,"Sub-basin 8"
3016,2000,126,5900,7900,"Sub-basin 8"
3017,400,35,1100,1500,"Sub-basin 8"
3018,100,2,700,800,"Sub-basin 8"
3019,100,1,1200,1300,"Sub-basin 8"
3020,1700,418,2400,4100,"Sub-basin 8"
3021,800,131,2000,2800,"Sub-basin 8"
3022,100,5,700,800,"Sub-basin 8"
3023,100,1,1000,1100,"Sub-basin 8"
3024,700,36,9100,9800,"Sub-basin 8"
3025,1300,130,6600,7900,"Sub-basin 8"
3026,13300,3491.7542,15700,29000,"Sub-basin 8"
3027,1300,149,13800,15100,"Sub-basin 8"
3028,100,2,1100,1200,"Sub-basin 8"
3029,3500,308,13900,17400,"Sub-basin 8"
3030,1300,369,2200,3500,"Sub-basin 8"
3031,400,21,1500,1900,"Sub-basin 8"
3032,200,4,1800,2000,"Sub-basin 8"
3033,600,45,5100,5700,"Sub-basin 8"
3034,400,23,3400,3800,"Sub-basin 8"
3035,19200,4521,86200,105400,"Sub-basin 8"
3036,500,13,6500,7000,"Sub-basin 8"
3037,500,30,6500,7000,"Sub-basin 8"
3038,900,49,5600,6500,"Sub-basin 8"
3039,2200,338,3200,5400,"Sub-basin 8"
3040,300,19,1400,1700,"Sub-basin 8"
3041,1000,152,2600,3600,"Sub-basin 8"
3042,400,19,2200,2600,"Sub-basin 8"
3043,900,96,5200,6100,"Sub-basin 8"
3044,2600,664,5600,8200,"Sub-basin 8"
3045,1200,234,2700,3900,"Sub-basin 8"
3046,400,9,1900,2300,"Sub-basin 8"
3047,100,3,1300,1400,"Sub-basin 8"
3048,100,1,600,700,"Sub-basin 8"
3049,200,2,2300,2500,"Sub-basin 8"
3050,100,1,2600,2700,"Sub-basin 8"
3051,200,4,400,600,"Sub-basin 8"
3052,200,6,1000,1200,"Sub-basin 8"
3053,400,12,4800,5200,"Sub-basin 8"
3054,400,53,900,1300,"Sub-basin 8"
3055,300,8,5000,5300,"Sub-basin 8"
3056,700,46,3600,4300,"Sub-basin 8"
3057,100,1,1200,1300,"Sub-basin 8"
3058,500,41,1700,2200,"Sub-basin 8"
3059,200,5,1200,1400,"Sub-basin 8"
3060,100,2,3100,3200,"Sub-basin 8"
3061,100,2,1100,1200,"Sub-basin 8"
3062,1900,365,4200,6100,"Sub-basin 8"
3063,100,2,600,700,"Sub-basin 8"
3064,600,116,1600,2200,"Sub-basin 8"
3065,500,82,2800,3300,"Sub-basin 8"
3066,100,2,2700,2800,"Sub-basin 8"
3067,11700,1688,68100,79800,"Sub-basin 8"
3068,100,3,1500,1600,"Sub-basin 8"
3069,200,2,800,1000,"Sub-basin 8"
3070,100,5,500,600,"Sub-basin 8"
3071,200,9,1400,1600,"Sub-basin 8"
3072,200,6,3100,3300,"Sub-basin 8"
3073,200,6,2800,3000,"Sub-basin 8"
3074,600,72,1000,1600,"Sub-basin 8"
3075,300,18,2800,3100,"Sub-basin 8"
3076,100,1,1200,1300,"Sub-basin 8"
3077,300,13,4900,5200,"Sub-basin 8"
3078,1500,207,3800,5300,"Sub-basin 8"
3079,21900,4527,97100,119000,"Sub-basin 8"
3080,100,1,1000,1100,"Sub-basin 8"
3081,500,22,3500,4000,"Sub-basin 8"
3082,200,7,2700,2900,"Sub-basin 8"
3083,700,54,3400,4100,"Sub-basin 8"
3084,100,1,1500,1600,"Sub-basin 8"
3085,100,1,2100,2200,"Sub-basin 8"
3086,400,39,6000,6400,"Sub-basin 8"
3087,400,38,1600,2000,"Sub-basin 8"
3088,1300,438,2900,4200,"Sub-basin 8"
3089,1200,198,5500,6700,"Sub-basin 8"
3090,400,24,2000,2400,"Sub-basin 8"
3091,400,42,2300,2700,"Sub-basin 8"
3092,1800,274,9200,11000,"Sub-basin 8"
3093,1400,125,7000,8400,"Sub-basin 8"
3094,6800,1261,29500,36300,"Sub-basin 8"
3095,100,3,500,600,"Sub-basin 8"
3096,600,27,2000,2600,"Sub-basin 8"
3097,200,8,2600,2800,"Sub-basin 8"
3098,100,4,1700,1800,"Sub-basin 8"
3099,200,9,4000,4200,"Sub-basin 8"
3100,3800,793,7000,10800,"Sub-basin 8"
3101,800,225,1800,2600,"Sub-basin 8"
3102,1800,323,6300,8100,"Sub-basin 8"
3103,5700,1864,17200,22900,"Sub-basin 8"
3104,100,2,1500,1600,"Sub-basin 8"
3105,2000,242,6300,8300,"Sub-basin 8"
3106,600,57,2600,3200,"Sub-basin 8"
3107,200,8,3500,3700,"Sub-basin 8"
3108,400,15,2900,3300,"Sub-basin 8"
3109,700,23,6800,7500,"Sub-basin 8"
3110,500,46,2600,3100,"Sub-basin 8"
3111,100,9,1400,1500,"Sub-basin 8"
3112,500,30,3400,3900,"Sub-basin 8"
3113,200,6,2000,2200,"Sub-basin 8"
3114,600,29,2900,3500,"Sub-basin 8"
3115,500,19,2600,3100,"Sub-basin 8"
3116,200,8,1900,2100,"Sub-basin 8"
3117,300,23,3600,3900,"Sub-basin 8"
3118,1800,178,9400,11200,"Sub-basin 8"
3119,600,148,2300,2900,"Sub-basin 8"
3120,1100,288,2500,3600,"Sub-basin 8"
3121,400,62,2000,2400,"Sub-basin 8"
3122,400,32,1500,1900,"Sub-basin 8"
3123,900,95,4700,5600,"Sub-basin 8"
3124,400,18,7000,7400,"Sub-basin 8"
3125,800,25,7700,8500,"Sub-basin 8"
3126,1100,87,3600,4700,"Sub-basin 8"
3127,200,2,2200,2400,"Sub-basin 8"
3128,100,1,1900,2000,"Sub-basin 8"
3129,800,65,2100,2900,"Sub-basin 8"
3130,200,6,2100,2300,"Sub-basin 8"
3131,200,2,2300,2500,"Sub-basin 8"
3132,100,3,1100,1200,"Sub-basin 8"
3133,100,5,1000,1100,"Sub-basin 8"
3134,200,6,2700,2900,"Sub-basin 8"
3135,100,1,1900,2000,"Sub-basin 8"
3136,2000,726,5400,7400,"Sub-basin 8"
3137,8000,659,9600,17600,"Sub-basin 8"
3138,100,2,1200,1300,"Sub-basin 8"
3139,2600,1246,2700,5300,"Sub-basin 8"
3140,800,55,4700,5500,"Sub-basin 8"
3141,400,54,1800,2200,"Sub-basin 8"
3142,900,135,3800,4700,"Sub-basin 8"
3143,100,4,200,300,"Sub-basin 8"
3144,1600,91,15300,16900,"Sub-basin 8"
3145,500,12,10200,10700,"Sub-basin 8"
3146,600,17,3900,4500,"Sub-basin 8"
3147,100,1,1600,1700,"Sub-basin 8"
3148,1300,208,3800,5100,"Sub-basin 8"
3149,300,11,2900,3200,"Sub-basin 8"
3150,100,1,500,600,"Sub-basin 8"
3151,100,1,500,600,"Sub-basin 8"
3152,2300,372,4400,6700,"Sub-basin 8"
3153,200,8,1700,1900,"Sub-basin 8"
3154,100,1,2200,2300,"Sub-basin 8"
3155,100,6,2000,2100,"Sub-basin 8"
3156,300,9,4500,4800,"Sub-basin 8"
3157,200,3,3000,3200,"Sub-basin 8"
3158,500,30,3200,3700,"Sub-basin 8"
3159,800,99,5500,6300,"Sub-basin 8"
3160,400,29,2100,2500,"Sub-basin 8"
3161,400,16,5000,5400,"Sub-basin 8"
3162,200,6,300,500,"Sub-basin 8"
3163,900,33,12000,12900,"Sub-basin 8"
3164,200,15,1800,2000,"Sub-basin 8"
3165,400,19,3200,3600,"Sub-basin 8"
3166,1000,75,5500,6500,"Sub-basin 8"
3167,800,26,3300,4100,"Sub-basin 8"
3168,3600,575,13700,17300,"Sub-basin 8"
3169,100,1,1400,1500,"Sub-basin 8"
3170,19700,3226,91100,110800,"Sub-basin 8"
3171,400,123,2600,3000,"Sub-basin 8"
3172,100,1,1300,1400,"Sub-basin 8"
3173,200,6,1900,2100,"Sub-basin 8"
3174,300,13,4000,4300,"Sub-basin 8"
3175,200,9,3100,3300,"Sub-basin 8"
3176,1000,157,4800,5800,"Sub-basin 8"
3177,3100,241,6000,9100,"Sub-basin 8"
3178,1400,85,12900,14300,"Sub-basin 8"
3179,600,75,7800,8400,"Sub-basin 8"
3180,100,3,1300,1400,"Sub-basin 8"
3181,100,2,2200,2300,"Sub-basin 8"
3182,100,3,1600,1700,"Sub-basin 8"
3183,1400,158,5500,6900,"Sub-basin 8"
3184,1300,104,6900,8200,"Sub-basin 8"
3185,500,14,3800,4300,"Sub-basin 8"
3186,100,1,1600,1700,"Sub-basin 8"
3187,1100,435,5500,6600,"Sub-basin 8"
3188,100,1,2100,2200,"Sub-basin 8"
3189,100,8,1100,1200,"Sub-basin 8"
3190,1500,578,5000,6500,"Sub-basin 8"
3191,4000,1426,6400,10400,"Sub-basin 8"
3192,1900,334,5000,6900,"Sub-basin 8"
3193,600,34,4600,5200,"Sub-basin 8"
3194,400,21,2600,3000,"Sub-basin 8"
3195,100,1,1300,1400,"Sub-basin 8"
3196,900,316,3100,4000,"Sub-basin 8"
3197,200,4,1900,2100,"Sub-basin 8"
3198,100,3,800,900,"Sub-basin 8"
3199,100,3,2400,2500,"Sub-basin 8"
3200,4900,1147,5900,10800,"Sub-basin 8"
3201,6800,879.66,22400,29200,"Sub-basin 8"
3202,600,91,4000,4600,"Sub-basin 8"
3203,600,17,2100,2700,"Sub-basin 8"
3204,1100,75,4100,5200,"Sub-basin 8"
3205,1400,229,1500,2900,"Sub-basin 8"
3206,100,1,1300,1400,"Sub-basin 8"
3207,300,4,4400,4700,"Sub-basin 8"
3208,500,14,3600,4100,"Sub-basin 8"
3209,200,2,500,700,"Sub-basin 8"
3210,100,1,1400,1500,"Sub-basin 8"
3211,100,1,2100,2200,"Sub-basin 8"
3212,900,84,7400,8300,"Sub-basin 8"
3213,800,45,4700,5500,"Sub-basin 8"
3214,500,68,2600,3100,"Sub-basin 8"
3215,3000,1275,12600,15600,"Sub-basin 8"
3216,700,59,4400,5100,"Sub-basin 8"
3217,1500,151,7500,9000,"Sub-basin 8"
3218,300,10,1900,2200,"Sub-basin 8"
3219,100,2,600,700,"Sub-basin 8"
3220,800,41,3900,4700,"Sub-basin 8"
3221,1600,377,16500,18100,"Sub-basin 8"
3222,400,39,2300,2700,"Sub-basin 8"
3223,10700,1466.34,38600,49300,"Sub-basin 8"
3224,400,54,3900,4300,"Sub-basin 8"
3225,100,1,1800,1900,"Sub-basin 8"
3226,600,108,1300,1900,"Sub-basin 8"
3227,200,5,1500,1700,"Sub-basin 8"
3228,100,1,1400,1500,"Sub-basin 8"
3229,100,1,1300,1400,"Sub-basin 8"
3230,100,3,1300,1400,"Sub-basin 8"
3231,2400,272,21900,24300,"Sub-basin 8"
3232,100,1,1100,1200,"Sub-basin 8"
3233,1200,247,6400,7600,"Sub-basin 8"
3234,200,5,3400,3600,"Sub-basin 8"
3235,200,3,2600,2800,"Sub-basin 8"
3236,900,98,3600,4500,"Sub-basin 8"
3237,300,4,5800,6100,"Sub-basin 8"
3238,200,17,1400,1600,"Sub-basin 8"
3239,100,1,700,800,"Sub-basin 8"
3240,200,9,300,500,"Sub-basin 8"
3241,700,22,3200,3900,"Sub-basin 8"
3242,1100,255,1900,3000,"Sub-basin 8"
3243,100,1,400,500,"Sub-basin 8"
3244,100,2,1600,1700,"Sub-basin 8"
3245,200,12,1700,1900,"Sub-basin 8"
3246,400,21,2700,3100,"Sub-basin 8"
3247,100,2,2000,2100,"Sub-basin 8"
3248,2500,478,6200,8700,"Sub-basin 8"
3249,400,11,2100,2500,"Sub-basin 8"
3250,700,26,4600,5300,"Sub-basin 8"
3251,900,36,6300,7200,"Sub-basin 8"
3252,400,16,2500,2900,"Sub-basin 8"
3253,200,13,3900,4100,"Sub-basin 8"
3254,100,6,1800,1900,"Sub-basin 8"
3255,100,1,2000,2100,"Sub-basin 8"
3256,100,3,2100,2200,"Sub-basin 8"
3257,300,9,2600,2900,"Sub-basin 8"
3258,300,11,3100,3400,"Sub-basin 8"
3259,3900,958,9400,13300,"Sub-basin 8"
3260,200,7,1200,1400,"Sub-basin 8"
3261,200,12,700,900,"Sub-basin 8"
3262,10400,1990,30100,40500,"Sub-basin 8"
3263,1300,112,21200,22500,"Sub-basin 8"
3264,600,16,6000,6600,"Sub-basin 8"
3265,200,16,900,1100,"Sub-basin 8"
3266,300,6,2600,2900,"Sub-basin 8"
3267,200,10,2300,2500,"Sub-basin 8"
3268,100,1,1700,1800,"Sub-basin 8"
3269,100,1,500,600,"Sub-basin 8"
3270,100,2,1400,1500,"Sub-basin 8"
3271,400,15,2400,2800,"Sub-basin 8"
3272,3600,485,9500,13100,"Sub-basin 8"
3273,100,3,1500,1600,"Sub-basin 8"
3274,700,28,6500,7200,"Sub-basin 8"
3275,500,18,6100,6600,"Sub-basin 8"
3276,200,4,1800,2000,"Sub-basin 8"
3277,1100,64,4600,5700,"Sub-basin 8"
3278,2300,297,6200,8500,"Sub-basin 8"
3279,1100,184.83,5400,6500,"Sub-basin 8"
3280,400,30,3700,4100,"Sub-basin 8"
3281,300,7,800,1100,"Sub-basin 8"
3282,100,2,1400,1500,"Sub-basin 8"
3283,200,5,700,900,"Sub-basin 8"
3284,100,6,1000,1100,"Sub-basin 8"
3285,300,7,4100,4400,"Sub-basin 8"
3286,700,77,4400,5100,"Sub-basin 8"
3287,600,40,6600,7200,"Sub-basin 8"
3288,2100,192.49,9700,11800,"Sub-basin 8"
3289,100,2,1300,1400,"Sub-basin 8"
3290,100,2,300,400,"Sub-basin 8"
3291,500,83,2300,2800,"Sub-basin 8"
3292,100,2,700,800,"Sub-basin 8"
3293,400,9,3600,4000,"Sub-basin 8"
3294,200,6,1500,1700,"Sub-basin 8"
3295,200,4,3000,3200,"Sub-basin 8"
3296,800,50,5800,6600,"Sub-basin 8"
3297,2200,599,12900,15100,"Sub-basin 8"
3298,100,4,1800,1900,"Sub-basin 8"
3299,200,2,3100,3300,"Sub-basin 8"
3300,800,106.99,2500,3300,"Sub-basin 8"
3301,600,51,2200,2800,"Sub-basin 8"
3302,300,19.17,2300,2600,"Sub-basin 8"
3303,100,1,1400,1500,"Sub-basin 8"
3304,200,5,3300,3500,"Sub-basin 8"
3305,500,54.17,7000,7500,"Sub-basin 8"
3306,1000,125.3,3200,4200,"Sub-basin 8"
3307,700,65,14100,14800,"Sub-basin 8"
3308,2500,335.17,10500,13000,"Sub-basin 8"
3309,200,8,500,700,"Sub-basin 8"
3310,500,21,2900,3400,"Sub-basin 8"
3311,600,101,3500,4100,"Sub-basin 8"
3312,300,9,2700,3000,"Sub-basin 8"
3313,200,3,2800,3000,"Sub-basin 8"
3314,2400,405,9700,12100,"Sub-basin 8"
3315,600,37,6500,7100,"Sub-basin 8"
3316,900,152,2500,3400,"Sub-basin 8"
3317,700,59,2900,3600,"Sub-basin 8"
3318,8800,3318,19200,28000,"Sub-basin 8"
3319,400,21,1600,2000,"Sub-basin 8"
3320,100,3,1800,1900,"Sub-basin 8"
3321,100,3,1500,1600,"Sub-basin 8"
3322,12400,3474,118600,131000,"Sub-basin 8"
3323,500,32,4100,4600,"Sub-basin 8"
3324,100,6,1400,1500,"Sub-basin 8"
3325,200,8,2200,2400,"Sub-basin 8"
3326,100,1,700,800,"Sub-basin 8"
3327,2000,149,8300,10300,"Sub-basin 8"
3328,100,4,1100,1200,"Sub-basin 8"
3329,100,3,700,800,"Sub-basin 8"
3330,500,31,6900,7400,"Sub-basin 8"
3331,200,13,800,1000,"Sub-basin 8"
3332,200,28,1100,1300,"Sub-basin 8"
3333,600,92,4400,5000,"Sub-basin 8"
3334,4600,656.17,24100,28700,"Sub-basin 8"
3335,100,2,1600,1700,"Sub-basin 8"
3336,900,186,3900,4800,"Sub-basin 8"
3337,1700,181,10300,12000,"Sub-basin 8"
3338,500,18,9300,9800,"Sub-basin 8"
3339,700,38,4100,4800,"Sub-basin 8"
3340,2700,215,10100,12800,"Sub-basin 8"
3341,100,1,2300,2400,"Sub-basin 8"
3342,200,4,2000,2200,"Sub-basin 8"
3343,1000,63,9200,10200,"Sub-basin 8"
3344,100,3,3300,3400,"Sub-basin 8"
3345,100,1,1200,1300,"Sub-basin 8"
3346,200,8,1800,2000,"Sub-basin 8"
3347,400,38,1800,2200,"Sub-basin 8"
3348,6200,1779,13900,20100,"Sub-basin 8"
3349,100,1,100,200,"Sub-basin 8"
3350,100,3,500,600,"Sub-basin 8"
3351,200,7,2600,2800,"Sub-basin 8"
3352,200,17,2200,2400,"Sub-basin 8"
3353,300,11,3400,3700,"Sub-basin 8"
3354,600,39,4900,5500,"Sub-basin 8"
3355,1600,122,9600,11200,"Sub-basin 8"
3356,100,2,2900,3000,"Sub-basin 8"
3357,100,3,1500,1600,"Sub-basin 8"
3358,2700,362,16300,19000,"Sub-basin 8"
3359,200,2,1700,1900,"Sub-basin 8"
3360,1500,123.0852,2700,4200,"Sub-basin 8"
3361,100,13,1500,1600,"Sub-basin 8"
3362,200,7,1200,1400,"Sub-basin 8"
3363,1600,758,4500,6100,"Sub-basin 8"
3364,100,9,100,200,"Sub-basin 8"
3365,400,21,3100,3500,"Sub-basin 8"
3366,100,2,2200,2300,"Sub-basin 8"
3367,400,17,3100,3500,"Sub-basin 8"
3368,200,7,100,300,"Sub-basin 8"
3369,1100,104,2700,3800,"Sub-basin 8"
3370,1800,88,6100,7900,"Sub-basin 8"
3371,2100,163,15300,17400,"Sub-basin 8"
3372,300,20,2400,2700,"Sub-basin 8"
3373,200,8,1600,1800,"Sub-basin 8"
3374,100,3,1400,1500,"Sub-basin 8"
3375,400,20,3400,3800,"Sub-basin 8"
3376,2200,157,7400,9600,"Sub-basin 8"
3377,200,7,1800,2000,"Sub-basin 8"
3378,1000,171,6200,7200,"Sub-basin 8"
3379,500,16,4300,4800,"Sub-basin 8"
3380,200,4,3100,3300,"Sub-basin 8"
3381,200,13,2800,3000,"Sub-basin 8"
3382,300,11,3200,3500,"Sub-basin 8"
3383,200,8,2900,3100,"Sub-basin 8"
3384,600,16,3700,4300,"Sub-basin 8"
3385,1300,99,9900,11200,"Sub-basin 8"
3386,300,15,2800,3100,"Sub-basin 8"
3387,400,23,5100,5500,"Sub-basin 8"
3388,400,15,5500,5900,"Sub-basin 8"
3389,300,10,4600,4900,"Sub-basin 8"
3390,400,27,3000,3400,"Sub-basin 8"
3391,500,13,2800,3300,"Sub-basin 8"
3392,900,207,3700,4600,"Sub-basin 8"
3393,1100,217,3100,4200,"Sub-basin 8"
3394,600,34,4600,5200,"Sub-basin 8"
3395,1200,229,4800,6000,"Sub-basin 8"
3396,200,8,3200,3400,"Sub-basin 8"
3397,100,1,1000,1100,"Sub-basin 8"
3398,700,71,4100,4800,"Sub-basin 8"
3399,4100,1332,16200,20300,"Sub-basin 8"
3400,100,8,1400,1500,"Sub-basin 8"
3401,1000,74,4500,5500,"Sub-basin 8"
3402,1900,122,9700,11600,"Sub-basin 8"
3403,800,41,7900,8700,"Sub-basin 8"
3404,100,1,1900,2000,"Sub-basin 8"
3405,3600,415,27100,30700,"Sub-basin 8"
3406,500,90,2000,2500,"Sub-basin 8"
3407,100,1,1100,1200,"Sub-basin 8"
3408,100,2,2500,2600,"Sub-basin 8"
3409,2800,544,12800,15600,"Sub-basin 8"
3410,2800,290,11500,14300,"Sub-basin 8"
3411,500,15,4200,4700,"Sub-basin 8"
3412,1300,103,10400,11700,"Sub-basin 8"
3413,600,73,5100,5700,"Sub-basin 8"
3414,800,74,7000,7800,"Sub-basin 8"
3415,200,6,3600,3800,"Sub-basin 8"
3416,100,2,700,800,"Sub-basin 8"
3417,500,27,4600,5100,"Sub-basin 8"
3418,800,43,5500,6300,"Sub-basin 8"
3419,300,4,2900,3200,"Sub-basin 8"
3420,900,89,6900,7800,"Sub-basin 8"
3421,500,18,5300,5800,"Sub-basin 8"
3422,100,2,800,900,"Sub-basin 8"
3423,1400,230,1700,3100,"Sub-basin 8"
3424,300,8,1700,2000,"Sub-basin 8"
3425,1200,90,7300,8500,"Sub-basin 8"
3426,100,6,1000,1100,"Sub-basin 8"
3427,1900,602,8200,10100,"Sub-basin 8"
3428,200,13,1400,1600,"Sub-basin 8"
3429,600,36,7600,8200,"Sub-basin 8"
3430,200,4,900,1100,"Sub-basin 8"
3431,200,7,1900,2100,"Sub-basin 8"
3432,1000,137,7300,8300,"Sub-basin 8"
3433,100,1,1200,1300,"Sub-basin 8"
3434,600,37,2400,3000,"Sub-basin 8"
3435,300,9,3600,3900,"Sub-basin 8"
3436,100,2,1000,1100,"Sub-basin 8"
3437,300,7,3300,3600,"Sub-basin 8"
3438,300,31,2600,2900,"Sub-basin 8"
3439,1000,74,3500,4500,"Sub-basin 8"
3440,2700,463,7100,9800,"Sub-basin 8"
3441,300,10,2600,2900,"Sub-basin 8"
3442,600,81,6200,6800,"Sub-basin 8"
3443,200,3,2500,2700,"Sub-basin 8"
3444,100,3,1200,1300,"Sub-basin 8"
3445,200,10,2000,2200,"Sub-basin 8"
3446,100,3,2700,2800,"Sub-basin 8"
3447,100,4,1300,1400,"Sub-basin 8"
3448,300,87,300,600,"Sub-basin 8"
3449,100,1,700,800,"Sub-basin 8"
3450,100,3,1500,1600,"Sub-basin 8"
3451,600,31,2200,2800,"Sub-basin 8"
3452,100,3,1700,1800,"Sub-basin 8"
3453,600,32,7800,8400,"Sub-basin 8"
3454,2600,299.0814,5700,8300,"Sub-basin 8"
3455,100,2,1100,1200,"Sub-basin 8"
3456,2100,249,17600,19700,"Sub-basin 8"
3457,200,7,2400,2600,"Sub-basin 8"
3458,300,9,3100,3400,"Sub-basin 8"
3459,100,2,900,1000,"Sub-basin 8"
3460,1300,167,3600,4900,"Sub-basin 8"
3461,800,31,6400,7200,"Sub-basin 8"
3462,400,44,2000,2400,"Sub-basin 8"
3463,100,2,1200,1300,"Sub-basin 8"
3464,300,7,2500,2800,"Sub-basin 8"
3465,1400,98,7000,8400,"Sub-basin 8"
3466,600,45,5500,6100,"Sub-basin 8"
3467,200,8,3000,3200,"Sub-basin 8"
3468,100,1,1000,1100,"Sub-basin 8"
3469,1800,166,16800,18600,"Sub-basin 8"
3470,1500,62,11800,13300,"Sub-basin 8"
3471,1100,110,3800,4900,"Sub-basin 8"
3472,2200,78,14000,16200,"Sub-basin 8"
3473,200,6,4600,4800,"Sub-basin 8"
3474,600,39,3700,4300,"Sub-basin 8"
3475,500,16,5600,6100,"Sub-basin 8"
3476,900,65,7900,8800,"Sub-basin 8"
3477,300,18,3000,3300,"Sub-basin 8"
3478,100,1,1900,2000,"Sub-basin 8"
3479,200,9,700,900,"Sub-basin 8"
3480,1500,72,11200,12700,"Sub-basin 8"
3481,600,41,10400,11000,"Sub-basin 8"
3482,200,11,1900,2100,"Sub-basin 8"
3483,100,1,1000,1100,"Sub-basin 8"
3484,600,24,3500,4100,"Sub-basin 8"
3485,200,4,2800,3000,"Sub-basin 8"
3486,100,1,1300,1400,"Sub-basin 8"
3487,100,2,1600,1700,"Sub-basin 8"
3488,500,40,4600,5100,"Sub-basin 8"
3489,600,75,3600,4200,"Sub-basin 8"
3490,700,21,3600,4300,"Sub-basin 8"
3491,4700,580,14600,19300,"Sub-basin 8"
3492,600,27,4200,4800,"Sub-basin 8"
3493,500,39,1300,1800,"Sub-basin 8"
3494,300,12,3400,3700,"Sub-basin 8"
3495,1000,116,7700,8700,"Sub-basin 8"
3496,600,29,900,1500,"Sub-basin 8"
3497,100,2,600,700,"Sub-basin 8"
3498,600,51,4100,4700,"Sub-basin 8"
3499,200,3,3600,3800,"Sub-basin 8"
3500,300,13,3100,3400,"Sub-basin 8"
3501,500,16,700,1200,"Sub-basin 8"
3502,200,2,2400,2600,"Sub-basin 8"
3503,200,3,2200,2400,"Sub-basin 8"
3504,1000,102,10100,11100,"Sub-basin 8"
3505,100,3,3900,4000,"Sub-basin 8"
3506,200,7,1700,1900,"Sub-basin 8"
3507,200,9,1400,1600,"Sub-basin 8"
3508,200,11,2500,2700,"Sub-basin 8"
3509,4200,463,21700,25900,"Sub-basin 8"
3510,200,4,4100,4300,"Sub-basin 8"
3511,600,17.33,3400,4000,"Sub-basin 8"
3512,700,54,2500,3200,"Sub-basin 8"
3513,100,2,1300,1400,"Sub-basin 8"
3514,600,56,4800,5400,"Sub-basin 8"
3515,200,9,3400,3600,"Sub-basin 8"
3516,100,3,2100,2200,"Sub-basin 8"
3517,400,16,2700,3100,"Sub-basin 8"
3518,400,14,3800,4200,"Sub-basin 8"
3519,200,6,1600,1800,"Sub-basin 8"
3520,200,29,1600,1800,"Sub-basin 8"
3521,100,1,800,900,"Sub-basin 8"
3522,900,90,6200,7100,"Sub-basin 8"
3523,800,49,8900,9700,"Sub-basin 8"
3524,100,3,1400,1500,"Sub-basin 8"
3525,200,3,2600,2800,"Sub-basin 8"
3526,100,3.0119,700,800,"Sub-basin 8"
3527,600,43,2300,2900,"Sub-basin 8"
3528,500,65,2200,2700,"Sub-basin 8"
3529,700,84,3800,4500,"Sub-basin 8"
3530,500,41,5100,5600,"Sub-basin 8"
3531,300,10,3300,3600,"Sub-basin 8"
3532,5100,1125.2825,6600,11700,"Sub-basin 8"
3533,1600,145,6400,8000,"Sub-basin 8"
3534,800,153,3200,4000,"Sub-basin 8"
3535,700,76,6100,6800,"Sub-basin 8"
3536,400,23,6900,7300,"Sub-basin 8"
3537,200,10,1400,1600,"Sub-basin 8"
3538,200,12,1900,2100,"Sub-basin 8"
3539,200,4,2000,2200,"Sub-basin 8"
3540,200,5,1500,1700,"Sub-basin 8"
3541,500,476.0885,2800,3300,"Sub-basin 8"
3542,100,2,300,400,"Sub-basin 8"
3543,100,2,2600,2700,"Sub-basin 8"
3544,400,45,8200,8600,"Sub-basin 8"
3545,400,18,3500,3900,"Sub-basin 8"
3546,400,20,4500,4900,"Sub-basin 8"
3547,200,7,3800,4000,"Sub-basin 8"
3548,100,3,3300,3400,"Sub-basin 8"
3549,300,9,4600,4900,"Sub-basin 8"
3550,5400,1375,18900,24300,"Sub-basin 8"
3551,500,22,2000,2500,"Sub-basin 8"
3552,400,15,4700,5100,"Sub-basin 8"
3553,1500,1095,10400,11900,"Sub-basin 8"
3554,1000,123,5300,6300,"Sub-basin 8"
3555,100,3,2400,2500,"Sub-basin 8"
3556,200,22,2300,2500,"Sub-basin 8"
3557,2000,262,13800,15800,"Sub-basin 8"
3558,200,16,1400,1600,"Sub-basin 8"
3559,200,2,1900,2100,"Sub-basin 8"
3560,1000,60,7000,8000,"Sub-basin 8"
3561,200,7,2000,2200,"Sub-basin 8"
3562,100,1,2000,2100,"Sub-basin 8"
3563,100,3,2400,2500,"Sub-basin 8"
3564,500,13,4500,5000,"Sub-basin 8"
3565,400,47,4600,5000,"Sub-basin 8"
3566,100,1,1800,1900,"Sub-basin 8"
3567,100,2,2000,2100,"Sub-basin 8"
3568,100,1,2600,2700,"Sub-basin 8"
3569,300,24,2600,2900,"Sub-basin 8"
3570,400,31,6500,6900,"Sub-basin 8"
3571,100,4,2100,2200,"Sub-basin 8"
3572,1900,208,9400,11300,"Sub-basin 8"
3573,600,16,6900,7500,"Sub-basin 8"
3574,400,27,3600,4000,"Sub-basin 8"
3575,100,3,3700,3800,"Sub-basin 8"
3576,200,64,6000,6200,"Sub-basin 8"
3577,1000,104,9800,10800,"Sub-basin 8"
3578,100,5,1500,1600,"Sub-basin 8"
3579,100,5,1800,1900,"Sub-basin 8"
3580,1000,113,13700,14700,"Sub-basin 8"
3581,100,2,1100,1200,"Sub-basin 8"
3582,600,22,4300,4900,"Sub-basin 8"
3583,300,16,3000,3300,"Sub-basin 8"
3584,200,8,1700,1900,"Sub-basin 8"
3585,1700,195,9700,11400,"Sub-basin 8"
3586,300,4,1800,2100,"Sub-basin 8"
3587,300,13,4800,5100,"Sub-basin 8"
3588,400,22,3100,3500,"Sub-basin 8"
3589,200,20,5000,5200,"Sub-basin 8"
3590,200,5,2200,2400,"Sub-basin 8"
3591,200,4,3900,4100,"Sub-basin 8"
3592,200,6,1000,1200,"Sub-basin 8"
3593,600,20,4400,5000,"Sub-basin 8"
3594,200,6,3100,3300,"Sub-basin 8"
3595,200,3,2000,2200,"Sub-basin 8"
3596,300,7,2600,2900,"Sub-basin 8"
3597,500,32,6000,6500,"Sub-basin 8"
3598,100,2,1300,1400,"Sub-basin 8"
3599,600,21,3300,3900,"Sub-basin 8"
3600,300,13,2500,2800,"Sub-basin 8"
3601,500,37,2800,3300,"Sub-basin 8"
3602,100,4,1300,1400,"Sub-basin 8"
3603,7000,3468,8800,15800,"Sub-basin 8"
3604,100,3,1500,1600,"Sub-basin 8"
3605,1100,49,12000,13100,"Sub-basin 8"
3606,200,3,4500,4700,"Sub-basin 8"
3607,100,1,1200,1300,"Sub-basin 8"
3608,500,26,12300,12800,"Sub-basin 8"
3609,100,2,1400,1500,"Sub-basin 8"
3610,100,3,4500,4600,"Sub-basin 8"
3611,200,3,6200,6400,"Sub-basin 8"
3612,300,7,5600,5900,"Sub-basin 8"
3613,300,12,4200,4500,"Sub-basin 8"
3614,400,28,4100,4500,"Sub-basin 8"
3615,800,60,6200,7000,"Sub-basin 8"
3616,200,5,3200,3400,"Sub-basin 8"
3617,500,10,17800,18300,"Sub-basin 8"
3618,200,11,3700,3900,"Sub-basin 8"
3619,200,4,2600,2800,"Sub-basin 8"
3620,100,2,2000,2100,"Sub-basin 8"
3621,100,3,1900,2000,"Sub-basin 8"
3622,500,19,6100,6600,"Sub-basin 8"
3623,200,8,2900,3100,"Sub-basin 8"
3624,500,20,4600,5100,"Sub-basin 8"
3625,800,24,20000,20800,"Sub-basin 8"
3626,100,1,2000,2100,"Sub-basin 8"
3627,100,4,1600,1700,"Sub-basin 8"
3628,200,2,6000,6200,"Sub-basin 8"
3629,200,3,5900,6100,"Sub-basin 8"
3630,300,10,6300,6600,"Sub-basin 8"
3631,1300,78,39200,40500,"Sub-basin 8"
3632,100,1,4100,4200,"Sub-basin 8"
3633,100,1,5100,5200,"Sub-basin 8"
3634,100,1,4300,4400,"Sub-basin 8"
3635,1100,47,21600,22700,"Sub-basin 8"
3636,200,7,2000,2200,"Sub-basin 8"
3637,4500,339,30500,35000,"Sub-basin 8"
3638,2800,1020.0741,9000,11800,"Sub-basin 8"
3639,600,53,4600,5200,"Sub-basin 8"
3640,100,1,3600,3700,"Sub-basin 8"
3641,200,3,1600,1800,"Sub-basin 8"
3642,200,9,11100,11300,"Sub-basin 8"
3643,100,4,4000,4100,"Sub-basin 8"
3644,600,43,6200,6800,"Sub-basin 8"
3645,400,14,3000,3400,"Sub-basin 8"
3646,300,16,3300,3600,"Sub-basin 8"
3647,400,40,15500,15900,"Sub-basin 8"
3648,100,1,300,400,"Sub-basin 8"
3649,100,1,1300,1400,"Sub-basin 8"
3650,100,3,1200,1300,"Sub-basin 8"
3651,900,108,9600,10500,"Sub-basin 8"
3652,200,16,2200,2400,"Sub-basin 8"
3653,400,18,5900,6300,"Sub-basin 8"
3654,800,223,6100,6900,"Sub-basin 8"
3655,100,2,5100,5200,"Sub-basin 8"
3656,900,113,9100,10000,"Sub-basin 8"
3657,400,14,6800,7200,"Sub-basin 8"
3658,7500,2094,14300,21800,"Sub-basin 8"
3659,1100,111,8300,9400,"Sub-basin 8"
3660,300,10,6200,6500,"Sub-basin 8"
3661,100,4,2000,2100,"Sub-basin 8"
3662,400,23,4500,4900,"Sub-basin 8"
3663,400,50,16900,17300,"Sub-basin 8"
3664,100,9,4900,5000,"Sub-basin 8"
3665,100,1,2700,2800,"Sub-basin 8"
3666,500,32,9400,9900,"Sub-basin 8"
3667,200,14,2000,2200,"Sub-basin 8"
3668,400,22,15100,15500,"Sub-basin 8"
3669,300,9,9500,9800,"Sub-basin 8"
3670,500,30,17400,17900,"Sub-basin 8"
3671,100,6,3000,3100,"Sub-basin 8"
3672,700,38,18400,19100,"Sub-basin 8"
3673,100,1,3800,3900,"Sub-basin 8"
3674,600,18,12500,13100,"Sub-basin 8"
3675,100,1,2900,3000,"Sub-basin 8"
3676,200,9,4600,4800,"Sub-basin 8"
3677,100,3,2400,2500,"Sub-basin 8"
3678,400,14,1400,1800,"Sub-basin 8"
3679,300,12,10400,10700,"Sub-basin 8"
3680,400,21,4500,4900,"Sub-basin 8"
3681,200,2,3000,3200,"Sub-basin 8"
3682,2300,222,13900,16200,"Sub-basin 8"
3683,100,3,2300,2400,"Sub-basin 8"
3684,100,4,1000,1100,"Sub-basin 8"
3685,100,2,1300,1400,"Sub-basin 8"
3686,600,24,8500,9100,"Sub-basin 8"
3687,100,3,2100,2200,"Sub-basin 8"
3688,200,10,3200,3400,"Sub-basin 8"
3689,100,1,5600,5700,"Sub-basin 8"
3690,900,94,6400,7300,"Sub-basin 8"
3691,600,31,6100,6700,"Sub-basin 8"
3692,500,29,8100,8600,"Sub-basin 8"
3693,400,12,3000,3400,"Sub-basin 8"
3694,900,98,8900,9800,"Sub-basin 8"
3695,200,3,1900,2100,"Sub-basin 8"
3696,10400,2270.5122,7800,18200,"Sub-basin 8"
3697,4900,603,72000,76900,"Sub-basin 8"
3698,1700,138,10600,12300,"Sub-basin 8"
3699,2200,260,10200,12400,"Sub-basin 8"
3700,200,8,6100,6300,"Sub-basin 8"
3701,400,30,2400,2800,"Sub-basin 8"
3702,100,2,1900,2000,"Sub-basin 8"
3703,500,18,3400,3900,"Sub-basin 8"
3704,100,1,2600,2700,"Sub-basin 8"
3705,1000,50,3300,4300,"Sub-basin 8"
3706,700,41,3400,4100,"Sub-basin 8"
3707,300,22,3100,3400,"Sub-basin 8"
3708,500,27,1400,1900,"Sub-basin 8"
3709,100,1,1800,1900,"Sub-basin 8"
3710,300,7,2300,2600,"Sub-basin 8"
3711,400,22,5100,5500,"Sub-basin 8"
3712,200,4,1400,1600,"Sub-basin 8"
3713,100,1,3800,3900,"Sub-basin 8"
3714,3300,316,31400,34700,"Sub-basin 8"
3715,4200,890,34800,39000,"Sub-basin 8"
3716,100,1,1900,2000,"Sub-basin 8"
3717,200,5,1900,2100,"Sub-basin 8"
3718,100,9,2900,3000,"Sub-basin 8"
3719,200,40,1200,1400,"Sub-basin 8"
3720,200,9,2200,2400,"Sub-basin 8"
3721,600,7,5100,5700,"Sub-basin 8"
3722,100,1,1000,1100,"Sub-basin 8"
3723,1800,71,25300,27100,"Sub-basin 8"
3724,300,17,5000,5300,"Sub-basin 8"
3725,1700,520,3600,5300,"Sub-basin 8"
3726,2500,725,20600,23100,"Sub-basin 8"
3727,500,28.34,6200,6700,"Sub-basin 8"
3728,800,22,9500,10300,"Sub-basin 8"
3729,600,26.5,9800,10400,"Sub-basin 8"
3730,600,19.67,6600,7200,"Sub-basin 8"
3731,3100,1278.5,16300,19400,"Sub-basin 8"
3732,12100,3848.67,34000,46100,"Sub-basin 8"
3733,300,10.51,3200,3500,"Sub-basin 8"
3734,400,14,5400,5800,"Sub-basin 8"
3735,400,11.32,2200,2600,"Sub-basin 8"
3736,600,32,6000,6600,"Sub-basin 8"
3737,500,26,4700,5200,"Sub-basin 8"
3738,500,18,5800,6300,"Sub-basin 8"
3739,400,33,5000,5400,"Sub-basin 8"
3740,200,3,4000,4200,"Sub-basin 8"
3741,500,37,6700,7200,"Sub-basin 8"
3742,500,33,8100,8600,"Sub-basin 8"
3743,800,28,9300,10100,"Sub-basin 8"
3744,800,39,16000,16800,"Sub-basin 8"
3745,600,46,15600,16200,"Sub-basin 8"
3746,600,64,4900,5500,"Sub-basin 8"
3747,100,4,800,900,"Sub-basin 8"
3748,400,21,4300,4700,"Sub-basin 8"
3749,100,3,1300,1400,"Sub-basin 8"
3750,100,2,3000,3100,"Sub-basin 8"
3751,1900,118,15500,17400,"Sub-basin 8"
3752,200,2,2400,2600,"Sub-basin 8"
3753,200,3,2800,3000,"Sub-basin 8"
3754,100,2,2100,2200,"Sub-basin 8"
3755,300,8,3500,3800,"Sub-basin 8"
3756,2200,198,5300,7500,"Sub-basin 8"
3757,200,5,2800,3000,"Sub-basin 8"
3758,800,42,8600,9400,"Sub-basin 8"
3759,400,29,9700,10100,"Sub-basin 8"
3760,100,1,2400,2500,"Sub-basin 8"
3761,200,4,2500,2700,"Sub-basin 8"
3762,100,1,800,900,"Sub-basin 8"
3763,1200,268,10100,11300,"Sub-basin 8"
3764,700,35,6900,7600,"Sub-basin 8"
3765,1300,291,4300,5600,"Sub-basin 8"
3766,200,7,2600,2800,"Sub-basin 8"
3767,200,7,6100,6300,"Sub-basin 8"
3768,900,137,9500,10400,"Sub-basin 8"
3769,200,6,4500,4700,"Sub-basin 8"
3770,200,5,8300,8500,"Sub-basin 8"
3771,100,1,1500,1600,"Sub-basin 8"
3772,300,14,4600,4900,"Sub-basin 8"
3773,200,3,3300,3500,"Sub-basin 8"
3774,200,4,3500,3700,"Sub-basin 8"
3775,500,41,17500,18000,"Sub-basin 8"
3776,2500,329,21100,23600,"Sub-basin 8"
3777,500,19,4700,5200,"Sub-basin 8"
3778,1200,145,4000,5200,"Sub-basin 8"
3779,100,1,1500,1600,"Sub-basin 8"
3780,1500,83,14300,15800,"Sub-basin 8"
3781,100,3,2900,3000,"Sub-basin 8"
3782,200,4,2600,2800,"Sub-basin 8"
3783,1000,72,2800,3800,"Sub-basin 8"
3784,100,1,1100,1200,"Sub-basin 8"
3785,500,33,5400,5900,"Sub-basin 8"
3786,500,19,8900,9400,"Sub-basin 8"
3787,800,52,5800,6600,"Sub-basin 8"
3788,400,13,1400,1800,"Sub-basin 8"
3789,600,66,15900,16500,"Sub-basin 8"
3790,100,1,1200,1300,"Sub-basin 8"
3791,600,25,13400,14000,"Sub-basin 8"
3792,1000,144,2400,3400,"Sub-basin 8"
3793,200,2,2100,2300,"Sub-basin 8"
3794,100,3,1700,1800,"Sub-basin 8"
3795,100,1,3500,3600,"Sub-basin 8"
3796,900,41,23500,24400,"Sub-basin 8"
3797,3500,180,14400,17900,"Sub-basin 8"
3798,100,1,1100,1200,"Sub-basin 8"
3799,200,8,3500,3700,"Sub-basin 8"
3800,200,3,3800,4000,"Sub-basin 8"
3801,1100,47.0165,10200,11300,"Sub-basin 8"
3802,700,14,6400,7100,"Sub-basin 8"
3803,1700,586,20300,22000,"Sub-basin 8"
3804,400,41,8100,8500,"Sub-basin 8"
3805,2900,1236,25700,28600,"Sub-basin 8"
3806,2200,429,12800,15000,"Sub-basin 8"
3807,100,2,1200,1300,"Sub-basin 8"
3808,2600,311,4100,6700,"Sub-basin 8"
3809,100,2,1500,1600,"Sub-basin 8"
3810,400,27,15400,15800,"Sub-basin 8"
3811,300,6,5400,5700,"Sub-basin 8"
3812,100,3,3200,3300,"Sub-basin 8"
3813,1000,99,6100,7100,"Sub-basin 8"
3814,3900,1127.0499,13000,16900,"Sub-basin 8"
3815,200,3,2300,2500,"Sub-basin 8"
3816,4000,554,26900,30900,"Sub-basin 8"
3817,100,1,2900,3000,"Sub-basin 8"
3818,300,7.0076,3800,4100,"Sub-basin 8"
3819,400,11.0147,5400,5800,"Sub-basin 8"
3820,1600,147,5700,7300,"Sub-basin 8"
3821,1000,63,5500,6500,"Sub-basin 8"
3822,1000,212.0124,3900,4900,"Sub-basin 8"
3823,200,5,3200,3400,"Sub-basin 8"
3824,700,67,12100,12800,"Sub-basin 8"
3825,400,11,4100,4500,"Sub-basin 8"
3826,8600,1471,85800,94400,"Sub-basin 8"
3827,100,2,2600,2700,"Sub-basin 8"
3828,300,13,6300,6600,"Sub-basin 8"
3829,500,46,5400,5900,"Sub-basin 8"
3830,200,7,5100,5300,"Sub-basin 8"
3831,1500,126.0571,13000,14500,"Sub-basin 8"
3832,300,16,3000,3300,"Sub-basin 8"
3833,2500,158,11400,13900,"Sub-basin 8"
3834,200,2,8000,8200,"Sub-basin 8"
3835,100,1,1400,1500,"Sub-basin 8"
3836,4200,720,16600,20800,"Sub-basin 8"
3837,200,2,8700,8900,"Sub-basin 8"
3838,100,4,1500,1600,"Sub-basin 8"
3839,400,6,1600,2000,"Sub-basin 8"
3840,400,24,6700,7100,"Sub-basin 8"
3841,2900,541,6900,9800,"Sub-basin 8"
3842,1600,59,7600,9200,"Sub-basin 8"
3843,100,1,1300,1400,"Sub-basin 8"
3844,100,6,2500,2600,"Sub-basin 8"
3845,100,3,300,400,"Sub-basin 8"
3846,3900,461.1041,24600,28500,"Sub-basin 8"
3847,900,38.0391,11600,12500,"Sub-basin 8"
3848,600,40,2100,2700,"Sub-basin 8"
3849,300,14,1800,2100,"Sub-basin 8"
3850,1300,90,5400,6700,"Sub-basin 8"
3851,100,2,1900,2000,"Sub-basin 8"
3852,2300,304,13900,16200,"Sub-basin 8"
3853,700,113,2600,3300,"Sub-basin 8"
3854,200,27,1700,1900,"Sub-basin 8"
3855,3300,811,5000,8300,"Sub-basin 8"
3856,2100,565,4200,6300,"Sub-basin 8"
3857,100,3,400,500,"Sub-basin 8"
3858,2500,959,4100,6600,"Sub-basin 8"
3859,100,3,500,600,"Sub-basin 8"
3860,100,1,1200,1300,"Sub-basin 8"
3861,100,1,700,800,"Sub-basin 8"
3862,400,16,3000,3400,"Sub-basin 8"
3863,700,46,6100,6800,"Sub-basin 8"
3864,100,6,2300,2400,"Sub-basin 8"
3865,700,44,13700,14400,"Sub-basin 8"
3866,300,13,4300,4600,"Sub-basin 8"
3867,1400,146,8000,9400,"Sub-basin 8"
3868,200,5,2200,2400,"Sub-basin 8"
3869,300,4,3800,4100,"Sub-basin 8"
3870,200,3,2400,2600,"Sub-basin 8"
3871,700,151,500,1200,"Sub-basin 8"
3872,200,19,2200,2400,"Sub-basin 8"
3873,1000,20,13000,14000,"Sub-basin 8"
3874,1500,222,12000,13500,"Sub-basin 8"
3875,400,8,5500,5900,"Sub-basin 8"
3876,100,1,3500,3600,"Sub-basin 8"
3877,100,1,1300,1400,"Sub-basin 8"
3878,100,3,900,1000,"Sub-basin 8"
3879,200,2,1400,1600,"Sub-basin 8"
3880,100,2,1200,1300,"Sub-basin 8"
3881,200,10,2300,2500,"Sub-basin 8"
3882,300,5,2400,2700,"Sub-basin 8"
3883,100,1,100,200,"Sub-basin 8"
3884,900,119,2400,3300,"Sub-basin 8"
3885,400,21,3900,4300,"Sub-basin 8"
3886,100,3,700,800,"Sub-basin 8"
3887,200,5,4700,4900,"Sub-basin 8"
3888,100,4,1000,1100,"Sub-basin 8"
3889,200,7,2600,2800,"Sub-basin 8"
3890,100,1,1800,1900,"Sub-basin 8"
3891,100,2,3300,3400,"Sub-basin 8"
3892,400,46,3800,4200,"Sub-basin 8"
3893,200,14.0042,2600,2800,"Sub-basin 8"
3894,100,2,900,1000,"Sub-basin 8"
3895,100,1,1000,1100,"Sub-basin 8"
3896,100,6,1200,1300,"Sub-basin 8"
3897,400,18,3400,3800,"Sub-basin 8"
3898,400,20,3600,4000,"Sub-basin 8"
3899,100,13,1700,1800,"Sub-basin 8"
3900,900,94.0314,9100,10000,"Sub-basin 8"
3901,500,15,4500,5000,"Sub-basin 8"
3902,100,1,1900,2000,"Sub-basin 8"
3903,200,11,2700,2900,"Sub-basin 8"
3904,100,8,900,1000,"Sub-basin 8"
3905,200,14,1700,1900,"Sub-basin 8"
3906,900,99,15500,16400,"Sub-basin 8"
3907,500,39,5500,6000,"Sub-basin 8"
3908,100,3,1700,1800,"Sub-basin 8"
3909,300,5,3100,3400,"Sub-basin 8"
3910,1300,84.0213,10200,11500,"Sub-basin 8"
3911,200,18.0009,3800,4000,"Sub-basin 8"
3912,200,4,1600,1800,"Sub-basin 8"
3913,300,15,2200,2500,"Sub-basin 8"
3914,200,9,2900,3100,"Sub-basin 8"
3915,800,60,5000,5800,"Sub-basin 8"
3916,1800,147,21400,23200,"Sub-basin 8"
3917,100,3,700,800,"Sub-basin 8"
3918,800,52,5700,6500,"Sub-basin 8"
3919,2000,453,12000,14000,"Sub-basin 8"
3920,400,82,4700,5100,"Sub-basin 8"
3921,100,8,1200,1300,"Sub-basin 8"
3922,500,50,4900,5400,"Sub-basin 8"
3923,100,2,1500,1600,"Sub-basin 8"
3924,300,17,2800,3100,"Sub-basin 8"
3925,300,45,2500,2800,"Sub-basin 8"
3926,100,1,400,500,"Sub-basin 8"
3927,100,4,900,1000,"Sub-basin 8"
3928,500,30,6100,6600,"Sub-basin 8"
3929,200,4.0012,3000,3200,"Sub-basin 8"
3930,100,2.0007,1600,1700,"Sub-basin 8"
3931,100,3.0021,1700,1800,"Sub-basin 8"
3932,100,1,1200,1300,"Sub-basin 8"
3933,300,7,1900,2200,"Sub-basin 8"
3934,400,7.0076,6400,6800,"Sub-basin 8"
3935,200,7,2700,2900,"Sub-basin 8"
3936,100,4,1900,2000,"Sub-basin 8"
3937,600,22,3100,3700,"Sub-basin 8"
3938,200,6.0029,3900,4100,"Sub-basin 8"
3939,100,5,1200,1300,"Sub-basin 8"
3940,100,1,300,400,"Sub-basin 8"
3941,200,3,1200,1400,"Sub-basin 8"
3942,400,17,5700,6100,"Sub-basin 8"
3943,100,2,2500,2600,"Sub-basin 8"
3944,100,1,400,500,"Sub-basin 8"
3945,200,3,1600,1800,"Sub-basin 8"
3946,2700,1263.0126,15000,17700,"Sub-basin 8"
3947,100,8,1500,1600,"Sub-basin 8"
3948,200,11,1800,2000,"Sub-basin 8"
3949,1100,65.0094,6500,7600,"Sub-basin 8"
3950,200,17,4200,4400,"Sub-basin 8"
3951,100,3.0025,1200,1300,"Sub-basin 8"
3952,100,2,1500,1600,"Sub-basin 8"
3953,200,5,2800,3000,"Sub-basin 8"
3954,100,2,1500,1600,"Sub-basin 8"
3955,800,34,4600,5400,"Sub-basin 8"
3956,300,9,4200,4500,"Sub-basin 8"
3957,400,11,5500,5900,"Sub-basin 8"
3958,100,4,2200,2300,"Sub-basin 8"
3959,400,24,5000,5400,"Sub-basin 8"
3960,300,18.0015,2300,2600,"Sub-basin 8"
3961,100,1,3000,3100,"Sub-basin 8"
3962,400,8,5600,6000,"Sub-basin 8"
3963,400,13,4200,4600,"Sub-basin 8"
3964,500,28,2600,3100,"Sub-basin 8"
3965,200,7.0011,2500,2700,"Sub-basin 8"
3966,100,5,600,700,"Sub-basin 8"
3967,100,2,1000,1100,"Sub-basin 8"
3968,65900,17807.4199,237100,303000,"Sub-basin 8"
3969,1800,106.0181,19300,21100,"Sub-basin 8"
3970,100,1,1400,1500,"Sub-basin 8"
3971,100,5,1200,1300,"Sub-basin 8"
3972,200,4,3300,3500,"Sub-basin 8"
3973,1700,104,19000,20700,"Sub-basin 8"
3974,100,1,800,900,"Sub-basin 8"
3975,1100,86,6300,7400,"Sub-basin 8"
3976,100,3,2800,2900,"Sub-basin 8"
3977,600,42,10300,10900,"Sub-basin 8"
3978,700,29,6600,7300,"Sub-basin 8"
3979,100,1,1300,1400,"Sub-basin 8"
3980,300,42,4400,4700,"Sub-basin 8"
3981,200,5,3800,4000,"Sub-basin 8"
3982,100,5,2800,2900,"Sub-basin 8"
3983,100,3,600,700,"Sub-basin 8"
3984,300,15,1900,2200,"Sub-basin 8"
3985,600,34,1400,2000,"Sub-basin 8"
3986,100,3,1300,1400,"Sub-basin 8"
3987,1300,109,10400,11700,"Sub-basin 8"
3988,100,2,1200,1300,"Sub-basin 8"
3989,11000,2809,31300,42300,"Sub-basin 8"
3990,400,8,4400,4800,"Sub-basin 8"
3991,400,35,2400,2800,"Sub-basin 8"
3992,300,18,1500,1800,"Sub-basin 8"
3993,400,6,4700,5100,"Sub-basin 8"
3994,100,1,1700,1800,"Sub-basin 8"
3995,800,24,5700,6500,"Sub-basin 8"
3996,100,1,1100,1200,"Sub-basin 8"
3997,100,1,1100,1200,"Sub-basin 8"
3998,200,5,3000,3200,"Sub-basin 8"
3999,100,2,1800,1900,"Sub-basin 8"
4000,1000,71.67,9800,10800,"Sub-basin 8"
4001,400,35,2200,2600,"Sub-basin 8"
4002,5600,693,50000,55600,"Sub-basin 8"
4003,900,51,3800,4700,"Sub-basin 8"
4004,900,62,10200,11100,"Sub-basin 8"
4005,600,15,6800,7400,"Sub-basin 8"
4006,1800,112,9400,11200,"Sub-basin 8"
4007,100,1,600,700,"Sub-basin 8"
4008,100,1,1700,1800,"Sub-basin 8"
4009,2200,207,14100,16300,"Sub-basin 8"
4010,700,44,2800,3500,"Sub-basin 8"
4011,100,3,1100,1200,"Sub-basin 8"
4012,400,10,2300,2700,"Sub-basin 8"
4013,500,83,3900,4400,"Sub-basin 8"
4014,200,2,1700,1900,"Sub-basin 8"
4015,400,10,5800,6200,"Sub-basin 8"
4016,400,23,5300,5700,"Sub-basin 8"
4017,2000,287,10400,12400,"Sub-basin 8"
4018,800,38,7000,7800,"Sub-basin 8"
4019,200,3,1000,1200,"Sub-basin 8"
4020,100,3,300,400,"Sub-basin 8"
4021,100,1,1900,2000,"Sub-basin 8"
4022,900,49,7000,7900,"Sub-basin 8"
4023,800,91,2400,3200,"Sub-basin 8"
4024,900,127,7600,8500,"Sub-basin 8"
4025,500,26,6200,6700,"Sub-basin 8"
4026,100,1,1200,1300,"Sub-basin 8"
4027,100,2,1500,1600,"Sub-basin 8"
4028,300,7,4800,5100,"Sub-basin 8"
4029,600,29,4900,5500,"Sub-basin 8"
4030,100,3,1000,1100,"Sub-basin 8"
4031,1200,90,4300,5500,"Sub-basin 8"
4032,500,31,2500,3000,"Sub-basin 8"
4033,200,3,4400,4600,"Sub-basin 8"
4034,100,3,1900,2000,"Sub-basin 8"
4035,200,5,1800,2000,"Sub-basin 8"
4036,1200,121,6300,7500,"Sub-basin 8"
4037,900,56,8000,8900,"Sub-basin 8"
4038,100,2,2200,2300,"Sub-basin 8"
4039,500,25,8800,9300,"Sub-basin 8"
4040,100,3,1000,1100,"Sub-basin 8"
4041,1200,158,5900,7100,"Sub-basin 8"
4042,200,6,2700,2900,"Sub-basin 8"
4043,400,32,3700,4100,"Sub-basin 8"
4044,200,5,1600,1800,"Sub-basin 8"
4045,200,21,3900,4100,"Sub-basin 8"
4046,600,76,6100,6700,"Sub-basin 8"
4047,300,16,4300,4600,"Sub-basin 8"
4048,400,14,1800,2200,"Sub-basin 8"
4049,100,3,2000,2100,"Sub-basin 8"
4050,100,1,2600,2700,"Sub-basin 8"
4051,200,3,3200,3400,"Sub-basin 8"
4052,700,43,13000,13700,"Sub-basin 8"
4053,600,176,4400,5000,"Sub-basin 8"
4054,200,13,1900,2100,"Sub-basin 8"
4055,200,11,1500,1700,"Sub-basin 8"
4056,100,7,800,900,"Sub-basin 8"
4057,100,1,1900,2000,"Sub-basin 8"
4058,200,3,2300,2500,"Sub-basin 8"
4059,300,11,4700,5000,"Sub-basin 8"
4060,300,9,4400,4700,"Sub-basin 8"
4061,400,6,5900,6300,"Sub-basin 8"
4062,200,10,2800,3000,"Sub-basin 8"
4063,3200,340,16600,19800,"Sub-basin 8"
4064,200,11,2800,3000,"Sub-basin 8"
4065,600,184,4800,5400,"Sub-basin 8"
4066,400,29,3800,4200,"Sub-basin 8"
4067,300,12,1000,1300,"Sub-basin 8"
4068,900,51,5900,6800,"Sub-basin 8"
4069,300,6,2600,2900,"Sub-basin 8"
4070,100,1,1200,1300,"Sub-basin 8"
4071,2900,213,28100,31000,"Sub-basin 8"
4072,1000,118,5100,6100,"Sub-basin 8"
4073,100,3,2200,2300,"Sub-basin 8"
4074,700,81,6000,6700,"Sub-basin 8"
4075,100,3,1300,1400,"Sub-basin 8"
4076,100,4,2400,2500,"Sub-basin 8"
4077,400,34,3600,4000,"Sub-basin 8"
4078,800,67,7500,8300,"Sub-basin 8"
4079,400,34,4000,4400,"Sub-basin 8"
4080,300,3,3000,3300,"Sub-basin 8"
4081,175800,56613.5,460000,635800,"Sub-basin 8"
4082,500,37,5100,5600,"Sub-basin 8"
4083,500,19,4100,4600,"Sub-basin 8"
4084,100,2,2000,2100,"Sub-basin 8"
4085,1600,206,8900,10500,"Sub-basin 8"
4086,100,3,2000,2100,"Sub-basin 8"
4087,700,80,5300,6000,"Sub-basin 8"
4088,100,3,2900,3000,"Sub-basin 8"
4089,100,1,900,1000,"Sub-basin 8"
4090,100,3,2400,2500,"Sub-basin 8"
4091,200,8,2900,3100,"Sub-basin 8"
4092,500,40,7100,7600,"Sub-basin 8"
4093,1100,111,9200,10300,"Sub-basin 8"
4094,100,2,700,800,"Sub-basin 8"
4095,200,3,1300,1500,"Sub-basin 8"
4096,100,2,1400,1500,"Sub-basin 8"
4097,1300,160,11100,12400,"Sub-basin 8"
4098,100,4,2400,2500,"Sub-basin 8"
4099,600,29,2800,3400,"Sub-basin 8"
4100,100,1,1500,1600,"Sub-basin 8"
4101,100,2,600,700,"Sub-basin 8"
4102,300,9,3300,3600,"Sub-basin 8"
4103,500,17,5000,5500,"Sub-basin 8"
4104,1200,85,10300,11500,"Sub-basin 8"
4105,200,3,3200,3400,"Sub-basin 8"
4106,300,8,4600,4900,"Sub-basin 8"
4107,300,13,2500,2800,"Sub-basin 8"
4108,400,10,3300,3700,"Sub-basin 8"
4109,100,4,1100,1200,"Sub-basin 8"
4110,100,1,1700,1800,"Sub-basin 8"
4111,200,9,2000,2200,"Sub-basin 8"
4112,300,13,2900,3200,"Sub-basin 8"
4113,100,2,1200,1300,"Sub-basin 8"
4114,500,26,5000,5500,"Sub-basin 8"
4115,1000,63,9600,10600,"Sub-basin 8"
4116,400,29,2500,2900,"Sub-basin 8"
4117,200,4,2500,2700,"Sub-basin 8"
4118,100,1,2000,2100,"Sub-basin 8"
4119,100,4,1100,1200,"Sub-basin 8"
4120,1600,225,6300,7900,"Sub-basin 8"
4121,400,22,2000,2400,"Sub-basin 8"
4122,800,31,8500,9300,"Sub-basin 8"
4123,100,1,1700,1800,"Sub-basin 8"
4124,200,5,3200,3400,"Sub-basin 8"
4125,200,14,4100,4300,"Sub-basin 8"
4126,200,9,3900,4100,"Sub-basin 8"
4127,100,1,3000,3100,"Sub-basin 8"
4128,200,2,4700,4900,"Sub-basin 8"
4129,400,12,6900,7300,"Sub-basin 8"
4130,100,1,700,800,"Sub-basin 8"
4131,200,3,2600,2800,"Sub-basin 8"
4132,100,5,800,900,"Sub-basin 8"
4133,400,22,9800,10200,"Sub-basin 8"
4134,200,8,1900,2100,"Sub-basin 8"
4135,100,4,1200,1300,"Sub-basin 8"
4136,300,11,3700,4000,"Sub-basin 8"
4137,300,15,2800,3100,"Sub-basin 8"
4138,100,2,1300,1400,"Sub-basin 8"
4139,200,20,3100,3300,"Sub-basin 8"
4140,600,35,4700,5300,"Sub-basin 8"
4141,100,3,1700,1800,"Sub-basin 8"
4142,100,1,1200,1300,"Sub-basin 8"
4143,100,2,2400,2500,"Sub-basin 8"
4144,1500,208,9100,10600,"Sub-basin 8"
4145,200,6,2000,2200,"Sub-basin 8"
4146,1000,37,8100,9100,"Sub-basin 8"
4147,100,1,1100,1200,"Sub-basin 8"
4148,100,1,2400,2500,"Sub-basin 8"
4149,200,9,2200,2400,"Sub-basin 8"
4150,100,2,1400,1500,"Sub-basin 8"
4151,100,1,2200,2300,"Sub-basin 8"
4152,300,18,2300,2600,"Sub-basin 8"
4153,700,21,4400,5100,"Sub-basin 8"
4154,100,2,1100,1200,"Sub-basin 8"
4155,100,4,1500,1600,"Sub-basin 8"
4156,200,4,2300,2500,"Sub-basin 8"
4157,100,1,1000,1100,"Sub-basin 8"
4158,300,5,3000,3300,"Sub-basin 8"
4159,500,35,4100,4600,"Sub-basin 8"
4160,200,5,1900,2100,"Sub-basin 8"
4161,900,115,6900,7800,"Sub-basin 8"
4162,400,27,2600,3000,"Sub-basin 8"
4163,300,28,4800,5100,"Sub-basin 8"
4164,200,4,3000,3200,"Sub-basin 8"
4165,100,2,400,500,"Sub-basin 8"
4166,300,15,1700,2000,"Sub-basin 8"
4167,100,1,1100,1200,"Sub-basin 8"
4168,100,9,1000,1100,"Sub-basin 8"
4169,400,26,2000,2400,"Sub-basin 8"
4170,100,2,700,800,"Sub-basin 8"
4171,300,13,2400,2700,"Sub-basin 8"
4172,100,6,800,900,"Sub-basin 8"
4173,200,3,2200,2400,"Sub-basin 8"
4174,100,1,600,700,"Sub-basin 8"
4175,300,16,4000,4300,"Sub-basin 8"
4176,400,8,2700,3100,"Sub-basin 8"
4177,1300,277,800,2100,"Sub-basin 8"
4178,200,9,700,900,"Sub-basin 8"
4179,100,2,400,500,"Sub-basin 8"
4180,100,3,1500,1600,"Sub-basin 8"
4181,100,1,1400,1500,"Sub-basin 8"
4182,100,5,1200,1300,"Sub-basin 8"
4183,600,18,1200,1800,"Sub-basin 8"
4184,14800,6005,16400,31200,"Sub-basin 8"
4185,200,9,1600,1800,"Sub-basin 8"
4186,100,1,400,500,"Sub-basin 8"
4187,100,3,2700,2800,"Sub-basin 8"
4188,600,149,2200,2800,"Sub-basin 8"
4189,1100,113,7800,8900,"Sub-basin 8"
4190,200,5,2600,2800,"Sub-basin 8"
4191,600,28,4700,5300,"Sub-basin 8"
4192,200,8,2800,3000,"Sub-basin 8"
4193,500,17,4000,4500,"Sub-basin 8"
4194,800,32,900,1700,"Sub-basin 8"
4195,200,47,600,800,"Sub-basin 8"
4196,2100,481,5600,7700,"Sub-basin 8"
4197,100,1,800,900,"Sub-basin 8"
4198,100,5,700,800,"Sub-basin 8"
4199,100,2,800,900,"Sub-basin 8"
4200,200,2,900,1100,"Sub-basin 8"
4201,100,12,900,1000,"Sub-basin 8"
4202,500,44,2500,3000,"Sub-basin 8"
4203,2100,737,4200,6300,"Sub-basin 8"
4204,200,6,2300,2500,"Sub-basin 8"
4205,600,92,6200,6800,"Sub-basin 8"
4206,200,3,2500,2700,"Sub-basin 8"
4207,200,4,2000,2200,"Sub-basin 8"
4208,4500,2335,4800,9300,"Sub-basin 8"
4209,100,1,1500,1600,"Sub-basin 8"
4210,100,1,700,800,"Sub-basin 8"
4211,100,2,600,700,"Sub-basin 8"
4212,6500,1626,15300,21800,"Sub-basin 8"
4213,6200,622,32500,38700,"Sub-basin 8"
4214,500,15,2700,3200,"Sub-basin 8"
4215,100,3,1100,1200,"Sub-basin 8"
4216,100,11,1100,1200,"Sub-basin 8"
4217,300,18,4000,4300,"Sub-basin 8"
4218,5700,592,9500,15200,"Sub-basin 8"
4219,100,2,2200,2300,"Sub-basin 8"
4220,700,24,5700,6400,"Sub-basin 8"
4221,200,20,2200,2400,"Sub-basin 8"
4222,200,3,2600,2800,"Sub-basin 8"
4223,2000,607,3100,5100,"Sub-basin 8"
4224,800,60,2000,2800,"Sub-basin 8"
4225,100,2,2500,2600,"Sub-basin 8"
4226,100,2,1300,1400,"Sub-basin 8"
4227,200,2,2100,2300,"Sub-basin 8"
4228,400,79,500,900,"Sub-basin 8"
4229,100,3,200,300,"Sub-basin 8"
4230,100,1,1400,1500,"Sub-basin 8"
4231,500,50,1000,1500,"Sub-basin 8"
4232,200,18,1300,1500,"Sub-basin 8"
4233,500,8,6000,6500,"Sub-basin 8"
4234,200,4,3800,4000,"Sub-basin 8"
4235,1100,461,2200,3300,"Sub-basin 8"
4236,1100,552,1900,3000,"Sub-basin 8"
4237,900,160,2400,3300,"Sub-basin 8"
4238,100,1,1600,1700,"Sub-basin 8"
4239,100,1,500,600,"Sub-basin 8"
4240,10200,3796,25600,35800,"Sub-basin 8"
4241,1200,284,2600,3800,"Sub-basin 8"
4242,200,7,1200,1400,"Sub-basin 8"
4243,100,4,3500,3600,"Sub-basin 8"
4244,1000,426,1400,2400,"Sub-basin 8"
4245,1200,550,2300,3500,"Sub-basin 8"
4246,400,31,1200,1600,"Sub-basin 8"
4247,100,6,1600,1700,"Sub-basin 8"
4248,100,2,1300,1400,"Sub-basin 8"
4249,100,2,1700,1800,"Sub-basin 8"
4250,700,24,6400,7100,"Sub-basin 8"
4251,53100,25988.84,47000,100100,"Sub-basin 8"
4252,200,11,900,1100,"Sub-basin 8"
4253,100,4,1500,1600,"Sub-basin 8"
4254,1000,62,6000,7000,"Sub-basin 8"
4255,1300,242,2200,3500,"Sub-basin 8"
4256,1400,360,3000,4400,"Sub-basin 8"
4257,400,117,1000,1400,"Sub-basin 8"
4258,1600,234,2800,4400,"Sub-basin 8"
4259,100,2,700,800,"Sub-basin 8"
4260,1400,174,9300,10700,"Sub-basin 8"
4261,200,2,2500,2700,"Sub-basin 8"
4262,100,1,2600,2700,"Sub-basin 8"
4263,900,179,4600,5500,"Sub-basin 8"
4264,100,2,2000,2100,"Sub-basin 8"
4265,300,10,4800,5100,"Sub-basin 8"
4266,400,29,600,1000,"Sub-basin 8"
4267,4000,1578,14800,18800,"Sub-basin 8"
4268,2700,1220,3800,6500,"Sub-basin 8"
4269,1400,64,16700,18100,"Sub-basin 8"
4270,100,1,1800,1900,"Sub-basin 8"
4271,200,4,3000,3200,"Sub-basin 8"
4272,100,6,2300,2400,"Sub-basin 8"
4273,300,21,5500,5800,"Sub-basin 8"
4274,100,2,1500,1600,"Sub-basin 8"
4275,700,38,11400,12100,"Sub-basin 8"
4276,900,332,2700,3600,"Sub-basin 8"
4277,100,11,1600,1700,"Sub-basin 8"
4278,200,3,5800,6000,"Sub-basin 8"
4279,100,1,700,800,"Sub-basin 8"
4280,200,6,3900,4100,"Sub-basin 8"
4281,400,177,6700,7100,"Sub-basin 8"
4282,100,8,1700,1800,"Sub-basin 8"
4283,100,2,1000,1100,"Sub-basin 8"
4284,100,4,1500,1600,"Sub-basin 8"
4285,300,8,3000,3300,"Sub-basin 8"
4286,100,1,1000,1100,"Sub-basin 8"
4287,800,32,5000,5800,"Sub-basin 8"
4288,300,3,2400,2700,"Sub-basin 8"
4289,100,1,1900,2000,"Sub-basin 8"
4290,1400,180,7900,9300,"Sub-basin 8"
4291,300,9,900,1200,"Sub-basin 8"
4292,2300,293,8300,10600,"Sub-basin 8"
4293,100,20,1400,1500,"Sub-basin 8"
4294,100,1,1400,1500,"Sub-basin 8"
4295,1400,268.0394,35200,36600,"Sub-basin 8"
4296,300,10,2700,3000,"Sub-basin 8"
4297,100,1,1600,1700,"Sub-basin 8"
4298,8100,2456,13900,22000,"Sub-basin 8"
4299,800,172,3400,4200,"Sub-basin 8"
4300,400,30,1700,2100,"Sub-basin 8"
4301,100,1,500,600,"Sub-basin 8"
4302,100,1,900,1000,"Sub-basin 8"
4303,200,5,3900,4100,"Sub-basin 8"
4304,100,2,1300,1400,"Sub-basin 8"
4305,100,3,500,600,"Sub-basin 8"
4306,2000,832,1600,3600,"Sub-basin 8"
4307,200,5,2400,2600,"Sub-basin 8"
4308,100,3,1900,2000,"Sub-basin 8"
4309,100,4,1100,1200,"Sub-basin 8"
4310,7400,2473,16000,23400,"Sub-basin 8"
4311,200,2,4600,4800,"Sub-basin 8"
4312,100,1,1800,1900,"Sub-basin 8"
4313,200,9,2200,2400,"Sub-basin 8"
4314,100,7,2200,2300,"Sub-basin 8"
4315,400,45,1600,2000,"Sub-basin 8"
4316,100,2,500,600,"Sub-basin 8"
4317,800,187,2700,3500,"Sub-basin 8"
4318,100,1,1700,1800,"Sub-basin 8"
4319,100,1,2800,2900,"Sub-basin 8"
4320,100,1,800,900,"Sub-basin 8"
4321,200,6,4600,4800,"Sub-basin 8"
4322,100,2,1400,1500,"Sub-basin 8"
4323,900,26,13600,14500,"Sub-basin 8"
4324,100,2,1900,2000,"Sub-basin 8"
4325,100,6,2300,2400,"Sub-basin 8"
4326,1300,241.1083,24300,25600,"Sub-basin 8"
4327,700,51,4700,5400,"Sub-basin 8"
4328,100,1,300,400,"Sub-basin 8"
4329,700,217,3300,4000,"Sub-basin 8"
4330,100,3,800,900,"Sub-basin 8"
4331,1400,127,7300,8700,"Sub-basin 8"
4332,18200,8021.34,17800,36000,"Sub-basin 8"
4333,1100,121,5200,6300,"Sub-basin 8"
4334,200,10,1100,1300,"Sub-basin 8"
4335,1200,125,5100,6300,"Sub-basin 8"
4336,3500,859,4600,8100,"Sub-basin 8"
4337,1900,413,3700,5600,"Sub-basin 8"
4338,100,3,1700,1800,"Sub-basin 8"
4339,400,27,7700,8100,"Sub-basin 8"
4340,2300,144,4900,7200,"Sub-basin 8"
4341,46800,14184.66,45700,92500,"Sub-basin 8"
4342,2300,448.17,13500,15800,"Sub-basin 8"
4343,700,762,6500,7200,"Sub-basin 8"
4344,900,249.0319,13700,14600,"Sub-basin 8"
4345,800,82,3500,4300,"Sub-basin 8"
4346,100,2,1400,1500,"Sub-basin 8"
4347,100,4,1900,2000,"Sub-basin 8"
4348,51200,9097.99,78200,129400,"Sub-basin 8"
4349,400,31,4000,4400,"Sub-basin 8"
4350,100,1,900,1000,"Sub-basin 8"
4351,100,1,2200,2300,"Sub-basin 8"
4352,1400,103.5,15300,16700,"Sub-basin 8"
4353,100,1,2400,2500,"Sub-basin 8"
4354,100,1,400,500,"Sub-basin 8"
4355,100,2,2200,2300,"Sub-basin 8"
4356,200,4,1500,1700,"Sub-basin 8"
4357,100,2,1700,1800,"Sub-basin 8"
4358,300,9.0018,5600,5900,"Sub-basin 8"
4359,1100,123,3900,5000,"Sub-basin 8"
4360,500,25,2300,2800,"Sub-basin 8"
4361,600,62,1400,2000,"Sub-basin 8"
4362,400,23,2200,2600,"Sub-basin 8"
4363,100,5,1500,1600,"Sub-basin 8"
4364,2600,225,18200,20800,"Sub-basin 8"
4365,300,4.33,1600,1900,"Sub-basin 8"
4366,100,1,1100,1200,"Sub-basin 8"
4367,100,1,1400,1500,"Sub-basin 8"
4368,100,1,900,1000,"Sub-basin 8"
4369,10100,4041,11900,22000,"Sub-basin 8"
4370,300,22.0098,6000,6300,"Sub-basin 8"
4371,600,60,2400,3000,"Sub-basin 8"
4372,100,1,1000,1100,"Sub-basin 8"
4373,600,20,6200,6800,"Sub-basin 8"
4374,100,2,1300,1400,"Sub-basin 8"
4375,100,1,1300,1400,"Sub-basin 8"
4376,1700,502,3400,5100,"Sub-basin 8"
4377,100,1,900,1000,"Sub-basin 8"
4378,800,147,2200,3000,"Sub-basin 8"
4379,100,1,1500,1600,"Sub-basin 8"
4380,100,7,3000,3100,"Sub-basin 8"
4381,100,4,2600,2700,"Sub-basin 8"
4382,200,2,2200,2400,"Sub-basin 8"
4383,200,2,800,1000,"Sub-basin 8"
4384,3700,553.1981,33400,37100,"Sub-basin 8"
4385,100,1,1200,1300,"Sub-basin 8"
4386,300,10,2100,2400,"Sub-basin 8"
4387,100,2,1500,1600,"Sub-basin 8"
4388,2000,857,5400,7400,"Sub-basin 8"
4389,1300,108,3900,5200,"Sub-basin 8"
4390,300,16,6700,7000,"Sub-basin 8"
4391,100,1,800,900,"Sub-basin 8"
4392,1600,609,3600,5200,"Sub-basin 8"
4393,200,7,1500,1700,"Sub-basin 8"
4394,100,1,1400,1500,"Sub-basin 8"
4395,1200,50,6300,7500,"Sub-basin 8"
4396,100,1,0,100,"Sub-basin 8"
4397,100,1,900,1000,"Sub-basin 8"
4398,600,162,1400,2000,"Sub-basin 8"
4399,300,7,6400,6700,"Sub-basin 8"
4400,100,2,1600,1700,"Sub-basin 8"
4401,1000,94,9500,10500,"Sub-basin 8"
4402,400,8,3800,4200,"Sub-basin 8"
4403,8500,1852,11900,20400,"Sub-basin 8"
4404,200,12,1700,1900,"Sub-basin 8"
4405,500,47,1300,1800,"Sub-basin 8"
4406,1100,78,2700,3800,"Sub-basin 8"
4407,100,2,400,500,"Sub-basin 8"
4408,200,9,3800,4000,"Sub-basin 8"
4409,100,7,3000,3100,"Sub-basin 8"
4410,1300,65,7500,8800,"Sub-basin 8"
4411,300,62,300,600,"Sub-basin 8"
4412,400,16,4300,4700,"Sub-basin 8"
4413,300,5,800,1100,"Sub-basin 8"
4414,1700,337,4000,5700,"Sub-basin 8"
4415,600,143,1900,2500,"Sub-basin 8"
4416,100,4,1500,1600,"Sub-basin 8"
4417,400,29,2500,2900,"Sub-basin 8"
4418,700,130,1900,2600,"Sub-basin 8"
4419,100,1,1200,1300,"Sub-basin 8"
4420,100,2,2100,2200,"Sub-basin 8"
4421,1700,104,7900,9600,"Sub-basin 8"
4422,100,1,1200,1300,"Sub-basin 8"
4423,100,2,700,800,"Sub-basin 8"
4424,100,1,800,900,"Sub-basin 8"
4425,400,18,5000,5400,"Sub-basin 8"
4426,100,3,1600,1700,"Sub-basin 8"
4427,400,19,4700,5100,"Sub-basin 8"
4428,100,2,300,400,"Sub-basin 8"
4429,400,16,1700,2100,"Sub-basin 8"
4430,600,32,2800,3400,"Sub-basin 8"
4431,2100,194,6300,8400,"Sub-basin 8"
4432,400,27,3300,3700,"Sub-basin 8"
4433,100,1,800,900,"Sub-basin 8"
4434,400,39,1300,1700,"Sub-basin 8"
4435,100,2,3200,3300,"Sub-basin 8"
4436,200,2,1400,1600,"Sub-basin 8"
4437,300,7,2000,2300,"Sub-basin 8"
4438,100,1,800,900,"Sub-basin 8"
4439,400,32,2400,2800,"Sub-basin 8"
4440,400,16,3300,3700,"Sub-basin 8"
4441,100,5,2000,2100,"Sub-basin 8"
4442,1100,101,10400,11500,"Sub-basin 8"
4443,43100,10405,48900,92000,"Sub-basin 8"
4444,100,1,900,1000,"Sub-basin 8"
4445,100,4,1100,1200,"Sub-basin 8"
4446,400,20,3200,3600,"Sub-basin 8"
4447,400,47,3700,4100,"Sub-basin 8"
4448,200,38.0065,1800,2000,"Sub-basin 8"
4449,100,1,300,400,"Sub-basin 8"
4450,300,45,2200,2500,"Sub-basin 8"
4451,100,1,1300,1400,"Sub-basin 8"
4452,100,2,700,800,"Sub-basin 8"
4453,700,46,3100,3800,"Sub-basin 8"
4454,200,6,1100,1300,"Sub-basin 8"
4455,700,39,1800,2500,"Sub-basin 8"
4456,100,4,1300,1400,"Sub-basin 8"
4457,200,3,1200,1400,"Sub-basin 8"
4458,300,9,2000,2300,"Sub-basin 8"
4459,100,1,700,800,"Sub-basin 8"
4460,100,2,700,800,"Sub-basin 8"
4461,200,5,800,1000,"Sub-basin 8"
4462,100,4,1900,2000,"Sub-basin 8"
4463,900,146,6000,6900,"Sub-basin 8"
4464,200,6,2600,2800,"Sub-basin 8"
4465,300,9,5500,5800,"Sub-basin 8"
4466,1000,74,4300,5300,"Sub-basin 8"
4467,1800,242,4000,5800,"Sub-basin 8"
4468,100,1,900,1000,"Sub-basin 8"
4469,100,2,900,1000,"Sub-basin 8"
4470,200,29,1900,2100,"Sub-basin 8"
4471,400,19,6200,6600,"Sub-basin 8"
4472,5900,1224,39700,45600,"Sub-basin 8"
4473,2000,223,3100,5100,"Sub-basin 8"
4474,100,1,400,500,"Sub-basin 8"
4475,200,10,1400,1600,"Sub-basin 8"
4476,4500,717,11000,15500,"Sub-basin 8"
4477,200,5,1800,2000,"Sub-basin 8"
4478,1400,103,7800,9200,"Sub-basin 8"
4479,100,8,300,400,"Sub-basin 8"
4480,1200,116,2800,4000,"Sub-basin 8"
4481,1100,76,5400,6500,"Sub-basin 8"
4482,100,2,500,600,"Sub-basin 8"
4483,200,5,100,300,"Sub-basin 8"
4484,1900,372,4200,6100,"Sub-basin 8"
4485,30900,5916,59900,90800,"Sub-basin 8"
4486,200,7,400,600,"Sub-basin 8"
4487,100,3,700,800,"Sub-basin 8"
4488,300,15.0083,4800,5100,"Sub-basin 8"
4489,400,15,1900,2300,"Sub-basin 8"
4490,8900,2218,33900,42800,"Sub-basin 8"
4491,400,21,3300,3700,"Sub-basin 8"
4492,100,1,0,100,"Sub-basin 8"
4493,900,74,2700,3600,"Sub-basin 8"
4494,400,9,3300,3700,"Sub-basin 8"
4495,700,43,2900,3600,"Sub-basin 8"
4496,400,24,2500,2900,"Sub-basin 8"
4497,100,1,1000,1100,"Sub-basin 8"
4498,100,5,2200,2300,"Sub-basin 8"
4499,1400,321,10700,12100,"Sub-basin 8"
4500,600,112,2100,2700,"Sub-basin 8"
4501,300,18,1700,2000,"Sub-basin 8"
4502,100,1,900,1000,"Sub-basin 8"
4503,800,104,3300,4100,"Sub-basin 8"
4504,800,176,3400,4200,"Sub-basin 8"
4505,100,7,1900,2000,"Sub-basin 8"
4506,49400,16647,68200,117600,"Sub-basin 8"
4507,500,73,5100,5600,"Sub-basin 8"
4508,200,18,1700,1900,"Sub-basin 8"
4509,100,9,1100,1200,"Sub-basin 8"
4510,900,113,3600,4500,"Sub-basin 8"
4511,200,6,1200,1400,"Sub-basin 8"
4512,100,1,800,900,"Sub-basin 8"
4513,100,1,700,800,"Sub-basin 8"
4514,3100,537,25600,28700,"Sub-basin 8"
4515,100,2,1400,1500,"Sub-basin 8"
4516,1600,70.1113,36400,38000,"Sub-basin 8"
4517,100,1,1300,1400,"Sub-basin 8"
4518,300,13,1500,1800,"Sub-basin 8"
4519,1400,351,5100,6500,"Sub-basin 8"
4520,3000,587,7400,10400,"Sub-basin 8"
4521,1500,226,3900,5400,"Sub-basin 8"
4522,1100,126,7700,8800,"Sub-basin 8"
4523,100,1,1900,2000,"Sub-basin 8"
4524,2400,229,22600,25000,"Sub-basin 8"
4525,1500,468,4000,5500,"Sub-basin 8"
4526,300,76,1900,2200,"Sub-basin 8"
4527,100,2,1900,2000,"Sub-basin 8"
4528,300,13,1900,2200,"Sub-basin 8"
4529,1200,98,5100,6300,"Sub-basin 8"
4530,900,377,1700,2600,"Sub-basin 8"
4531,200,8,1000,1200,"Sub-basin 8"
4532,400,8,1200,1600,"Sub-basin 8"
4533,100,1,2600,2700,"Sub-basin 8"
4534,300,15,500,800,"Sub-basin 8"
4535,700,106,1800,2500,"Sub-basin 8"
4536,4600,766,9600,14200,"Sub-basin 8"
4537,100,1,1700,1800,"Sub-basin 8"
4538,200,15,1700,1900,"Sub-basin 8"
4539,4500,485,16300,20800,"Sub-basin 8"
4540,1700,340,5700,7400,"Sub-basin 8"
4541,1200,147,4700,5900,"Sub-basin 8"
4542,100,5,500,600,"Sub-basin 8"
4543,800,247,4500,5300,"Sub-basin 8"
4544,100,7,1900,2000,"Sub-basin 8"
4545,200,5,900,1100,"Sub-basin 8"
4546,200,12,4100,4300,"Sub-basin 8"
4547,1200,158,4300,5500,"Sub-basin 8"
4548,1300,46.0528,25100,26400,"Sub-basin 8"
4549,100,2,700,800,"Sub-basin 8"
4550,400,10,2900,3300,"Sub-basin 8"
4551,200,3,1600,1800,"Sub-basin 8"
4552,200,6,2300,2500,"Sub-basin 8"
4553,600,140,6000,6600,"Sub-basin 8"
4554,400,52,1800,2200,"Sub-basin 8"
4555,100,4,0,100,"Sub-basin 8"
4556,1900,1494,17000,18900,"Sub-basin 8"
4557,300,11,1100,1400,"Sub-basin 8"
4558,1100,80,2300,3400,"Sub-basin 8"
4559,200,16,800,1000,"Sub-basin 8"
4560,1900,185,10000,11900,"Sub-basin 8"
4561,200,5,2500,2700,"Sub-basin 8"
4562,600,50,4900,5500,"Sub-basin 8"
4563,33700,16976,20500,54200,"Sub-basin 8"
4564,100,1,2500,2600,"Sub-basin 8"
4565,1500,622,2900,4400,"Sub-basin 8"
4566,100,4.0017,1400,1500,"Sub-basin 8"
4567,100,3,1500,1600,"Sub-basin 8"
4568,400,7.027,5100,5500,"Sub-basin 8"
4569,5800,2819,11500,17300,"Sub-basin 8"
4570,100,1,1200,1300,"Sub-basin 8"
4571,100,3,1500,1600,"Sub-basin 8"
4572,100,3,900,1000,"Sub-basin 8"
4573,100,1,2200,2300,"Sub-basin 8"
4574,600,148,1500,2100,"Sub-basin 8"
4575,200,6.0057,4500,4700,"Sub-basin 8"
4576,1200,194,4700,5900,"Sub-basin 8"
4577,100,1,1900,2000,"Sub-basin 8"
4578,100,3,1700,1800,"Sub-basin 8"
4579,100,4,500,600,"Sub-basin 8"
4580,200,19,1400,1600,"Sub-basin 8"
4581,300,4,4000,4300,"Sub-basin 8"
4582,100,1,900,1000,"Sub-basin 8"
4583,1500,109,16200,17700,"Sub-basin 8"
4584,100,3.0077,2600,2700,"Sub-basin 8"
4585,400,35,1200,1600,"Sub-basin 8"
4586,100,1,800,900,"Sub-basin 8"
4587,700,26.028,11400,12100,"Sub-basin 8"
4588,600,35,2900,3500,"Sub-basin 8"
4589,700,58,3300,4000,"Sub-basin 8"
4590,1100,59,10900,12000,"Sub-basin 8"
4591,200,5,4300,4500,"Sub-basin 8"
4592,4400,2121,5800,10200,"Sub-basin 8"
4593,500,19,1700,2200,"Sub-basin 8"
4594,200,5,2400,2600,"Sub-basin 8"
4595,900,108,1600,2500,"Sub-basin 8"
4596,300,25,1800,2100,"Sub-basin 8"
4597,200,8,700,900,"Sub-basin 8"
4598,100,1,1100,1200,"Sub-basin 8"
4599,200,4,100,300,"Sub-basin 8"
4600,600,18,6200,6800,"Sub-basin 8"
4601,200,10,1200,1400,"Sub-basin 8"
4602,300,5,2400,2700,"Sub-basin 8"
4603,5500,2807,7600,13100,"Sub-basin 8"
4604,400,98,1200,1600,"Sub-basin 8"
4605,2700,629,6700,9400,"Sub-basin 8"
4606,200,12,1400,1600,"Sub-basin 8"
4607,600,60,4400,5000,"Sub-basin 8"
4608,400,75,4000,4400,"Sub-basin 8"
4609,100,1,200,300,"Sub-basin 8"
4610,900,186,2100,3000,"Sub-basin 8"
4611,100,1,1300,1400,"Sub-basin 8"
4612,400,7,3500,3900,"Sub-basin 8"
4613,200,2,4000,4200,"Sub-basin 8"
4614,200,3.0057,5000,5200,"Sub-basin 8"
4615,1400,688,4000,5400,"Sub-basin 8"
4616,700,181,800,1500,"Sub-basin 8"
4617,400,27,2000,2400,"Sub-basin 8"
4618,1200,307,1900,3100,"Sub-basin 8"
4619,200,56,1400,1600,"Sub-basin 8"
4620,100,1,500,600,"Sub-basin 8"
4621,200,17,2000,2200,"Sub-basin 8"
4622,600,35,2300,2900,"Sub-basin 8"
4623,200,5,2200,2400,"Sub-basin 8"
4624,200,5,700,900,"Sub-basin 8"
4625,10200,4337,22100,32300,"Sub-basin 8"
4626,100,1,800,900,"Sub-basin 8"
4627,200,6.0057,4500,4700,"Sub-basin 8"
4628,100,2,500,600,"Sub-basin 8"
4629,600,24,3200,3800,"Sub-basin 8"
4630,100,2,2300,2400,"Sub-basin 8"
4631,1400,314,2500,3900,"Sub-basin 8"
4632,700,163,3100,3800,"Sub-basin 8"
4633,1500,69,12800,14300,"Sub-basin 8"
4634,200,27,1300,1500,"Sub-basin 8"
4635,3400,600,29400,32800,"Sub-basin 8"
4636,100,1,600,700,"Sub-basin 8"
4637,1400,294,4100,5500,"Sub-basin 8"
4638,600,32,5500,6100,"Sub-basin 8"
4639,300,19,2100,2400,"Sub-basin 8"
4640,100,2.0022,1300,1400,"Sub-basin 8"
4641,2200,715,3100,5300,"Sub-basin 8"
4642,400,19,3500,3900,"Sub-basin 8"
4643,100,1,900,1000,"Sub-basin 8"
4644,2800,783,5600,8400,"Sub-basin 8"
4645,100,3,1800,1900,"Sub-basin 8"
4646,100,2.0022,1800,1900,"Sub-basin 8"
4647,1100,238,5400,6500,"Sub-basin 8"
4648,200,11,900,1100,"Sub-basin 8"
4649,1500,285,2600,4100,"Sub-basin 8"
4650,1200,256,5500,6700,"Sub-basin 8"
4651,100,1,1300,1400,"Sub-basin 8"
4652,300,26,2500,2800,"Sub-basin 8"
4653,100,8,2900,3000,"Sub-basin 8"
4654,100,1.0019,1800,1900,"Sub-basin 8"
4655,700,46,2500,3200,"Sub-basin 8"
4656,400,16,3300,3700,"Sub-basin 8"
4657,700,60,1900,2600,"Sub-basin 8"
4658,600,28,2800,3400,"Sub-basin 8"
4659,1300,308,3600,4900,"Sub-basin 8"
4660,100,4,400,500,"Sub-basin 8"
4661,600,34,3600,4200,"Sub-basin 8"
4662,1300,135,7000,8300,"Sub-basin 8"
4663,200,5,1700,1900,"Sub-basin 8"
4664,400,29,1300,1700,"Sub-basin 8"
4665,200,11,1900,2100,"Sub-basin 8"
4666,3100,918,3400,6500,"Sub-basin 8"
4667,1100,249,3200,4300,"Sub-basin 8"
4668,400,14,5100,5500,"Sub-basin 8"
4669,5700,1921,7100,12800,"Sub-basin 8"
4670,700,181,3200,3900,"Sub-basin 8"
4671,200,3,3600,3800,"Sub-basin 8"
4672,100,19,900,1000,"Sub-basin 8"
4673,5500,2203,10100,15600,"Sub-basin 8"
4674,3900,180.5118,60800,64700,"Sub-basin 8"
4675,200,8,1000,1200,"Sub-basin 8"
4676,2200,657,10300,12500,"Sub-basin 8"
4677,800,128,2200,3000,"Sub-basin 8"
4678,1200,151,4100,5300,"Sub-basin 8"
4679,4500,1664,14100,18600,"Sub-basin 8"
4680,200,4,3200,3400,"Sub-basin 8"
4681,4500,2278.67,9500,14000,"Sub-basin 8"
4682,100,2,1300,1400,"Sub-basin 8"
4683,200,4,4900,5100,"Sub-basin 8"
4684,200,4,3700,3900,"Sub-basin 8"
4685,100,1,1600,1700,"Sub-basin 8"
4686,100,3,900,1000,"Sub-basin 8"
4687,200,6,3900,4100,"Sub-basin 8"
4688,8800,1556,17700,26500,"Sub-basin 8"
4689,100,1,1000,1100,"Sub-basin 8"
4690,100,2,1700,1800,"Sub-basin 8"
4691,100,3,2500,2600,"Sub-basin 8"
4692,300,27,4800,5100,"Sub-basin 8"
4693,2300,211,18300,20600,"Sub-basin 8"
4694,200,4,2000,2200,"Sub-basin 8"
4695,1200,291,8500,9700,"Sub-basin 8"
4696,400,24,4200,4600,"Sub-basin 8"
4697,500,23,5900,6400,"Sub-basin 8"
4698,300,15,4100,4400,"Sub-basin 8"
4699,100,2,2000,2100,"Sub-basin 8"
4700,300,9,2000,2300,"Sub-basin 8"
4701,100,1,0,100,"Sub-basin 8"
4702,100,1,1200,1300,"Sub-basin 8"
4703,100,6,800,900,"Sub-basin 8"
4704,100,3,1600,1700,"Sub-basin 8"
4705,5200,1508,9100,14300,"Sub-basin 8"
4706,2600,1542,11600,14200,"Sub-basin 8"
4707,1100,73,16900,18000,"Sub-basin 8"
4708,200,12,2200,2400,"Sub-basin 8"
4709,9000,4639,23500,32500,"Sub-basin 8"
4710,500,57,5300,5800,"Sub-basin 8"
4711,1600,96,12600,14200,"Sub-basin 8"
4712,100,1,2000,2100,"Sub-basin 8"
4713,1300,489,3000,4300,"Sub-basin 8"
4714,100,13,1700,1800,"Sub-basin 8"
4715,2700,297,19300,22000,"Sub-basin 8"
4716,100,3,1200,1300,"Sub-basin 8"
4717,600,106,2100,2700,"Sub-basin 8"
4718,900,119,5700,6600,"Sub-basin 8"
4719,100,3,2300,2400,"Sub-basin 8"
4720,800,104,6900,7700,"Sub-basin 8"
4721,5000,1438,16800,21800,"Sub-basin 8"
4722,100,2,1600,1700,"Sub-basin 8"
4723,200,19.0055,3600,3800,"Sub-basin 8"
4724,200,2,3800,4000,"Sub-basin 8"
4725,8900,807.2882,52400,61300,"Sub-basin 8"
4726,200,20,2900,3100,"Sub-basin 8"
4727,100,7,4300,4400,"Sub-basin 8"
4728,200,9,1600,1800,"Sub-basin 8"
4729,100,1,2200,2300,"Sub-basin 8"
4730,200,7,3400,3600,"Sub-basin 8"
4731,200,12,1300,1500,"Sub-basin 8"
4732,2400,477,14900,17300,"Sub-basin 8"
4733,400,40,7300,7700,"Sub-basin 8"
4734,300,10,1300,1600,"Sub-basin 8"
4735,100,7,1500,1600,"Sub-basin 8"
4736,1000,29,2700,3700,"Sub-basin 8"
4737,300,16,3100,3400,"Sub-basin 8"
4738,12100,5045,26500,38600,"Sub-basin 8"
4739,500,38,5500,6000,"Sub-basin 8"
4740,100,2,400,500,"Sub-basin 8"
4741,2800,499,9300,12100,"Sub-basin 8"
4742,3800,474,32800,36600,"Sub-basin 8"
4743,100,3,2800,2900,"Sub-basin 8"
4744,500,10,7100,7600,"Sub-basin 8"
4745,200,2,1900,2100,"Sub-basin 8"
4746,500,18,2600,3100,"Sub-basin 8"
4747,1200,243,13000,14200,"Sub-basin 8"
4748,200,2,1100,1300,"Sub-basin 8"
4749,400,15,3500,3900,"Sub-basin 8"
4750,300,6,2400,2700,"Sub-basin 8"
4751,100,3,1100,1200,"Sub-basin 8"
4752,200,4,1100,1300,"Sub-basin 8"
4753,1300,73,10000,11300,"Sub-basin 8"
4754,200,8,5000,5200,"Sub-basin 8"
4755,200,18,2900,3100,"Sub-basin 8"
4756,100,1,600,700,"Sub-basin 8"
4757,100,1,800,900,"Sub-basin 8"
4758,100,3,1500,1600,"Sub-basin 8"
4759,100,1,1600,1700,"Sub-basin 8"
4760,100,1,1900,2000,"Sub-basin 8"
4761,300,8,4000,4300,"Sub-basin 8"
4762,100,1,500,600,"Sub-basin 8"
4763,100,1,400,500,"Sub-basin 8"
4764,100,1,1200,1300,"Sub-basin 8"
4765,100,1,1900,2000,"Sub-basin 8"
4766,100,1,1800,1900,"Sub-basin 8"
4767,200,16,4800,5000,"Sub-basin 8"
4768,200,11,7800,8000,"Sub-basin 8"
4769,100,2,800,900,"Sub-basin 8"
4770,100,3,1100,1200,"Sub-basin 8"
4771,600,110,3200,3800,"Sub-basin 8"
4772,200,16,1800,2000,"Sub-basin 8"
4773,500,18,1800,2300,"Sub-basin 8"
4774,500,15,3600,4100,"Sub-basin 8"
4775,800,41,7500,8300,"Sub-basin 8"
4776,100,1,600,700,"Sub-basin 8"
4777,500,7,3600,4100,"Sub-basin 8"
4778,100,2,800,900,"Sub-basin 8"
4779,200,5,2100,2300,"Sub-basin 8"
4780,900,54,8700,9600,"Sub-basin 8"
4781,300,17,1600,1900,"Sub-basin 8"
4782,200,6,4300,4500,"Sub-basin 8"
4783,200,8,2400,2600,"Sub-basin 8"
4784,100,2,1100,1200,"Sub-basin 8"
4785,100,1,900,1000,"Sub-basin 8"
4786,1500,27,4300,5800,"Sub-basin 8"
4787,100,2,1200,1300,"Sub-basin 8"
4788,100,1,2200,2300,"Sub-basin 8"
4789,100,16,2000,2100,"Sub-basin 8"
4790,200,5,3400,3600,"Sub-basin 8"
4791,400,12,2100,2500,"Sub-basin 8"
4792,100,7,1800,1900,"Sub-basin 8"
4793,2400,43,5700,8100,"Sub-basin 8"
4794,8800,874.67,38500,47300,"Sub-basin 8"
4795,100,1,1600,1700,"Sub-basin 8"
4796,100,3,1200,1300,"Sub-basin 8"
4797,100,1,1600,1700,"Sub-basin 8"
4798,400,14,2000,2400,"Sub-basin 8"
4799,200,26,1000,1200,"Sub-basin 8"
4800,1000,81,2400,3400,"Sub-basin 8"
4801,400,18,3400,3800,"Sub-basin 8"
4802,300,10,1500,1800,"Sub-basin 8"
4803,200,39,1800,2000,"Sub-basin 8"
4804,100,8,2100,2200,"Sub-basin 8"
4805,200,2,1800,2000,"Sub-basin 8"
4806,200,4,1500,1700,"Sub-basin 8"
4807,100,1,2200,2300,"Sub-basin 8"
4808,100,1,1500,1600,"Sub-basin 8"
4809,800,37,8000,8800,"Sub-basin 8"
4810,100,1,1200,1300,"Sub-basin 8"
4811,2100,380,21900,24000,"Sub-basin 8"
4812,1100,20,3200,4300,"Sub-basin 8"
4813,100,3,1400,1500,"Sub-basin 8"
4814,100,1,2400,2500,"Sub-basin 8"
4815,100,7,1200,1300,"Sub-basin 8"
4816,600,47.0126,4200,4800,"Sub-basin 8"
4817,100,9,1700,1800,"Sub-basin 8"
4818,500,22,3400,3900,"Sub-basin 8"
4819,500,26,3500,4000,"Sub-basin 8"
4820,100,2,2500,2600,"Sub-basin 8"
4821,100,2,2200,2300,"Sub-basin 8"
4822,100,1,600,700,"Sub-basin 8"
4823,100,1,800,900,"Sub-basin 8"
4824,1100,61,6200,7300,"Sub-basin 8"
4825,200,5,800,1000,"Sub-basin 8"
4826,72200,3209,30900,103100,"Sub-basin 8"
4827,1600,165,7200,8800,"Sub-basin 8"
4828,500,10,8900,9400,"Sub-basin 8"
4829,100,1,2700,2800,"Sub-basin 8"
4830,300,15.008,1200,1500,"Sub-basin 8"
4831,4600,87,12500,17100,"Sub-basin 8"
4832,100,1,500,600,"Sub-basin 8"
4833,100,5,2200,2300,"Sub-basin 8"
4834,200,4,3100,3300,"Sub-basin 8"
4835,100,2,2600,2700,"Sub-basin 8"
4836,200,2,2000,2200,"Sub-basin 8"
4837,400,27,5600,6000,"Sub-basin 8"
4838,900,35,11700,12600,"Sub-basin 8"
4839,100,5,300,400,"Sub-basin 8"
4840,700,29,4200,4900,"Sub-basin 8"
4841,300,6,600,900,"Sub-basin 8"
4842,100,2.0024,2200,2300,"Sub-basin 8"
4843,2300,826,7500,9800,"Sub-basin 8"
4844,200,5,1400,1600,"Sub-basin 8"
4845,200,6,1000,1200,"Sub-basin 8"
4846,200,3,2000,2200,"Sub-basin 8"
4847,100,3,1800,1900,"Sub-basin 8"
4848,1600,109,11800,13400,"Sub-basin 8"
4849,100,1.0035,1000,1100,"Sub-basin 8"
4850,900,68,3000,3900,"Sub-basin 8"
4851,100,3.0022,1500,1600,"Sub-basin 8"
4852,200,3,1000,1200,"Sub-basin 8"
4853,600,67,2900,3500,"Sub-basin 8"
4854,100,4,800,900,"Sub-basin 8"
4855,500,25,4100,4600,"Sub-basin 8"
4856,100,1,1100,1200,"Sub-basin 8"
4857,800,24,9800,10600,"Sub-basin 8"
4858,100,1,1000,1100,"Sub-basin 8"
4859,200,2,500,700,"Sub-basin 8"
4860,100,2,1000,1100,"Sub-basin 8"
4861,500,15,8100,8600,"Sub-basin 8"
4862,100,1,2200,2300,"Sub-basin 8"
4863,100,2,1200,1300,"Sub-basin 8"
4864,1100,18,3900,5000,"Sub-basin 8"
4865,200,8,3800,4000,"Sub-basin 8"
4866,100,3,1600,1700,"Sub-basin 8"
4867,1200,67.0661,18900,20100,"Sub-basin 8"
4868,300,4,800,1100,"Sub-basin 8"
4869,100,2,600,700,"Sub-basin 8"
4870,1000,149,5300,6300,"Sub-basin 8"
4871,200,3,1600,1800,"Sub-basin 8"
4872,400,15,1100,1500,"Sub-basin 8"
4873,2600,204,7300,9900,"Sub-basin 8"
4874,400,7,7700,8100,"Sub-basin 8"
4875,1700,237,17600,19300,"Sub-basin 8"
4876,400,6,3000,3400,"Sub-basin 8"
4877,100,3,1300,1400,"Sub-basin 8"
4878,400,6,700,1100,"Sub-basin 8"
4879,100,3,900,1000,"Sub-basin 8"
4880,100,1,300,400,"Sub-basin 8"
4881,1200,77,5800,7000,"Sub-basin 8"
4882,2300,189,11300,13600,"Sub-basin 8"
4883,200,10,1800,2000,"Sub-basin 8"
4884,700,25,9700,10400,"Sub-basin 8"
4885,500,17,9800,10300,"Sub-basin 8"
4886,300,9,2000,2300,"Sub-basin 8"
4887,200,7,1300,1500,"Sub-basin 8"
4888,300,6,1300,1600,"Sub-basin 8"
4889,1900,249,6900,8800,"Sub-basin 8"
4890,200,3,700,900,"Sub-basin 8"
4891,100,1,1600,1700,"Sub-basin 8"
4892,800,25,4500,5300,"Sub-basin 8"
4893,300,15,5800,6100,"Sub-basin 8"
4894,1600,30,6300,7900,"Sub-basin 8"
4895,300,3,500,800,"Sub-basin 8"
4896,100,2,800,900,"Sub-basin 8"
4897,2000,249,7300,9300,"Sub-basin 8"
4898,100,2,2100,2200,"Sub-basin 8"
4899,600,16,4200,4800,"Sub-basin 8"
4900,200,6,800,1000,"Sub-basin 8"
4901,2100,360,5500,7600,"Sub-basin 8"
4902,100,6,1900,2000,"Sub-basin 8"
4903,1000,52,6600,7600,"Sub-basin 8"
4904,100,1,900,1000,"Sub-basin 8"
4905,2500,147,21800,24300,"Sub-basin 8"
4906,100,2,400,500,"Sub-basin 8"
4907,2300,246,7300,9600,"Sub-basin 8"
4908,100,2,2700,2800,"Sub-basin 8"
4909,200,3,2700,2900,"Sub-basin 8"
4910,100,2,2100,2200,"Sub-basin 8"
4911,600,28,6300,6900,"Sub-basin 8"
4912,100,1.0046,2300,2400,"Sub-basin 8"
4913,100,1,1000,1100,"Sub-basin 8"
4914,1700,101,5000,6700,"Sub-basin 8"
4915,300,10,1700,2000,"Sub-basin 8"
4916,500,18,2200,2700,"Sub-basin 8"
4917,800,68,6000,6800,"Sub-basin 8"
4918,1100,107,6800,7900,"Sub-basin 8"
4919,800,86,3400,4200,"Sub-basin 8"
4920,1900,86,16000,17900,"Sub-basin 8"
4921,200,6,2500,2700,"Sub-basin 8"
4922,300,8,4700,5000,"Sub-basin 8"
4923,200,5,2500,2700,"Sub-basin 8"
4924,200,6,4300,4500,"Sub-basin 8"
4925,100,1,900,1000,"Sub-basin 8"
4926,700,23.0262,5400,6100,"Sub-basin 8"
4927,1600,81.0813,13700,15300,"Sub-basin 8"
4928,1200,97,11200,12400,"Sub-basin 8"
4929,100,1,1200,1300,"Sub-basin 8"
4930,100,2,2100,2200,"Sub-basin 8"
4931,1300,129,7400,8700,"Sub-basin 8"
4932,400,13,4000,4400,"Sub-basin 8"
4933,100,4,400,500,"Sub-basin 8"
4934,400,12,2900,3300,"Sub-basin 8"
4935,200,10,3100,3300,"Sub-basin 8"
4936,100,3,2200,2300,"Sub-basin 8"
4937,500,77,3200,3700,"Sub-basin 8"
4938,200,6,2400,2600,"Sub-basin 8"
4939,400,15,6600,7000,"Sub-basin 8"
4940,200,11,900,1100,"Sub-basin 8"
4941,2000,298,8200,10200,"Sub-basin 8"
4942,300,8,3500,3800,"Sub-basin 8"
4943,200,10,1000,1200,"Sub-basin 8"
4944,200,4,3800,4000,"Sub-basin 8"
4945,100,3.0016,700,800,"Sub-basin 8"
4946,100,2,1300,1400,"Sub-basin 8"
4947,100,3,600,700,"Sub-basin 8"
4948,1400,60,10500,11900,"Sub-basin 8"
4949,300,11,5300,5600,"Sub-basin 8"
4950,100,6,800,900,"Sub-basin 8"
4951,100,2,1200,1300,"Sub-basin 8"
4952,2300,251,9900,12200,"Sub-basin 8"
4953,500,15,5300,5800,"Sub-basin 8"
4954,700,30,3000,3700,"Sub-basin 8"
4955,1500,158,7700,9200,"Sub-basin 8"
4956,200,7,3000,3200,"Sub-basin 8"
4957,100,5,1400,1500,"Sub-basin 8"
4958,300,25,3400,3700,"Sub-basin 8"
4959,1200,221,8200,9400,"Sub-basin 8"
4960,300,19,2600,2900,"Sub-basin 8"
4961,100,2,1300,1400,"Sub-basin 8"
4962,200,2,1400,1600,"Sub-basin 8"
4963,1100,80,7100,8200,"Sub-basin 8"
4964,1500,144,9700,11200,"Sub-basin 8"
4965,1000,112,4100,5100,"Sub-basin 8"
4966,400,12,2900,3300,"Sub-basin 8"
4967,100,3,1700,1800,"Sub-basin 8"
4968,300,22,2700,3000,"Sub-basin 8"
4969,500,36,4900,5400,"Sub-basin 8"
4970,500,12,5100,5600,"Sub-basin 8"
4971,100,2,1800,1900,"Sub-basin 8"
4972,200,59,1500,1700,"Sub-basin 8"
4973,700,29.1315,4200,4900,"Sub-basin 8"
4974,100,2,1300,1400,"Sub-basin 8"
4975,1200,70,4400,5600,"Sub-basin 8"
4976,300,10,2300,2600,"Sub-basin 8"
4977,1000,50,15900,16900,"Sub-basin 8"
4978,400,10,5900,6300,"Sub-basin 8"
4979,100,1,700,800,"Sub-basin 8"
4980,200,11,600,800,"Sub-basin 8"
4981,300,19,5200,5500,"Sub-basin 8"
4982,300,12,4400,4700,"Sub-basin 8"
4983,300,10,3600,3900,"Sub-basin 8"
4984,1000,71,5600,6600,"Sub-basin 8"
4985,100,2,1700,1800,"Sub-basin 8"
4986,200,8,1500,1700,"Sub-basin 8"
4987,100,1,500,600,"Sub-basin 8"
4988,100,1,3400,3500,"Sub-basin 8"
4989,200,3,1300,1500,"Sub-basin 8"
4990,100,1,1400,1500,"Sub-basin 8"
4991,700,51,7000,7700,"Sub-basin 8"
4992,1000,101,9800,10800,"Sub-basin 8"
4993,300,15,900,1200,"Sub-basin 8"
4994,100,2,500,600,"Sub-basin 8"
4995,500,15,2200,2700,"Sub-basin 8"
4996,400,10,4600,5000,"Sub-basin 8"
4997,800,75,1500,2300,"Sub-basin 8"
4998,100,2,500,600,"Sub-basin 8"
4999,600,24,4400,5000,"Sub-basin 8"
5000,400,22,3900,4300,"Sub-basin 8"
5001,100,1,1100,1200,"Sub-basin 8"
5002,100,1,1100,1200,"Sub-basin 8"
5003,200,5,3200,3400,"Sub-basin 8"
5004,500,40,3700,4200,"Sub-basin 8"
5005,300,15,1300,1600,"Sub-basin 8"
5006,100,1,800,900,"Sub-basin 8"
5007,26100,7506.9294,113900,140000,"Sub-basin 8"
5008,100,2,800,900,"Sub-basin 8"
5009,200,2,1200,1400,"Sub-basin 8"
5010,200,16,3100,3300,"Sub-basin 8"
5011,300,16,1200,1500,"Sub-basin 8"
5012,100,1,2800,2900,"Sub-basin 8"
5013,100,1,1400,1500,"Sub-basin 8"
5014,1500,513,5700,7200,"Sub-basin 8"
5015,200,2,1500,1700,"Sub-basin 8"
5016,100,2,1100,1200,"Sub-basin 8"
5017,700,41,6000,6700,"Sub-basin 8"
5018,400,36,4500,4900,"Sub-basin 8"
5019,100,4,1600,1700,"Sub-basin 8"
5020,300,15,3200,3500,"Sub-basin 8"
5021,100,9,1500,1600,"Sub-basin 8"
5022,500,61,2500,3000,"Sub-basin 8"
5023,600,62,1800,2400,"Sub-basin 8"
5024,100,8,700,800,"Sub-basin 8"
5025,100,1,1600,1700,"Sub-basin 8"
5026,500,23,4200,4700,"Sub-basin 8"
5027,400,31,2300,2700,"Sub-basin 8"
5028,1400,318,11100,12500,"Sub-basin 8"
5029,100,4,900,1000,"Sub-basin 8"
5030,800,37,8000,8800,"Sub-basin 8"
5031,400,9,3300,3700,"Sub-basin 8"
5032,200,7,2600,2800,"Sub-basin 8"
5033,100,2,1400,1500,"Sub-basin 8"
5034,1200,131,3500,4700,"Sub-basin 8"
5035,300,14,900,1200,"Sub-basin 8"
5036,1200,161,11700,12900,"Sub-basin 8"
5037,200,6,2500,2700,"Sub-basin 8"
5038,2400,345,20100,22500,"Sub-basin 8"
5039,100,3,2900,3000,"Sub-basin 8"
5040,100,1,1000,1100,"Sub-basin 8"
5041,200,6,2500,2700,"Sub-basin 8"
5042,1000,40,4300,5300,"Sub-basin 8"
5043,100,2,1600,1700,"Sub-basin 8"
5044,100,3,2300,2400,"Sub-basin 8"
5045,200,7,3800,4000,"Sub-basin 8"
5046,2000,247,13500,15500,"Sub-basin 8"
5047,500,36,5200,5700,"Sub-basin 8"
5048,800,39,7400,8200,"Sub-basin 8"
5049,100,1,2300,2400,"Sub-basin 8"
5050,1600,464,8300,9900,"Sub-basin 8"
5051,100,3,1400,1500,"Sub-basin 8"
5052,200,5,1700,1900,"Sub-basin 8"
5053,400,10,2800,3200,"Sub-basin 8"
5054,200,2,1200,1400,"Sub-basin 8"
5055,5400,721.17,26200,31600,"Sub-basin 8"
5056,300,8,2700,3000,"Sub-basin 8"
5057,100,4,900,1000,"Sub-basin 8"
5058,100,1,1700,1800,"Sub-basin 8"
5059,400,19,1900,2300,"Sub-basin 8"
5060,2600,315.33,18400,21000,"Sub-basin 8"
5061,100,2,1100,1200,"Sub-basin 8"
5062,1900,170,20900,22800,"Sub-basin 8"
5063,100,1,1700,1800,"Sub-basin 8"
5064,100,2,1300,1400,"Sub-basin 8"
5065,100,2,2200,2300,"Sub-basin 8"
5066,500,30.66,1400,1900,"Sub-basin 8"
5067,100,1,1600,1700,"Sub-basin 8"
5068,100,1,1700,1800,"Sub-basin 8"
5069,8700,3611,19800,28500,"Sub-basin 8"
5070,400,26,3200,3600,"Sub-basin 8"
5071,100,1,1300,1400,"Sub-basin 8"
5072,500,17,4900,5400,"Sub-basin 8"
5073,300,7,2800,3100,"Sub-basin 8"
5074,800,30,5100,5900,"Sub-basin 8"
5075,600,145,2400,3000,"Sub-basin 8"
5076,800,119,2900,3700,"Sub-basin 8"
5077,100,3,2000,2100,"Sub-basin 8"
5078,700,20,3700,4400,"Sub-basin 8"
5079,600,42,7100,7700,"Sub-basin 8"
5080,100,1,1600,1700,"Sub-basin 8"
5081,200,5,2500,2700,"Sub-basin 8"
5082,100,4,2400,2500,"Sub-basin 8"
5083,300,10,4000,4300,"Sub-basin 8"
5084,400,44,1000,1400,"Sub-basin 8"
5085,100,4,2100,2200,"Sub-basin 8"
5086,400,8,5400,5800,"Sub-basin 8"
5087,400,12,4400,4800,"Sub-basin 8"
5088,100,1,3900,4000,"Sub-basin 8"
5089,100,1,1900,2000,"Sub-basin 8"
5090,100,1,1900,2000,"Sub-basin 8"
5091,800,128,3600,4400,"Sub-basin 8"
5092,200,4,1300,1500,"Sub-basin 8"
5093,200,3,4600,4800,"Sub-basin 8"
5094,300,4,4400,4700,"Sub-basin 8"
5095,900,46,10900,11800,"Sub-basin 8"
5096,500,17,4500,5000,"Sub-basin 8"
5097,600,39,2900,3500,"Sub-basin 8"
5098,1400,74,14800,16200,"Sub-basin 8"
5099,100,4,1600,1700,"Sub-basin 8"
5100,100,1,1700,1800,"Sub-basin 8"
5101,1800,108,11200,13000,"Sub-basin 8"
5102,200,4,1600,1800,"Sub-basin 8"
5103,1000,135,2900,3900,"Sub-basin 8"
5104,600,32,3800,4400,"Sub-basin 8"
5105,200,7,1500,1700,"Sub-basin 8"
5106,400,12,6600,7000,"Sub-basin 8"
5107,100,1,1400,1500,"Sub-basin 8"
5108,1100,83,2100,3200,"Sub-basin 8"
5109,100,6,200,300,"Sub-basin 8"
5110,100,3,1300,1400,"Sub-basin 8"
5111,500,26,3200,3700,"Sub-basin 8"
5112,300,6,4300,4600,"Sub-basin 8"
5113,100,1,700,800,"Sub-basin 8"
5114,100,2,1600,1700,"Sub-basin 8"
5115,400,13,6500,6900,"Sub-basin 8"
5116,1800,162,2700,4500,"Sub-basin 8"
5117,200,2,1900,2100,"Sub-basin 8"
5118,100,1,1700,1800,"Sub-basin 8"
5119,600,37,1200,1800,"Sub-basin 8"
5120,100,1,2600,2700,"Sub-basin 8"
5121,100,2,4200,4300,"Sub-basin 8"
5122,300,19,2300,2600,"Sub-basin 8"
5123,1100,50,6800,7900,"Sub-basin 8"
5124,16500,1217,63800,80300,"Sub-basin 8"
5125,100,1,1900,2000,"Sub-basin 8"
5126,100,1,1400,1500,"Sub-basin 8"
5127,500,16,4000,4500,"Sub-basin 8"
5128,200,6,1600,1800,"Sub-basin 8"
5129,200,2,2100,2300,"Sub-basin 8"
5130,200,12,2700,2900,"Sub-basin 8"
5131,900,76,5000,5900,"Sub-basin 8"
5132,1100,91,5900,7000,"Sub-basin 8"
5133,200,14,400,600,"Sub-basin 8"
5134,400,8,2100,2500,"Sub-basin 8"
5135,500,25,3800,4300,"Sub-basin 8"
5136,900,41,7900,8800,"Sub-basin 8"
5137,100,1.0001,1000,1100,"Sub-basin 8"
5138,1400,72,22100,23500,"Sub-basin 8"
5139,100,3,2700,2800,"Sub-basin 8"
5140,100,2,3000,3100,"Sub-basin 8"
5141,12100,1542,69300,81400,"Sub-basin 8"
5142,1200,77,7500,8700,"Sub-basin 8"
5143,800,68,4100,4900,"Sub-basin 8"
5144,8600,1690,21400,30000,"Sub-basin 8"
5145,500,21,6000,6500,"Sub-basin 8"
5146,400,7.0605,5400,5800,"Sub-basin 8"
5147,5400,948,9200,14600,"Sub-basin 8"
5148,1300,47.0861,28500,29800,"Sub-basin 8"
5149,800,61,3000,3800,"Sub-basin 8"
5150,100,2,1700,1800,"Sub-basin 8"
5151,600,16,7700,8300,"Sub-basin 8"
5152,100,3,1700,1800,"Sub-basin 8"
5153,300,10,4000,4300,"Sub-basin 8"
5154,300,20,2000,2300,"Sub-basin 8"
5155,100,2,800,900,"Sub-basin 8"
5156,100,1,1400,1500,"Sub-basin 8"
5157,400,12,2700,3100,"Sub-basin 8"
5158,300,13,2700,3000,"Sub-basin 8"
5159,100,1,1500,1600,"Sub-basin 8"
5160,200,8,1000,1200,"Sub-basin 8"
5161,300,43,2200,2500,"Sub-basin 8"
5162,600,57,2500,3100,"Sub-basin 8"
5163,17800,7703,29700,47500,"Sub-basin 8"
5164,100,1,2500,2600,"Sub-basin 8"
5165,200,15,1700,1900,"Sub-basin 8"
5166,100,1,900,1000,"Sub-basin 8"
5167,100,1,600,700,"Sub-basin 8"
5168,400,14,1300,1700,"Sub-basin 8"
5169,200,11,1200,1400,"Sub-basin 8"
5170,100,1,1200,1300,"Sub-basin 8"
5171,400,11,3000,3400,"Sub-basin 8"
5172,400,15,2200,2600,"Sub-basin 8"
5173,2700,746,7300,10000,"Sub-basin 8"
5174,100,1,1000,1100,"Sub-basin 8"
5175,1000,31,5700,6700,"Sub-basin 8"
5176,400,11,3000,3400,"Sub-basin 8"
5177,200,17.0029,3800,4000,"Sub-basin 8"
5178,100,1,500,600,"Sub-basin 8"
5179,200,4,5300,5500,"Sub-basin 8"
5180,800,38,4000,4800,"Sub-basin 8"
5181,200,6,1000,1200,"Sub-basin 8"
5182,200,5,1900,2100,"Sub-basin 8"
5183,1600,96,5600,7200,"Sub-basin 8"
5184,100,2,3100,3200,"Sub-basin 8"
5185,100,1,1400,1500,"Sub-basin 8"
5186,100,6,1300,1400,"Sub-basin 8"
5187,900,258,2400,3300,"Sub-basin 8"
5188,200,12,1400,1600,"Sub-basin 8"
5189,200,4,1900,2100,"Sub-basin 8"
5190,800,61.0301,16700,17500,"Sub-basin 8"
5191,200,4,900,1100,"Sub-basin 8"
5192,300,8,2800,3100,"Sub-basin 8"
5193,400,12,2500,2900,"Sub-basin 8"
5194,400,35,900,1300,"Sub-basin 8"
5195,400,28,2100,2500,"Sub-basin 8"
5196,300,23,1500,1800,"Sub-basin 8"
5197,3700,1571,6300,10000,"Sub-basin 8"
5198,200,5,2400,2600,"Sub-basin 8"
5199,100,2,1100,1200,"Sub-basin 8"
5200,100,2,700,800,"Sub-basin 8"
5201,400,10,4500,4900,"Sub-basin 8"
5202,1100,163,3800,4900,"Sub-basin 8"
5203,200,3,1200,1400,"Sub-basin 8"
5204,200,5,3400,3600,"Sub-basin 8"
5205,200,8,2000,2200,"Sub-basin 8"
5206,600,86,2100,2700,"Sub-basin 8"
5207,3500,1208,5600,9100,"Sub-basin 8"
5208,1000,420,3500,4500,"Sub-basin 8"
5209,100,1,800,900,"Sub-basin 8"
5210,600,56,2300,2900,"Sub-basin 8"
5211,300,6,1900,2200,"Sub-basin 8"
5212,100,2,800,900,"Sub-basin 8"
5213,500,22,3500,4000,"Sub-basin 8"
5214,100,4,1400,1500,"Sub-basin 8"
5215,200,7,1400,1600,"Sub-basin 8"
5216,100,1,600,700,"Sub-basin 8"
5217,6900,911,24900,31800,"Sub-basin 8"
5218,10000,1379,17900,27900,"Sub-basin 8"
5219,1700,203,4400,6100,"Sub-basin 8"
5220,1500,115,9800,11300,"Sub-basin 8"
5221,300,19.1705,7700,8000,"Sub-basin 8"
5222,100,4,1300,1400,"Sub-basin 8"
5223,600,46,2200,2800,"Sub-basin 8"
5224,100,5.0541,3700,3800,"Sub-basin 8"
5225,600,48,2800,3400,"Sub-basin 8"
5226,700,145,2400,3100,"Sub-basin 8"
5227,200,5,1200,1400,"Sub-basin 8"
5228,200,8,1700,1900,"Sub-basin 8"
5229,400,11,300,700,"Sub-basin 8"
5230,200,5,2600,2800,"Sub-basin 8"
5231,3600,1399,6500,10100,"Sub-basin 8"
5232,11100,2265.4828,207100,218200,"Sub-basin 8"
5233,100,6,400,500,"Sub-basin 8"
5234,100,2,1600,1700,"Sub-basin 8"
5235,500,66,1200,1700,"Sub-basin 8"
5236,300,8,3500,3800,"Sub-basin 8"
5237,700,78,4300,5000,"Sub-basin 8"
5238,200,3,700,900,"Sub-basin 8"
5239,400,13,3300,3700,"Sub-basin 8"
5240,1900,341,3900,5800,"Sub-basin 8"
5241,16200,2562.33,32100,48300,"Sub-basin 8"
5242,25600,13285,27500,53100,"Sub-basin 8"
5243,2900,791,5500,8400,"Sub-basin 8"
5244,100,3,700,800,"Sub-basin 8"
5245,300,37,2300,2600,"Sub-basin 8"
5246,1400,324,2800,4200,"Sub-basin 8"
5247,400,21,800,1200,"Sub-basin 8"
5248,100,1,900,1000,"Sub-basin 8"
5249,600,62,2900,3500,"Sub-basin 8"
5250,2300,772,5200,7500,"Sub-basin 8"
5251,700,62,2300,3000,"Sub-basin 8"
5252,700,172,1200,1900,"Sub-basin 8"
5253,600,50,2200,2800,"Sub-basin 8"
5254,500,22,5300,5800,"Sub-basin 8"
5255,1500,101,10500,12000,"Sub-basin 8"
5256,3300,327,12100,15400,"Sub-basin 8"
5257,400,14,5000,5400,"Sub-basin 8"
5258,2400,467,4900,7300,"Sub-basin 8"
5259,700,36,4400,5100,"Sub-basin 8"
5260,200,9,800,1000,"Sub-basin 8"
5261,1700,350,6800,8500,"Sub-basin 8"
5262,100,1,900,1000,"Sub-basin 8"
5263,100,4,400,500,"Sub-basin 8"
5264,5400,1429,10200,15600,"Sub-basin 8"
5265,300,14,2200,2500,"Sub-basin 8"
5266,700,26,1800,2500,"Sub-basin 8"
5267,200,12,3300,3500,"Sub-basin 8"
5268,600,23,5600,6200,"Sub-basin 8"
5269,3700,1373,5400,9100,"Sub-basin 8"
5270,400,29,1500,1900,"Sub-basin 8"
5271,200,4,3300,3500,"Sub-basin 8"
5272,600,490,2200,2800,"Sub-basin 8"
5273,100,1,1700,1800,"Sub-basin 8"
5274,200,40,1300,1500,"Sub-basin 8"
5275,4300,854,15600,19900,"Sub-basin 8"
5276,2100,211,10600,12700,"Sub-basin 8"
5277,200,4,1500,1700,"Sub-basin 8"
5278,3000,481,15500,18500,"Sub-basin 8"
5279,1100,85,7700,8800,"Sub-basin 8"
5280,400,39,1100,1500,"Sub-basin 8"
5281,100,1,2400,2500,"Sub-basin 8"
5282,100,3,2700,2800,"Sub-basin 8"
5283,1200,200,6600,7800,"Sub-basin 8"
5284,1000,260,3000,4000,"Sub-basin 8"
5285,100,2,900,1000,"Sub-basin 8"
5286,200,6,600,800,"Sub-basin 8"
5287,100,5,700,800,"Sub-basin 8"
5288,400,18,2100,2500,"Sub-basin 8"
5289,600,141,1400,2000,"Sub-basin 8"
5290,100,1,600,700,"Sub-basin 8"
5291,200,4,2900,3100,"Sub-basin 8"
5292,2000,334,6800,8800,"Sub-basin 8"
5293,600,40,3100,3700,"Sub-basin 8"
5294,2000,197,9800,11800,"Sub-basin 8"
5295,8600,4577,14400,23000,"Sub-basin 8"
5296,1700,336,3400,5100,"Sub-basin 8"
5297,500,32,5400,5900,"Sub-basin 8"
5298,1700,194,4900,6600,"Sub-basin 8"
5299,600,75,2800,3400,"Sub-basin 8"
5300,100,3,900,1000,"Sub-basin 8"
5301,100,4,1800,1900,"Sub-basin 8"
5302,200,9,1500,1700,"Sub-basin 8"
5303,800,77,2100,2900,"Sub-basin 8"
5304,200,5,600,800,"Sub-basin 8"
5305,100,3,1300,1400,"Sub-basin 8"
5306,300,34,1500,1800,"Sub-basin 8"
5307,6400,2338,12500,18900,"Sub-basin 8"
5308,2000,436,5800,7800,"Sub-basin 8"
5309,200,7,2800,3000,"Sub-basin 8"
5310,400,51,4200,4600,"Sub-basin 8"
5311,2300,171,12500,14800,"Sub-basin 8"
5312,100,1,900,1000,"Sub-basin 8"
5313,2800,758,6200,9000,"Sub-basin 8"
5314,100,1,500,600,"Sub-basin 8"
5315,1000,52,5000,6000,"Sub-basin 8"
5316,2300,348,4800,7100,"Sub-basin 8"
5317,1800,486,2400,4200,"Sub-basin 8"
5318,800,396,2300,3100,"Sub-basin 8"
5319,300,8,4900,5200,"Sub-basin 8"
5320,100,1,1500,1600,"Sub-basin 8"
5321,800,146,1900,2700,"Sub-basin 8"
5322,100,2,1100,1200,"Sub-basin 8"
5323,100,6,2100,2200,"Sub-basin 8"
5324,1400,183,4500,5900,"Sub-basin 8"
5325,500,54,3000,3500,"Sub-basin 8"
5326,100,1,900,1000,"Sub-basin 8"
5327,100,3,1500,1600,"Sub-basin 8"
5328,1400,534,2000,3400,"Sub-basin 8"
5329,200,5,3200,3400,"Sub-basin 8"
5330,700,27,2500,3200,"Sub-basin 8"
5331,400,14,2600,3000,"Sub-basin 8"
5332,200,3,1400,1600,"Sub-basin 8"
5333,2000,645,5400,7400,"Sub-basin 8"
5334,3200,1537,4000,7200,"Sub-basin 8"
5335,100,1,600,700,"Sub-basin 8"
5336,500,120,2400,2900,"Sub-basin 8"
5337,100,2,2200,2300,"Sub-basin 8"
5338,2300,719,2900,5200,"Sub-basin 8"
5339,1700,82,14800,16500,"Sub-basin 8"
5340,400,22,1900,2300,"Sub-basin 8"
5341,1900,195,7100,9000,"Sub-basin 8"
5342,600,55,2100,2700,"Sub-basin 8"
5343,1200,307,6800,8000,"Sub-basin 8"
5344,800,19,7300,8100,"Sub-basin 8"
5345,500,10,3700,4200,"Sub-basin 8"
5346,800,51,6700,7500,"Sub-basin 8"
5347,1000,147,2800,3800,"Sub-basin 8"
5348,400,10,6900,7300,"Sub-basin 8"
5349,200,8,3800,4000,"Sub-basin 8"
5350,100,1,1700,1800,"Sub-basin 8"
5351,100,2,1200,1300,"Sub-basin 8"
5352,600,48,2100,2700,"Sub-basin 8"
5353,200,15,500,700,"Sub-basin 8"
5354,400,49,2800,3200,"Sub-basin 8"
5355,100,2,1200,1300,"Sub-basin 8"
5356,5200,2005,13400,18600,"Sub-basin 8"
5357,4700,2082,9100,13800,"Sub-basin 8"
5358,200,3,1100,1300,"Sub-basin 8"
5359,300,5,2100,2400,"Sub-basin 8"
5360,900,74,6400,7300,"Sub-basin 8"
5361,100,3,300,400,"Sub-basin 8"
5362,100,2,500,600,"Sub-basin 8"
5363,1900,105,22700,24600,"Sub-basin 8"
5364,100,3,1300,1400,"Sub-basin 8"
5365,1200,193,3900,5100,"Sub-basin 8"
5366,700,227,2500,3200,"Sub-basin 8"
5367,400,18,2100,2500,"Sub-basin 8"
5368,100,9,1100,1200,"Sub-basin 8"
5369,100,5,200,300,"Sub-basin 8"
5370,1900,137,8900,10800,"Sub-basin 8"
5371,1800,371,3600,5400,"Sub-basin 8"
5372,1400,437,2400,3800,"Sub-basin 8"
5373,700,161,1900,2600,"Sub-basin 8"
5374,1300,196.21,12700,14000,"Sub-basin 8"
5375,9700,956.17,21300,31000,"Sub-basin 8"
5376,800,67,700,1500,"Sub-basin 8"
5377,900,166,2200,3100,"Sub-basin 8"
5378,100,3,2300,2400,"Sub-basin 8"
5379,1900,494,5900,7800,"Sub-basin 8"
5380,700,36,9300,10000,"Sub-basin 8"
5381,1200,74,4200,5400,"Sub-basin 8"
5382,100,1,2000,2100,"Sub-basin 8"
5383,3800,1101.67,12500,16300,"Sub-basin 8"
5384,100,2,800,900,"Sub-basin 8"
5385,1000,70.34,7800,8800,"Sub-basin 8"
5386,200,4,1100,1300,"Sub-basin 8"
5387,700,53,8100,8800,"Sub-basin 8"
5388,100,1,1900,2000,"Sub-basin 8"
5389,300,7.99,3200,3500,"Sub-basin 8"
5390,400,20,4700,5100,"Sub-basin 8"
5391,300,17,2300,2600,"Sub-basin 8"
5392,200,3,3300,3500,"Sub-basin 8"
5393,4500,515.5,32100,36600,"Sub-basin 8"
5394,1600,340.33,6400,8000,"Sub-basin 8"
5395,1800,109,16900,18700,"Sub-basin 8"
5396,100,3,2900,3000,"Sub-basin 8"
5397,100,1,3300,3400,"Sub-basin 8"
5398,900,117,4800,5700,"Sub-basin 8"
5399,100,2,3400,3500,"Sub-basin 8"
5400,100,2,2200,2300,"Sub-basin 8"
5401,200,4,5300,5500,"Sub-basin 8"
5402,2800,380,14900,17700,"Sub-basin 8"
5403,600,49,4400,5000,"Sub-basin 8"
5404,200,3,3600,3800,"Sub-basin 8"
5405,500,9,6700,7200,"Sub-basin 8"
5406,2300,123,7000,9300,"Sub-basin 8"
5407,2700,268,11100,13800,"Sub-basin 8"
5408,500,19,5700,6200,"Sub-basin 8"
5409,200,24,3700,3900,"Sub-basin 8"
5410,600,121,4900,5500,"Sub-basin 8"
5411,100,5,1600,1700,"Sub-basin 8"
5412,200,2,3800,4000,"Sub-basin 8"
5413,400,24,4400,4800,"Sub-basin 8"
5414,200,2,3100,3300,"Sub-basin 8"
5415,200,4,4200,4400,"Sub-basin 8"
5416,100,4,1100,1200,"Sub-basin 8"
5417,200,7,700,900,"Sub-basin 8"
5418,600,72,3400,4000,"Sub-basin 8"
5419,500,33,5300,5800,"Sub-basin 8"
5420,100,1,2300,2400,"Sub-basin 8"
5421,700,32,10900,11600,"Sub-basin 8"
5422,500,58,5600,6100,"Sub-basin 8"
5423,100,4,2300,2400,"Sub-basin 8"
5424,100,3,800,900,"Sub-basin 8"
5425,100,1,1200,1300,"Sub-basin 8"
5426,500,91,1900,2400,"Sub-basin 8"
5427,200,6,3100,3300,"Sub-basin 8"
5428,600,31,2600,3200,"Sub-basin 8"
5429,100,3,2200,2300,"Sub-basin 8"
5430,100,3,2200,2300,"Sub-basin 8"
5431,100,4,3100,3200,"Sub-basin 8"
5432,400,27,2500,2900,"Sub-basin 8"
5433,100,1,1000,1100,"Sub-basin 8"
5434,1100,78,6900,8000,"Sub-basin 8"
5435,100,1,3300,3400,"Sub-basin 8"
5436,300,15,3400,3700,"Sub-basin 8"
5437,400,118,1300,1700,"Sub-basin 8"
5438,100,1,2300,2400,"Sub-basin 8"
5439,100,1,700,800,"Sub-basin 8"
5440,100,1,900,1000,"Sub-basin 8"
5441,100,4,1300,1400,"Sub-basin 8"
5442,100,1,2800,2900,"Sub-basin 8"
5443,200,2,3100,3300,"Sub-basin 8"
5444,400,18,3900,4300,"Sub-basin 8"
5445,300,19,4000,4300,"Sub-basin 8"
5446,500,23,2000,2500,"Sub-basin 8"
5447,300,7,2900,3200,"Sub-basin 8"
5448,200,4,800,1000,"Sub-basin 8"
5449,900,118,3300,4200,"Sub-basin 8"
5450,2200,306,10200,12400,"Sub-basin 8"
5451,100,4,1800,1900,"Sub-basin 8"
5452,300,4,5200,5500,"Sub-basin 8"
5453,200,6,3000,3200,"Sub-basin 8"
5454,200,5,1900,2100,"Sub-basin 8"
5455,600,52,3300,3900,"Sub-basin 8"
5456,100,6,1300,1400,"Sub-basin 8"
5457,1500,73,19200,20700,"Sub-basin 8"
5458,300,7,2400,2700,"Sub-basin 8"
5459,200,9,3500,3700,"Sub-basin 8"
5460,200,20,3000,3200,"Sub-basin 8"
5461,200,3,4500,4700,"Sub-basin 8"
5462,400,16,4700,5100,"Sub-basin 8"
5463,1000,67,6400,7400,"Sub-basin 8"
5464,100,1,0,100,"Sub-basin 8"
5465,400,20,5500,5900,"Sub-basin 8"
5466,200,7,3900,4100,"Sub-basin 8"
5467,7500,766,48000,55500,"Sub-basin 8"
5468,300,16,2100,2400,"Sub-basin 8"
5469,700,26,5300,6000,"Sub-basin 8"
5470,100,1,1300,1400,"Sub-basin 8"
5471,2100,288,7100,9200,"Sub-basin 8"
5472,1000,79,5900,6900,"Sub-basin 8"
5473,100,2,3000,3100,"Sub-basin 8"
5474,100,2,1800,1900,"Sub-basin 8"
5475,100,2,3300,3400,"Sub-basin 8"
5476,100,1,4200,4300,"Sub-basin 8"
5477,3700,535,18900,22600,"Sub-basin 8"
5478,100,1,700,800,"Sub-basin 8"
5479,500,63,2200,2700,"Sub-basin 8"
5480,100,1,1000,1100,"Sub-basin 8"
5481,300,8.0086,7400,7700,"Sub-basin 8"
5482,100,3.0015,3800,3900,"Sub-basin 8"
5483,300,10,6900,7200,"Sub-basin 8"
5484,400,12,1400,1800,"Sub-basin 8"
5485,500,19,3000,3500,"Sub-basin 8"
5486,100,1.0021,4400,4500,"Sub-basin 8"
5487,300,7,4600,4900,"Sub-basin 8"
5488,4600,588,19200,23800,"Sub-basin 8"
5489,100,3,1700,1800,"Sub-basin 8"
5490,3300,275,35500,38800,"Sub-basin 8"
5491,200,2,2800,3000,"Sub-basin 8"
5492,200,7,2500,2700,"Sub-basin 8"
5493,200,4,5000,5200,"Sub-basin 8"
5494,200,7,6100,6300,"Sub-basin 8"
5495,500,18.0168,14000,14500,"Sub-basin 8"
5496,200,7.0061,4800,5000,"Sub-basin 8"
5497,600,39,4600,5200,"Sub-basin 8"
5498,1100,156,5000,6100,"Sub-basin 8"
5499,1100,165,7600,8700,"Sub-basin 8"
5500,100,1,1200,1300,"Sub-basin 8"
5501,300,4.0105,10700,11000,"Sub-basin 8"
5502,100,3,4500,4600,"Sub-basin 8"
5503,200,2,1100,1300,"Sub-basin 8"
5504,2800,255,12400,15200,"Sub-basin 8"
5505,200,9,1500,1700,"Sub-basin 8"
5506,300,13.0108,10200,10500,"Sub-basin 8"
5507,200,3,3400,3600,"Sub-basin 8"
5508,200,6,3100,3300,"Sub-basin 8"
5509,1600,317,3700,5300,"Sub-basin 8"
5510,400,20,3700,4100,"Sub-basin 8"
5511,100,1.002,4800,4900,"Sub-basin 8"
5512,200,7,2000,2200,"Sub-basin 8"
5513,400,24,7200,7600,"Sub-basin 8"
5514,100,4,1600,1700,"Sub-basin 8"
5515,100,3,1600,1700,"Sub-basin 8"
5516,100,1,1200,1300,"Sub-basin 8"
5517,100,2,1500,1600,"Sub-basin 8"
5518,100,1,2600,2700,"Sub-basin 8"
5519,200,4.006,9200,9400,"Sub-basin 8"
5520,300,5,2300,2600,"Sub-basin 8"
5521,300,43,900,1200,"Sub-basin 8"
5522,600,30,5200,5800,"Sub-basin 8"
5523,100,2,2500,2600,"Sub-basin 8"
5524,3600,491,10800,14400,"Sub-basin 8"
5525,200,2,9500,9700,"Sub-basin 8"
5526,500,17,6300,6800,"Sub-basin 8"
5527,700,54,3300,4000,"Sub-basin 8"
5528,2700,315,10100,12800,"Sub-basin 8"
5529,300,17,2400,2700,"Sub-basin 8"
5530,400,10.0194,11000,11400,"Sub-basin 8"
5531,100,1,1800,1900,"Sub-basin 8"
5532,100,1,1200,1300,"Sub-basin 8"
5533,1300,151,9200,10500,"Sub-basin 8"
5534,1000,159,5700,6700,"Sub-basin 8"
5535,600,21,8800,9400,"Sub-basin 8"
5536,300,3,1600,1900,"Sub-basin 8"
5537,100,2,1700,1800,"Sub-basin 8"
5538,100,1.002,2900,3000,"Sub-basin 8"
5539,200,5,2500,2700,"Sub-basin 8"
5540,700,54,3600,4300,"Sub-basin 8"
5541,400,17,1500,1900,"Sub-basin 8"
5542,100,3.0029,5300,5400,"Sub-basin 8"
5543,100,2,1400,1500,"Sub-basin 8"
5544,3300,661,12600,15900,"Sub-basin 8"
5545,100,3,3900,4000,"Sub-basin 8"
5546,100,1,1800,1900,"Sub-basin 8"
5547,100,1,3000,3100,"Sub-basin 8"
5548,100,3.0016,4400,4500,"Sub-basin 8"
5549,100,1,1700,1800,"Sub-basin 8"
5550,200,7,1200,1400,"Sub-basin 8"
5551,100,1,400,500,"Sub-basin 8"
5552,700,74,2600,3300,"Sub-basin 8"
5553,100,1,1300,1400,"Sub-basin 8"
5554,100,1,1400,1500,"Sub-basin 8"
5555,700,25,10700,11400,"Sub-basin 8"
5556,500,11,5500,6000,"Sub-basin 8"
5557,1000,85,4200,5200,"Sub-basin 8"
5558,9500,902,27600,37100,"Sub-basin 8"
5559,700,38,800,1500,"Sub-basin 8"
5560,1000,70.0593,27500,28500,"Sub-basin 8"
5561,2200,580,16400,18600,"Sub-basin 8"
5562,100,1,1600,1700,"Sub-basin 8"
5563,200,10,5900,6100,"Sub-basin 8"
5564,200,10,4800,5000,"Sub-basin 8"
5565,100,4,200,300,"Sub-basin 8"
5566,1900,168,7300,9200,"Sub-basin 8"
5567,100,1,600,700,"Sub-basin 8"
5568,200,4,3800,4000,"Sub-basin 8"
5569,100,1,2100,2200,"Sub-basin 8"
5570,100,1,300,400,"Sub-basin 8"
5571,100,1,1500,1600,"Sub-basin 8"
5572,600,40,9900,10500,"Sub-basin 8"
5573,100,3,2200,2300,"Sub-basin 8"
5574,2100,209,4900,7000,"Sub-basin 8"
5575,600,27,5600,6200,"Sub-basin 8"
5576,100,1,1700,1800,"Sub-basin 8"
5577,100,1,700,800,"Sub-basin 8"
5578,100,17,400,500,"Sub-basin 8"
5579,1600,100,15800,17400,"Sub-basin 8"
5580,200,10,5700,5900,"Sub-basin 8"
5581,200,8,4500,4700,"Sub-basin 8"
5582,13400,671,25500,38900,"Sub-basin 8"
5583,200,5,3700,3900,"Sub-basin 8"
5584,100,4,2700,2800,"Sub-basin 8"
5585,1000,56,11000,12000,"Sub-basin 8"
5586,900,146,10800,11700,"Sub-basin 8"
5587,100,4,1400,1500,"Sub-basin 8"
5588,200,5,4000,4200,"Sub-basin 8"
5589,600,164,4100,4700,"Sub-basin 8"
5590,100,1,700,800,"Sub-basin 8"
5591,600,175,1700,2300,"Sub-basin 8"
5592,200,4,2800,3000,"Sub-basin 8"
5593,100,2,1000,1100,"Sub-basin 8"
5594,300,32,5700,6000,"Sub-basin 8"
5595,300,17,2000,2300,"Sub-basin 8"
5596,100,2,200,300,"Sub-basin 8"
5597,300,53,2200,2500,"Sub-basin 8"
5598,200,67,2300,2500,"Sub-basin 8"
5599,100,3,3000,3100,"Sub-basin 8"
5600,100,4,900,1000,"Sub-basin 8"
5601,100,3,700,800,"Sub-basin 8"
5602,100,4,900,1000,"Sub-basin 8"
5603,400,66,2600,3000,"Sub-basin 8"
5604,100,4,2300,2400,"Sub-basin 8"
5605,200,7,5000,5200,"Sub-basin 8"
5606,300,17,4700,5000,"Sub-basin 8"
5607,200,4,2100,2300,"Sub-basin 8"
5608,3700,281,9200,12900,"Sub-basin 8"
5609,100,2,3400,3500,"Sub-basin 8"
5610,300,40.0108,8900,9200,"Sub-basin 8"
5611,200,20,4600,4800,"Sub-basin 8"
5612,1500,379,12100,13600,"Sub-basin 8"
5613,200,5,2100,2300,"Sub-basin 8"
5614,1200,140,4200,5400,"Sub-basin 8"
5615,1200,302,4600,5800,"Sub-basin 8"
5616,900,103,1700,2600,"Sub-basin 8"
5617,100,14,4400,4500,"Sub-basin 8"
5618,100,9,2700,2800,"Sub-basin 8"
5619,500,26,3200,3700,"Sub-basin 8"
5620,900,47,5900,6800,"Sub-basin 8"
5621,100,1,1900,2000,"Sub-basin 8"
5622,500,71,8200,8700,"Sub-basin 8"
5623,100,4,1000,1100,"Sub-basin 8"
5624,100,1,1100,1200,"Sub-basin 8"
5625,200,5,1200,1400,"Sub-basin 8"
5626,100,13,900,1000,"Sub-basin 8"
5627,200,5,2600,2800,"Sub-basin 8"
5628,700,97,2900,3600,"Sub-basin 8"
5629,400,12,1300,1700,"Sub-basin 8"
5630,100,1,1200,1300,"Sub-basin 8"
5631,100,1,800,900,"Sub-basin 8"
5632,900,48,2000,2900,"Sub-basin 8"
5633,100,6.0024,3700,3800,"Sub-basin 8"
5634,800,102,7700,8500,"Sub-basin 8"
5635,100,6,400,500,"Sub-basin 8"
5636,2500,301,8000,10500,"Sub-basin 8"
5637,200,3,1600,1800,"Sub-basin 8"
5638,3200,1118,4500,7700,"Sub-basin 8"
5639,200,10,2300,2500,"Sub-basin 8"
5640,4000,1268,9100,13100,"Sub-basin 8"
5641,600,62,3100,3700,"Sub-basin 8"
5642,1000,297,1700,2700,"Sub-basin 8"
5643,500,52,2100,2600,"Sub-basin 8"
5644,600,71,4700,5300,"Sub-basin 8"
5645,500,12,4200,4700,"Sub-basin 8"
5646,8100,2298,17500,25600,"Sub-basin 8"
5647,600,134,3500,4100,"Sub-basin 8"
5648,300,41,800,1100,"Sub-basin 8"
5649,2300,258,5100,7400,"Sub-basin 8"
5650,200,8,600,800,"Sub-basin 8"
5651,200,12.0062,6200,6400,"Sub-basin 8"
5652,54500,11197.16,52700,107200,"Sub-basin 8"
5653,100,4,200,300,"Sub-basin 8"
5654,1400,414,2500,3900,"Sub-basin 8"
5655,400,48,3100,3500,"Sub-basin 8"
5656,100,3,800,900,"Sub-basin 8"
5657,2100,1057,3900,6000,"Sub-basin 8"
5658,500,102,1200,1700,"Sub-basin 8"
5659,100,2,600,700,"Sub-basin 8"
5660,100,2.001,1900,2000,"Sub-basin 8"
5661,4700,1917,6000,10700,"Sub-basin 8"
5662,400,19,1700,2100,"Sub-basin 8"
5663,300,11.0084,6700,7000,"Sub-basin 8"
5664,100,3,1800,1900,"Sub-basin 8"
5665,200,17,1800,2000,"Sub-basin 8"
5666,19700,11122,16000,35700,"Sub-basin 8"
5667,900,131,3000,3900,"Sub-basin 8"
5668,8600,3453,8400,17000,"Sub-basin 8"
5669,600,139,2300,2900,"Sub-basin 8"
5670,100,1.0013,3600,3700,"Sub-basin 8"
5671,400,34,1700,2100,"Sub-basin 8"
5672,200,8,2500,2700,"Sub-basin 8"
5673,3600,1032,3100,6700,"Sub-basin 8"
5674,700,58,2500,3200,"Sub-basin 8"
5675,8100,2034,8400,16500,"Sub-basin 8"
5676,200,14,1500,1700,"Sub-basin 8"
5677,300,21.0084,7900,8200,"Sub-basin 8"
5678,500,46,1000,1500,"Sub-basin 8"
5679,2400,878,3700,6100,"Sub-basin 8"
5680,200,16,400,600,"Sub-basin 8"
5681,400,17,3100,3500,"Sub-basin 8"
5682,4100,1880,5400,9500,"Sub-basin 8"
5683,400,11.0169,9000,9400,"Sub-basin 8"
5684,200,4,1600,1800,"Sub-basin 8"
5685,600,27,4500,5100,"Sub-basin 8"
5686,100,1,300,400,"Sub-basin 8"
5687,100,1,1400,1500,"Sub-basin 8"
5688,700,68,1400,2100,"Sub-basin 8"
5689,1100,81,3400,4500,"Sub-basin 8"
5690,6200,1552,9600,15800,"Sub-basin 8"
5691,10000,3475,14800,24800,"Sub-basin 8"
5692,600,37.0138,9200,9800,"Sub-basin 8"
5693,4000,506,7300,11300,"Sub-basin 8"
5694,17900,10604.84,15500,33400,"Sub-basin 8"
5695,36800,9879.16,26000,62800,"Sub-basin 8"
5696,300,15,2700,3000,"Sub-basin 8"
5697,30300,12845.83,28400,58700,"Sub-basin 8"
5698,2300,474,4900,7200,"Sub-basin 8"
5699,1200,100,2800,4000,"Sub-basin 8"
5700,200,7,3100,3300,"Sub-basin 8"
5701,100,2.0028,3100,3200,"Sub-basin 8"
5702,200,7,700,900,"Sub-basin 8"
5703,100,2,500,600,"Sub-basin 8"
5704,900,210,2200,3100,"Sub-basin 8"
5705,300,14,600,900,"Sub-basin 8"
5706,100,4.0024,3100,3200,"Sub-basin 8"
5707,100,8.0025,2600,2700,"Sub-basin 8"
5708,600,74,2300,2900,"Sub-basin 8"
5709,1400,348.66,3600,5000,"Sub-basin 8"
5710,200,11.0046,4900,5100,"Sub-basin 8"
5711,7300,1686,10900,18200,"Sub-basin 8"
5712,400,27,1700,2100,"Sub-basin 8"
5713,100,3.0017,3700,3800,"Sub-basin 8"
5714,300,16,1800,2100,"Sub-basin 8"
5715,1700,797,3300,5000,"Sub-basin 8"
5716,2100,340,3600,5700,"Sub-basin 8"
5717,4300,2011,15200,19500,"Sub-basin 8"
5718,2200,959,5600,7800,"Sub-basin 8"
5719,200,3.0084,4900,5100,"Sub-basin 8"
5720,200,7,1500,1700,"Sub-basin 8"
5721,200,20.0048,3300,3500,"Sub-basin 8"
5722,2400,506,2800,5200,"Sub-basin 8"
5723,25000,5335,31600,56600,"Sub-basin 8"
5724,700,94,2000,2700,"Sub-basin 8"
5725,3800,573,5300,9100,"Sub-basin 8"
5726,600,75,7100,7700,"Sub-basin 8"
5727,100,3.0019,1500,1600,"Sub-basin 8"
5728,200,8,1200,1400,"Sub-basin 8"
5729,3500,913,4200,7700,"Sub-basin 8"
5730,2700,693,5700,8400,"Sub-basin 8"
5731,300,29,1100,1400,"Sub-basin 8"
5732,5600,1638,8500,14100,"Sub-basin 8"
5733,100,11.0024,2300,2400,"Sub-basin 8"
5734,200,12,800,1000,"Sub-basin 8"
5735,4100,1487,6000,10100,"Sub-basin 8"
5736,600,135,2000,2600,"Sub-basin 8"
5737,100,5.0024,2300,2400,"Sub-basin 8"
5738,900,202,5500,6400,"Sub-basin 8"
5739,600,90,1100,1700,"Sub-basin 8"
5740,400,27,900,1300,"Sub-basin 8"
5741,8500,4352,6000,14500,"Sub-basin 8"
5742,600,225,1300,1900,"Sub-basin 8"
5743,1600,149,11100,12700,"Sub-basin 8"
5744,300,22,600,900,"Sub-basin 8"
5745,3400,566,6900,10300,"Sub-basin 8"
5746,200,10,100,300,"Sub-basin 8"
5747,900,128,2300,3200,"Sub-basin 8"
5748,200,2.0056,3600,3800,"Sub-basin 8"
5749,2000,86.122,9100,11100,"Sub-basin 8"
5750,1900,374,6100,8000,"Sub-basin 8"
5751,300,43,1000,1300,"Sub-basin 8"
5752,100,5,500,600,"Sub-basin 8"
5753,700,142,1200,1900,"Sub-basin 8"
5754,1100,231,1100,2200,"Sub-basin 8"
1,100,3,700,800,"Sub-basin 9"
2,200,13,400,600,"Sub-basin 9"
3,2400,642,7000,9400,"Sub-basin 9"
4,5200,2020,6300,11500,"Sub-basin 9"
5,700,25,3500,4200,"Sub-basin 9"
6,1500,268,2600,4100,"Sub-basin 9"
7,100,13,300,400,"Sub-basin 9"
8,300,21,600,900,"Sub-basin 9"
9,100,2,300,400,"Sub-basin 9"
10,2400,240,12800,15200,"Sub-basin 9"
11,42600,11063,51900,94500,"Sub-basin 9"
12,1100,106,4600,5700,"Sub-basin 9"
13,1100,173,1800,2900,"Sub-basin 9"
14,14900,2702,21800,36700,"Sub-basin 9"
15,3700,951,9800,13500,"Sub-basin 9"
16,500,63,1600,2100,"Sub-basin 9"
17,1000,58,3700,4700,"Sub-basin 9"
18,800,75,3200,4000,"Sub-basin 9"
19,1000,104,2300,3300,"Sub-basin 9"
20,14500,5971,19600,34100,"Sub-basin 9"
21,10400,4103,17900,28300,"Sub-basin 9"
22,2700,524,6700,9400,"Sub-basin 9"
23,200,9,300,500,"Sub-basin 9"
24,500,101,1400,1900,"Sub-basin 9"
25,2500,207,7600,10100,"Sub-basin 9"
26,100,1,600,700,"Sub-basin 9"
27,1900,244,6200,8100,"Sub-basin 9"
28,1100,294,1300,2400,"Sub-basin 9"
29,26200,10158,24600,50800,"Sub-basin 9"
30,100,6,800,900,"Sub-basin 9"
31,1700,325,2900,4600,"Sub-basin 9"
32,300,17,1400,1700,"Sub-basin 9"
33,300,37,1600,1900,"Sub-basin 9"
34,600,99,2000,2600,"Sub-basin 9"
35,300,8,2500,2800,"Sub-basin 9"
36,100,2,1600,1700,"Sub-basin 9"
37,10100,3506,8300,18400,"Sub-basin 9"
38,400,19,600,1000,"Sub-basin 9"
39,200,3,1900,2100,"Sub-basin 9"
40,800,49,2100,2900,"Sub-basin 9"
41,300,9,2300,2600,"Sub-basin 9"
42,2300,356,17000,19300,"Sub-basin 9"
43,700,20,4500,5200,"Sub-basin 9"
44,1400,203,4000,5400,"Sub-basin 9"
45,4500,683,20100,24600,"Sub-basin 9"
46,1100,118,4500,5600,"Sub-basin 9"
47,300,10,1900,2200,"Sub-basin 9"
48,500,62,1600,2100,"Sub-basin 9"
49,2400,1104,4200,6600,"Sub-basin 9"
50,1000,246,3500,4500,"Sub-basin 9"
51,500,20,1300,1800,"Sub-basin 9"
52,700,53,900,1600,"Sub-basin 9"
53,400,45,2700,3100,"Sub-basin 9"
54,2200,999,4000,6200,"Sub-basin 9"
55,1100,73,3800,4900,"Sub-basin 9"
56,300,6,2000,2300,"Sub-basin 9"
57,200,6,2700,2900,"Sub-basin 9"
58,1900,370,3500,5400,"Sub-basin 9"
59,8800,4884,8200,17000,"Sub-basin 9"
60,1800,331,4800,6600,"Sub-basin 9"
61,5100,2626,7100,12200,"Sub-basin 9"
62,100,1,700,800,"Sub-basin 9"
63,400,11,1200,1600,"Sub-basin 9"
64,400,37,1300,1700,"Sub-basin 9"
65,200,4,2300,2500,"Sub-basin 9"
66,2700,651,4600,7300,"Sub-basin 9"
67,600,220,1000,1600,"Sub-basin 9"
68,600,126,1600,2200,"Sub-basin 9"
69,500,33,3300,3800,"Sub-basin 9"
70,1700,719,5300,7000,"Sub-basin 9"
71,600,37,2300,2900,"Sub-basin 9"
72,1200,291,2600,3800,"Sub-basin 9"
73,300,24,1900,2200,"Sub-basin 9"
74,1100,94,5300,6400,"Sub-basin 9"
75,5200,1600,7500,12700,"Sub-basin 9"
76,1800,167,3800,5600,"Sub-basin 9"
77,100,1,1300,1400,"Sub-basin 9"
78,100,4,1000,1100,"Sub-basin 9"
79,6700,3093,8600,15300,"Sub-basin 9"
80,200,2,500,700,"Sub-basin 9"
81,300,44,900,1200,"Sub-basin 9"
82,200,11,1500,1700,"Sub-basin 9"
83,200,2,900,1100,"Sub-basin 9"
84,300,9,3200,3500,"Sub-basin 9"
85,200,5,3400,3600,"Sub-basin 9"
86,900,37,13900,14800,"Sub-basin 9"
87,1800,417,6800,8600,"Sub-basin 9"
88,700,34,2500,3200,"Sub-basin 9"
89,400,42,2800,3200,"Sub-basin 9"
90,400,11,2600,3000,"Sub-basin 9"
91,2000,496,8200,10200,"Sub-basin 9"
92,600,69,1300,1900,"Sub-basin 9"
93,4000,1217,9300,13300,"Sub-basin 9"
94,200,3,700,900,"Sub-basin 9"
95,800,92,1500,2300,"Sub-basin 9"
96,3200,1069,4700,7900,"Sub-basin 9"
97,800,156,2400,3200,"Sub-basin 9"
98,1000,49,4100,5100,"Sub-basin 9"
99,100,2,900,1000,"Sub-basin 9"
100,600,17,7200,7800,"Sub-basin 9"
101,800,38,9800,10600,"Sub-basin 9"
102,800,113,5300,6100,"Sub-basin 9"
103,1100,165,7400,8500,"Sub-basin 9"
104,400,26,1300,1700,"Sub-basin 9"
105,100,2,1300,1400,"Sub-basin 9"
106,1500,594,2100,3600,"Sub-basin 9"
107,200,3,1300,1500,"Sub-basin 9"
108,1900,486,2800,4700,"Sub-basin 9"
109,600,17,4600,5200,"Sub-basin 9"
110,7800,2761,15200,23000,"Sub-basin 9"
111,100,1,1500,1600,"Sub-basin 9"
112,400,12,4300,4700,"Sub-basin 9"
113,800,272,3100,3900,"Sub-basin 9"
114,1000,197,1200,2200,"Sub-basin 9"
115,1600,432,4900,6500,"Sub-basin 9"
116,300,28,3000,3300,"Sub-basin 9"
117,200,5,3100,3300,"Sub-basin 9"
118,400,16,4100,4500,"Sub-basin 9"
119,300,18,5400,5700,"Sub-basin 9"
120,2900,1075,4900,7800,"Sub-basin 9"
121,1200,389,2200,3400,"Sub-basin 9"
122,300,12,1300,1600,"Sub-basin 9"
123,100,3,600,700,"Sub-basin 9"
124,400,122,1600,2000,"Sub-basin 9"
125,400,65,1400,1800,"Sub-basin 9"
126,600,27,5800,6400,"Sub-basin 9"
127,700,58,4900,5600,"Sub-basin 9"
128,100,2,500,600,"Sub-basin 9"
129,400,64,3700,4100,"Sub-basin 9"
130,300,15,2700,3000,"Sub-basin 9"
131,9700,1236.5,52300,62000,"Sub-basin 9"
132,600,18,7400,8000,"Sub-basin 9"
133,100,4,1200,1300,"Sub-basin 9"
134,800,99,3200,4000,"Sub-basin 9"
135,700,29,9800,10500,"Sub-basin 9"
136,500,30,4200,4700,"Sub-basin 9"
137,400,46,4100,4500,"Sub-basin 9"
138,3100,1578,4200,7300,"Sub-basin 9"
139,17400,7886,23200,40600,"Sub-basin 9"
140,2300,916,6700,9000,"Sub-basin 9"
141,1600,330,9000,10600,"Sub-basin 9"
142,1800,321,2800,4600,"Sub-basin 9"
143,100,2,1500,1600,"Sub-basin 9"
144,200,7,2600,2800,"Sub-basin 9"
145,200,23,3100,3300,"Sub-basin 9"
146,100,3,500,600,"Sub-basin 9"
147,1300,352,5000,6300,"Sub-basin 9"
148,2400,139,13200,15600,"Sub-basin 9"
149,200,9,2800,3000,"Sub-basin 9"
150,100,2,1100,1200,"Sub-basin 9"
151,300,11,400,700,"Sub-basin 9"
152,400,13,800,1200,"Sub-basin 9"
153,600,17,4600,5200,"Sub-basin 9"
154,200,12,900,1100,"Sub-basin 9"
155,13700,5608,12700,26400,"Sub-basin 9"
156,100,2,1100,1200,"Sub-basin 9"
157,3500,1102,5700,9200,"Sub-basin 9"
158,100,1,800,900,"Sub-basin 9"
159,2200,655,7400,9600,"Sub-basin 9"
160,400,40,5400,5800,"Sub-basin 9"
161,300,35,2000,2300,"Sub-basin 9"
162,300,4,6400,6700,"Sub-basin 9"
163,100,3,800,900,"Sub-basin 9"
164,4200,579,23400,27600,"Sub-basin 9"
165,1300,121,3800,5100,"Sub-basin 9"
166,500,12,8200,8700,"Sub-basin 9"
167,600,63,2000,2600,"Sub-basin 9"
168,100,6,1400,1500,"Sub-basin 9"
169,100,1,1800,1900,"Sub-basin 9"
170,900,39,13800,14700,"Sub-basin 9"
171,100,4,1200,1300,"Sub-basin 9"
172,7600,3456,8100,15700,"Sub-basin 9"
173,100,1,300,400,"Sub-basin 9"
174,1300,149,6500,7800,"Sub-basin 9"
175,900,77,4900,5800,"Sub-basin 9"
176,200,11,2700,2900,"Sub-basin 9"
177,11000,1963,23800,34800,"Sub-basin 9"
178,200,8,700,900,"Sub-basin 9"
179,100,1,500,600,"Sub-basin 9"
180,200,7,600,800,"Sub-basin 9"
181,3800,501,7900,11700,"Sub-basin 9"
182,300,14,3200,3500,"Sub-basin 9"
183,100,3,600,700,"Sub-basin 9"
184,200,3,1700,1900,"Sub-basin 9"
185,300,25,2100,2400,"Sub-basin 9"
186,6100,1416,17500,23600,"Sub-basin 9"
187,100,2,500,600,"Sub-basin 9"
188,800,98,3800,4600,"Sub-basin 9"
189,700,19,19700,20400,"Sub-basin 9"
190,400,25,2800,3200,"Sub-basin 9"
191,100,2,1900,2000,"Sub-basin 9"
192,700,41,2900,3600,"Sub-basin 9"
193,100,2,1600,1700,"Sub-basin 9"
194,600,114,1700,2300,"Sub-basin 9"
195,300,12,2700,3000,"Sub-basin 9"
196,2700,349,5300,8000,"Sub-basin 9"
197,600,115,2000,2600,"Sub-basin 9"
198,400,10,2700,3100,"Sub-basin 9"
199,700,28,1200,1900,"Sub-basin 9"
200,100,2,600,700,"Sub-basin 9"
201,100,1,800,900,"Sub-basin 9"
202,200,13,1300,1500,"Sub-basin 9"
203,100,6,1300,1400,"Sub-basin 9"
204,600,80,3900,4500,"Sub-basin 9"
205,2200,790,4500,6700,"Sub-basin 9"
206,1500,485,3900,5400,"Sub-basin 9"
207,2400,619,6400,8800,"Sub-basin 9"
208,200,7,3600,3800,"Sub-basin 9"
209,200,5,1300,1500,"Sub-basin 9"
210,400,11,4300,4700,"Sub-basin 9"
211,100,1,900,1000,"Sub-basin 9"
212,100,1,600,700,"Sub-basin 9"
213,200,11,1200,1400,"Sub-basin 9"
214,600,35,1600,2200,"Sub-basin 9"
215,300,9,11400,11700,"Sub-basin 9"
216,1100,205,5200,6300,"Sub-basin 9"
217,400,19,2800,3200,"Sub-basin 9"
218,900,54,4500,5400,"Sub-basin 9"
219,300,10,2700,3000,"Sub-basin 9"
220,100,2,1100,1200,"Sub-basin 9"
221,300,16,3200,3500,"Sub-basin 9"
222,400,97,2000,2400,"Sub-basin 9"
223,200,8,2000,2200,"Sub-basin 9"
224,300,13,2200,2500,"Sub-basin 9"
225,3000,1032,7800,10800,"Sub-basin 9"
226,1700,507.33,8100,9800,"Sub-basin 9"
227,800,22,3000,3800,"Sub-basin 9"
228,3200,324,14400,17600,"Sub-basin 9"
229,12100,4081,16400,28500,"Sub-basin 9"
230,300,45,2100,2400,"Sub-basin 9"
231,100,3,0,100,"Sub-basin 9"
232,400,10,2600,3000,"Sub-basin 9"
233,400,56,2500,2900,"Sub-basin 9"
234,1300,192,4800,6100,"Sub-basin 9"
235,100,2,600,700,"Sub-basin 9"
236,900,72,5700,6600,"Sub-basin 9"
237,200,4,1500,1700,"Sub-basin 9"
238,300,9,1700,2000,"Sub-basin 9"
239,2900,574,24100,27000,"Sub-basin 9"
240,1400,484,4700,6100,"Sub-basin 9"
241,100,3,1800,1900,"Sub-basin 9"
242,6500,1917,10200,16700,"Sub-basin 9"
243,5900,1064,10700,16600,"Sub-basin 9"
244,800,292,6200,7000,"Sub-basin 9"
245,7100,2132,14200,21300,"Sub-basin 9"
246,100,4,1000,1100,"Sub-basin 9"
247,14500,2588,53500,68000,"Sub-basin 9"
248,100,10,1200,1300,"Sub-basin 9"
249,600,38,7600,8200,"Sub-basin 9"
250,2300,478,5400,7700,"Sub-basin 9"
251,100,2,600,700,"Sub-basin 9"
252,400,9,3600,4000,"Sub-basin 9"
253,1400,172,2200,3600,"Sub-basin 9"
254,400,20,2600,3000,"Sub-basin 9"
255,400,20,1400,1800,"Sub-basin 9"
256,600,39,1900,2500,"Sub-basin 9"
257,200,7,2200,2400,"Sub-basin 9"
258,100,1,2100,2200,"Sub-basin 9"
259,500,13,17500,18000,"Sub-basin 9"
260,1400,415,3000,4400,"Sub-basin 9"
261,2800,494,4400,7200,"Sub-basin 9"
262,200,5,1100,1300,"Sub-basin 9"
263,100,2,300,400,"Sub-basin 9"
264,100,1,2600,2700,"Sub-basin 9"
265,2100,553,3700,5800,"Sub-basin 9"
266,1100,301,2300,3400,"Sub-basin 9"
267,300,5,1200,1500,"Sub-basin 9"
268,2300,709,3600,5900,"Sub-basin 9"
269,1900,201,5600,7500,"Sub-basin 9"
270,200,3,1700,1900,"Sub-basin 9"
271,700,48,2300,3000,"Sub-basin 9"
272,100,1,1300,1400,"Sub-basin 9"
273,1000,111,4200,5200,"Sub-basin 9"
274,300,4,2700,3000,"Sub-basin 9"
275,2900,612,10000,12900,"Sub-basin 9"
276,1300,90,8900,10200,"Sub-basin 9"
277,4200,507,3800,8000,"Sub-basin 9"
278,500,30,2400,2900,"Sub-basin 9"
279,500,32,2600,3100,"Sub-basin 9"
280,100,3,1000,1100,"Sub-basin 9"
281,2300,206,12400,14700,"Sub-basin 9"
282,1000,122.16,6400,7400,"Sub-basin 9"
283,100,2,3200,3300,"Sub-basin 9"
284,8700,2148,11100,19800,"Sub-basin 9"
285,3400,690,5500,8900,"Sub-basin 9"
286,100,1,600,700,"Sub-basin 9"
287,4100,1081,3900,8000,"Sub-basin 9"
288,200,5,1800,2000,"Sub-basin 9"
289,1600,123,9700,11300,"Sub-basin 9"
290,6600,831,42900,49500,"Sub-basin 9"
291,11400,3138,10500,21900,"Sub-basin 9"
292,900,261,1600,2500,"Sub-basin 9"
293,900,124,2500,3400,"Sub-basin 9"
294,200,2,1600,1800,"Sub-basin 9"
295,1000,64,6000,7000,"Sub-basin 9"
296,100,5,3800,3900,"Sub-basin 9"
297,400,23,2700,3100,"Sub-basin 9"
298,100,1,900,1000,"Sub-basin 9"
299,900,60,7600,8500,"Sub-basin 9"
300,200,4,2100,2300,"Sub-basin 9"
301,15100,6207,19800,34900,"Sub-basin 9"
302,1300,57,3200,4500,"Sub-basin 9"
303,700,77,1800,2500,"Sub-basin 9"
304,200,5,1800,2000,"Sub-basin 9"
305,500,38,5400,5900,"Sub-basin 9"
306,100,3,4400,4500,"Sub-basin 9"
307,100,2,100,200,"Sub-basin 9"
308,1200,360,2700,3900,"Sub-basin 9"
309,700,107,900,1600,"Sub-basin 9"
310,200,13,3100,3300,"Sub-basin 9"
311,2800,819,3100,5900,"Sub-basin 9"
312,600,118,1600,2200,"Sub-basin 9"
313,600,55,1500,2100,"Sub-basin 9"
314,2000,222,3500,5500,"Sub-basin 9"
315,100,1,600,700,"Sub-basin 9"
316,900,71,5800,6700,"Sub-basin 9"
317,100,1,2700,2800,"Sub-basin 9"
318,100,1,4300,4400,"Sub-basin 9"
319,2300,858,4000,6300,"Sub-basin 9"
320,100,4,800,900,"Sub-basin 9"
321,100,5,1000,1100,"Sub-basin 9"
322,100,1,800,900,"Sub-basin 9"
323,900,200,4500,5400,"Sub-basin 9"
324,1300,52,3000,4300,"Sub-basin 9"
325,100,1,900,1000,"Sub-basin 9"
326,100,18,800,900,"Sub-basin 9"
327,100,3,1500,1600,"Sub-basin 9"
328,200,6,2300,2500,"Sub-basin 9"
329,100,2,3000,3100,"Sub-basin 9"
330,1100,235,1400,2500,"Sub-basin 9"
331,300,11,1700,2000,"Sub-basin 9"
332,200,9,200,400,"Sub-basin 9"
333,100,4,600,700,"Sub-basin 9"
334,600,97,5100,5700,"Sub-basin 9"
335,700,65,7500,8200,"Sub-basin 9"
336,400,19,700,1100,"Sub-basin 9"
337,1000,106,3100,4100,"Sub-basin 9"
338,100,5,400,500,"Sub-basin 9"
339,100,8,1000,1100,"Sub-basin 9"
340,700,76,8700,9400,"Sub-basin 9"
341,200,17,4000,4200,"Sub-basin 9"
342,300,5,7400,7700,"Sub-basin 9"
343,600,48,1800,2400,"Sub-basin 9"
344,200,3,2200,2400,"Sub-basin 9"
345,1200,327,2600,3800,"Sub-basin 9"
346,300,19,1300,1600,"Sub-basin 9"
347,300,6,2300,2600,"Sub-basin 9"
348,800,89,9300,10100,"Sub-basin 9"
349,3300,334,10400,13700,"Sub-basin 9"
350,1300,156,3700,5000,"Sub-basin 9"
351,200,9,3800,4000,"Sub-basin 9"
352,3900,1069,5000,8900,"Sub-basin 9"
353,300,43,500,800,"Sub-basin 9"
354,400,18,3100,3500,"Sub-basin 9"
355,1200,93,4400,5600,"Sub-basin 9"
356,100,4,700,800,"Sub-basin 9"
357,600,140,1500,2100,"Sub-basin 9"
358,100,1,2000,2100,"Sub-basin 9"
359,100,12,3200,3300,"Sub-basin 9"
360,200,2,6000,6200,"Sub-basin 9"
361,1600,298,5300,6900,"Sub-basin 9"
362,600,71,11100,11700,"Sub-basin 9"
363,1200,101,2200,3400,"Sub-basin 9"
364,900,26,28400,29300,"Sub-basin 9"
365,500,18,15800,16300,"Sub-basin 9"
366,200,16,5300,5500,"Sub-basin 9"
367,200,18,5000,5200,"Sub-basin 9"
368,200,8,1600,1800,"Sub-basin 9"
369,6600,1961,6900,13500,"Sub-basin 9"
370,4900,670,6400,11300,"Sub-basin 9"
371,1100,98,4300,5400,"Sub-basin 9"
372,4300,663.17,13900,18200,"Sub-basin 9"
373,1900,211,6700,8600,"Sub-basin 9"
374,3200,1980,3400,6600,"Sub-basin 9"
375,1400,561,4400,5800,"Sub-basin 9"
376,400,9,2800,3200,"Sub-basin 9"
377,100,2,3600,3700,"Sub-basin 9"
378,300,13,7800,8100,"Sub-basin 9"
379,100,1,3100,3200,"Sub-basin 9"
380,100,12,3100,3200,"Sub-basin 9"
381,500,21,4200,4700,"Sub-basin 9"
382,600,137,2300,2900,"Sub-basin 9"
383,200,8,2400,2600,"Sub-basin 9"
384,100,5,6100,6200,"Sub-basin 9"
385,100,1,1500,1600,"Sub-basin 9"
386,3300,546,5400,8700,"Sub-basin 9"
387,100,2,1600,1700,"Sub-basin 9"
388,900,40,25000,25900,"Sub-basin 9"
389,400,12,16800,17200,"Sub-basin 9"
390,100,1,5000,5100,"Sub-basin 9"
391,200,4,4300,4500,"Sub-basin 9"
392,100,29,1700,1800,"Sub-basin 9"
393,600,123,11600,12200,"Sub-basin 9"
394,700,74,6700,7400,"Sub-basin 9"
395,1500,347,3700,5200,"Sub-basin 9"
396,1200,155,5100,6300,"Sub-basin 9"
397,600,23,3800,4400,"Sub-basin 9"
398,800,32,2300,3100,"Sub-basin 9"
399,100,1,1000,1100,"Sub-basin 9"
400,1100,254,1900,3000,"Sub-basin 9"
401,500,74,2200,2700,"Sub-basin 9"
402,700,62,11800,12500,"Sub-basin 9"
403,200,8,9400,9600,"Sub-basin 9"
404,100,1,3700,3800,"Sub-basin 9"
405,300,9,2400,2700,"Sub-basin 9"
406,300,7,8000,8300,"Sub-basin 9"
407,500,11,17300,17800,"Sub-basin 9"
408,200,4,6500,6700,"Sub-basin 9"
409,200,40,4000,4200,"Sub-basin 9"
410,1200,454,12600,13800,"Sub-basin 9"
411,100,1,400,500,"Sub-basin 9"
412,200,11,100,300,"Sub-basin 9"
413,3100,437,8600,11700,"Sub-basin 9"
414,4700,485,8200,12900,"Sub-basin 9"
415,100,1,2800,2900,"Sub-basin 9"
416,300,11,4400,4700,"Sub-basin 9"
417,200,3,5700,5900,"Sub-basin 9"
418,100,1,500,600,"Sub-basin 9"
419,5900,1031.5,10400,16300,"Sub-basin 9"
420,800,146,2500,3300,"Sub-basin 9"
421,100,1,3600,3700,"Sub-basin 9"
422,1200,252,14700,15900,"Sub-basin 9"
423,100,2,4500,4600,"Sub-basin 9"
424,100,1,1000,1100,"Sub-basin 9"
425,500,38,2000,2500,"Sub-basin 9"
426,100,2,1600,1700,"Sub-basin 9"
427,400,11,4700,5100,"Sub-basin 9"
428,200,5,4800,5000,"Sub-basin 9"
429,100,3,4900,5000,"Sub-basin 9"
430,400,24,2500,2900,"Sub-basin 9"
431,300,24,1800,2100,"Sub-basin 9"
432,200,2,3100,3300,"Sub-basin 9"
433,100,2,3800,3900,"Sub-basin 9"
434,300,5,6400,6700,"Sub-basin 9"
435,800,25,5300,6100,"Sub-basin 9"
436,1900,252,8500,10400,"Sub-basin 9"
437,100,1,4000,4100,"Sub-basin 9"
438,2700,337,4700,7400,"Sub-basin 9"
439,700,92,1700,2400,"Sub-basin 9"
440,2100,1180,4100,6200,"Sub-basin 9"
441,100,2,5800,5900,"Sub-basin 9"
442,100,3,4600,4700,"Sub-basin 9"
443,800,69,10100,10900,"Sub-basin 9"
444,100,1,400,500,"Sub-basin 9"
445,200,12,400,600,"Sub-basin 9"
446,200,8,1300,1500,"Sub-basin 9"
447,2700,749,10700,13400,"Sub-basin 9"
448,5000,1127,27600,32600,"Sub-basin 9"
449,1300,44,39800,41100,"Sub-basin 9"
450,300,19,5900,6200,"Sub-basin 9"
451,1500,52,24300,25800,"Sub-basin 9"
452,600,54,1400,2000,"Sub-basin 9"
453,300,5,8800,9100,"Sub-basin 9"
454,16000,2169,43700,59700,"Sub-basin 9"
455,200,6,700,900,"Sub-basin 9"
456,900,128,2400,3300,"Sub-basin 9"
457,3800,317,11700,15500,"Sub-basin 9"
458,200,2,700,900,"Sub-basin 9"
459,3400,346,5300,8700,"Sub-basin 9"
460,7000,1678,6800,13800,"Sub-basin 9"
461,1200,204,4200,5400,"Sub-basin 9"
462,100,6,700,800,"Sub-basin 9"
463,1100,278,5000,6100,"Sub-basin 9"
464,100,9,2300,2400,"Sub-basin 9"
465,700,48,4300,5000,"Sub-basin 9"
466,500,19,6000,6500,"Sub-basin 9"
467,1800,70,50300,52100,"Sub-basin 9"
468,1200,132,3500,4700,"Sub-basin 9"
469,500,28.67,2900,3400,"Sub-basin 9"
470,100,6,1200,1300,"Sub-basin 9"
471,500,55,3200,3700,"Sub-basin 9"
472,300,5,6000,6300,"Sub-basin 9"
473,100,11,700,800,"Sub-basin 9"
474,4100,553,7400,11500,"Sub-basin 9"
475,2300,372,9400,11700,"Sub-basin 9"
476,7500,3237,14600,22100,"Sub-basin 9"
477,100,2,3500,3600,"Sub-basin 9"
478,300,12,1300,1600,"Sub-basin 9"
479,300,18,3700,4000,"Sub-basin 9"
480,600,38,5100,5700,"Sub-basin 9"
481,500,58,7600,8100,"Sub-basin 9"
482,900,84,7600,8500,"Sub-basin 9"
483,700,132,2500,3200,"Sub-basin 9"
484,100,2,3400,3500,"Sub-basin 9"
485,500,21,3700,4200,"Sub-basin 9"
486,700,68,3900,4600,"Sub-basin 9"
487,800,77,9600,10400,"Sub-basin 9"
488,500,24,10200,10700,"Sub-basin 9"
489,200,3,900,1100,"Sub-basin 9"
490,100,1,1900,2000,"Sub-basin 9"
491,200,5,3300,3500,"Sub-basin 9"
492,100,1,3100,3200,"Sub-basin 9"
493,300,9,8100,8400,"Sub-basin 9"
494,800,92,9700,10500,"Sub-basin 9"
495,700,44,5200,5900,"Sub-basin 9"
496,800,186,6200,7000,"Sub-basin 9"
497,400,19,5900,6300,"Sub-basin 9"
498,400,45,4100,4500,"Sub-basin 9"
499,2900,517,9600,12500,"Sub-basin 9"
500,100,1,1400,1500,"Sub-basin 9"
501,3500,481,23700,27200,"Sub-basin 9"
502,2200,423,3200,5400,"Sub-basin 9"
503,300,12,1100,1400,"Sub-basin 9"
504,1300,110,9700,11000,"Sub-basin 9"
505,200,20,2400,2600,"Sub-basin 9"
506,600,29,23300,23900,"Sub-basin 9"
507,400,35,3200,3600,"Sub-basin 9"
508,400,38,2700,3100,"Sub-basin 9"
509,1100,166,5500,6600,"Sub-basin 9"
510,100,1,800,900,"Sub-basin 9"
511,600,90,2900,3500,"Sub-basin 9"
512,200,4,5500,5700,"Sub-basin 9"
513,100,1,3600,3700,"Sub-basin 9"
514,300,25,3300,3600,"Sub-basin 9"
515,300,27,2300,2600,"Sub-basin 9"
516,100,7,1400,1500,"Sub-basin 9"
517,1200,97,8900,10100,"Sub-basin 9"
518,300,4,2400,2700,"Sub-basin 9"
519,100,1,600,700,"Sub-basin 9"
520,600,53,2800,3400,"Sub-basin 9"
521,500,29,1300,1800,"Sub-basin 9"
522,300,14,2400,2700,"Sub-basin 9"
523,300,10,3900,4200,"Sub-basin 9"
524,300,8,2300,2600,"Sub-basin 9"
525,3200,1529,7800,11000,"Sub-basin 9"
526,1600,299,2200,3800,"Sub-basin 9"
527,7000,2899,9400,16400,"Sub-basin 9"
528,100,1,900,1000,"Sub-basin 9"
529,600,73,2000,2600,"Sub-basin 9"
530,400,42,3800,4200,"Sub-basin 9"
531,200,3,2700,2900,"Sub-basin 9"
532,400,50,2800,3200,"Sub-basin 9"
533,300,7,500,800,"Sub-basin 9"
534,400,18,10300,10700,"Sub-basin 9"
535,900,33,27300,28200,"Sub-basin 9"
536,1500,163,8800,10300,"Sub-basin 9"
537,400,18,5100,5500,"Sub-basin 9"
538,600,27,10100,10700,"Sub-basin 9"
539,100,1,500,600,"Sub-basin 9"
540,2400,321,10500,12900,"Sub-basin 9"
541,300,12,4000,4300,"Sub-basin 9"
542,2100,555,13800,15900,"Sub-basin 9"
543,300,9,1900,2200,"Sub-basin 9"
544,300,10,2800,3100,"Sub-basin 9"
545,200,6,1500,1700,"Sub-basin 9"
546,1600,154,14500,16100,"Sub-basin 9"
547,900,165,9600,10500,"Sub-basin 9"
548,1100,214,4700,5800,"Sub-basin 9"
549,600,29,2900,3500,"Sub-basin 9"
550,1500,106,3900,5400,"Sub-basin 9"
551,900,105,2300,3200,"Sub-basin 9"
552,400,38,4500,4900,"Sub-basin 9"
553,600,43,8000,8600,"Sub-basin 9"
554,400,7,15100,15500,"Sub-basin 9"
555,300,9,1100,1400,"Sub-basin 9"
556,300,9,3300,3600,"Sub-basin 9"
557,300,7,2400,2700,"Sub-basin 9"
558,800,55,6200,7000,"Sub-basin 9"
559,200,9,4800,5000,"Sub-basin 9"
560,1100,113,3800,4900,"Sub-basin 9"
561,2000,448,6900,8900,"Sub-basin 9"
562,300,13,1400,1700,"Sub-basin 9"
563,400,43,2700,3100,"Sub-basin 9"
564,300,17,2400,2700,"Sub-basin 9"
565,400,63,5900,6300,"Sub-basin 9"
566,300,7,4300,4600,"Sub-basin 9"
567,6700,1610,22200,28900,"Sub-basin 9"
568,100,1,600,700,"Sub-basin 9"
569,200,4,1400,1600,"Sub-basin 9"
570,200,5,5900,6100,"Sub-basin 9"
571,2300,381,7100,9400,"Sub-basin 9"
572,11100,1547.5,25000,36100,"Sub-basin 9"
573,400,24,3600,4000,"Sub-basin 9"
574,100,5,300,400,"Sub-basin 9"
575,800,139,11700,12500,"Sub-basin 9"
576,400,9,9700,10100,"Sub-basin 9"
577,1000,100,6200,7200,"Sub-basin 9"
578,1300,290,2800,4100,"Sub-basin 9"
579,100,4,1300,1400,"Sub-basin 9"
580,1000,195,5100,6100,"Sub-basin 9"
581,2600,247,14000,16600,"Sub-basin 9"
582,900,20,22900,23800,"Sub-basin 9"
583,100,2,3900,4000,"Sub-basin 9"
584,400,13,9100,9500,"Sub-basin 9"
585,200,10,1500,1700,"Sub-basin 9"
586,700,110,3000,3700,"Sub-basin 9"
587,100,1,1400,1500,"Sub-basin 9"
588,13600,4675,21300,34900,"Sub-basin 9"
589,1500,150,9400,10900,"Sub-basin 9"
590,100,3,800,900,"Sub-basin 9"
591,900,84,1100,2000,"Sub-basin 9"
592,100,2,2600,2700,"Sub-basin 9"
593,900,160,2100,3000,"Sub-basin 9"
594,800,282,3100,3900,"Sub-basin 9"
595,200,11,1500,1700,"Sub-basin 9"
596,1800,429,4100,5900,"Sub-basin 9"
597,100,2,700,800,"Sub-basin 9"
598,400,15,5800,6200,"Sub-basin 9"
599,1100,179,7100,8200,"Sub-basin 9"
600,100,1,3100,3200,"Sub-basin 9"
601,600,34,2600,3200,"Sub-basin 9"
602,200,8,1300,1500,"Sub-basin 9"
603,4400,753,34800,39200,"Sub-basin 9"
604,600,33,5600,6200,"Sub-basin 9"
605,100,1,3400,3500,"Sub-basin 9"
606,600,27,10900,11500,"Sub-basin 9"
607,1300,193,4400,5700,"Sub-basin 9"
608,300,7,600,900,"Sub-basin 9"
609,2200,561,8400,10600,"Sub-basin 9"
610,100,2,1700,1800,"Sub-basin 9"
611,100,3,1200,1300,"Sub-basin 9"
612,1000,127,2900,3900,"Sub-basin 9"
613,100,1,1400,1500,"Sub-basin 9"
614,4000,719,9300,13300,"Sub-basin 9"
615,4200,951,9300,13500,"Sub-basin 9"
616,200,3,3100,3300,"Sub-basin 9"
617,300,5,9600,9900,"Sub-basin 9"
618,1700,116,8000,9700,"Sub-basin 9"
619,3500,844,7300,10800,"Sub-basin 9"
620,100,4,1000,1100,"Sub-basin 9"
621,200,3,3600,3800,"Sub-basin 9"
622,200,2,6300,6500,"Sub-basin 9"
623,100,3,900,1000,"Sub-basin 9"
624,100,1,400,500,"Sub-basin 9"
625,200,9,2000,2200,"Sub-basin 9"
626,600,44,1700,2300,"Sub-basin 9"
627,400,13,3000,3400,"Sub-basin 9"
628,100,3,2700,2800,"Sub-basin 9"
629,400,24,6600,7000,"Sub-basin 9"
630,200,8,3300,3500,"Sub-basin 9"
631,100,1,2000,2100,"Sub-basin 9"
632,100,4,1300,1400,"Sub-basin 9"
633,1000,88,3200,4200,"Sub-basin 9"
634,500,80,1400,1900,"Sub-basin 9"
635,100,2,700,800,"Sub-basin 9"
636,500,39,2200,2700,"Sub-basin 9"
637,700,49,1200,1900,"Sub-basin 9"
638,400,32,6100,6500,"Sub-basin 9"
639,2100,427,8400,10500,"Sub-basin 9"
640,200,5,1600,1800,"Sub-basin 9"
641,100,5,3700,3800,"Sub-basin 9"
642,2400,254,6800,9200,"Sub-basin 9"
643,1600,131,6100,7700,"Sub-basin 9"
644,200,4,300,500,"Sub-basin 9"
645,500,17,5500,6000,"Sub-basin 9"
646,1400,118,13100,14500,"Sub-basin 9"
647,9300,1539,20300,29600,"Sub-basin 9"
648,200,4,1800,2000,"Sub-basin 9"
649,100,2,1400,1500,"Sub-basin 9"
650,2200,156,21300,23500,"Sub-basin 9"
651,100,2,900,1000,"Sub-basin 9"
652,100,2,900,1000,"Sub-basin 9"
653,1700,329,5400,7100,"Sub-basin 9"
654,500,58,2200,2700,"Sub-basin 9"
655,100,4,600,700,"Sub-basin 9"
656,5700,1401,12000,17700,"Sub-basin 9"
657,300,9,3200,3500,"Sub-basin 9"
658,2500,339,7500,10000,"Sub-basin 9"
659,100,1,900,1000,"Sub-basin 9"
660,1000,178,2100,3100,"Sub-basin 9"
661,100,4,900,1000,"Sub-basin 9"
662,1600,68,4100,5700,"Sub-basin 9"
663,100,3,3000,3100,"Sub-basin 9"
664,100,2,4300,4400,"Sub-basin 9"
665,200,5,4000,4200,"Sub-basin 9"
666,100,7,800,900,"Sub-basin 9"
667,400,41,1700,2100,"Sub-basin 9"
668,1300,122,4200,5500,"Sub-basin 9"
669,100,2,3300,3400,"Sub-basin 9"
670,7400,2134,14200,21600,"Sub-basin 9"
671,300,9,3600,3900,"Sub-basin 9"
672,200,6,1900,2100,"Sub-basin 9"
673,100,2,1200,1300,"Sub-basin 9"
674,100,1,1400,1500,"Sub-basin 9"
675,300,9,900,1200,"Sub-basin 9"
676,100,1,600,700,"Sub-basin 9"
677,100,3,3600,3700,"Sub-basin 9"
678,200,2,1200,1400,"Sub-basin 9"
679,800,134,2200,3000,"Sub-basin 9"
680,100,1,7300,7400,"Sub-basin 9"
681,2000,300,5700,7700,"Sub-basin 9"
682,600,45,2800,3400,"Sub-basin 9"
683,900,133,3000,3900,"Sub-basin 9"
684,400,33,2100,2500,"Sub-basin 9"
685,900,152,2100,3000,"Sub-basin 9"
686,100,1,3200,3300,"Sub-basin 9"
687,1000,299,3100,4100,"Sub-basin 9"
688,400,9,1700,2100,"Sub-basin 9"
689,100,3,1600,1700,"Sub-basin 9"
690,100,6,2000,2100,"Sub-basin 9"
691,100,1,1200,1300,"Sub-basin 9"
692,1100,160,3700,4800,"Sub-basin 9"
693,5500,2106,10400,15900,"Sub-basin 9"
694,1000,157,2200,3200,"Sub-basin 9"
695,1100,195,2400,3500,"Sub-basin 9"
696,100,2,1000,1100,"Sub-basin 9"
697,1200,168,4700,5900,"Sub-basin 9"
698,900,60,24400,25300,"Sub-basin 9"
699,1000,113,1700,2700,"Sub-basin 9"
700,2700,469,6700,9400,"Sub-basin 9"
701,200,21,2100,2300,"Sub-basin 9"
702,1900,184,6800,8700,"Sub-basin 9"
703,3300,1009,4600,7900,"Sub-basin 9"
704,400,9,18200,18600,"Sub-basin 9"
705,100,1,5600,5700,"Sub-basin 9"
706,100,2,900,1000,"Sub-basin 9"
707,1600,615,2100,3700,"Sub-basin 9"
708,400,29,1600,2000,"Sub-basin 9"
709,1800,134,76500,78300,"Sub-basin 9"
710,100,1,4700,4800,"Sub-basin 9"
711,1300,113,35700,37000,"Sub-basin 9"
712,200,10,2700,2900,"Sub-basin 9"
713,100,1,900,1000,"Sub-basin 9"
714,600,110,2400,3000,"Sub-basin 9"
715,200,10,500,700,"Sub-basin 9"
716,1400,209,4700,6100,"Sub-basin 9"
717,600,47,3400,4000,"Sub-basin 9"
718,600,70,4100,4700,"Sub-basin 9"
719,200,2,5800,6000,"Sub-basin 9"
720,100,4,2600,2700,"Sub-basin 9"
721,100,4,1700,1800,"Sub-basin 9"
722,400,34,2500,2900,"Sub-basin 9"
723,200,4,1500,1700,"Sub-basin 9"
724,900,190,1000,1900,"Sub-basin 9"
725,600,103,1700,2300,"Sub-basin 9"
726,600,228,1800,2400,"Sub-basin 9"
727,100,2,2900,3000,"Sub-basin 9"
728,1200,78,39200,40400,"Sub-basin 9"
729,100,1,2200,2300,"Sub-basin 9"
730,500,50,6500,7000,"Sub-basin 9"
731,600,95,1100,1700,"Sub-basin 9"
732,4000,1099,5900,9900,"Sub-basin 9"
733,300,5,10700,11000,"Sub-basin 9"
734,700,100,2000,2700,"Sub-basin 9"
735,500,37.67,19400,19900,"Sub-basin 9"
736,500,22,4400,4900,"Sub-basin 9"
737,6300,807,15100,21400,"Sub-basin 9"
738,600,112,2900,3500,"Sub-basin 9"
739,100,1,1400,1500,"Sub-basin 9"
740,4100,1194,5200,9300,"Sub-basin 9"
741,200,6,400,600,"Sub-basin 9"
742,100,1,500,600,"Sub-basin 9"
743,100,4,3300,3400,"Sub-basin 9"
744,2900,592,5700,8600,"Sub-basin 9"
745,900,81,3000,3900,"Sub-basin 9"
746,300,9,3000,3300,"Sub-basin 9"
747,500,92,2200,2700,"Sub-basin 9"
748,200,2,8200,8400,"Sub-basin 9"
749,600,49,5700,6300,"Sub-basin 9"
750,300,12,1100,1400,"Sub-basin 9"
751,1400,90,4800,6200,"Sub-basin 9"
752,100,5,1000,1100,"Sub-basin 9"
753,700,201,1900,2600,"Sub-basin 9"
754,800,56,5000,5800,"Sub-basin 9"
755,2700,958,8600,11300,"Sub-basin 9"
756,300,7,6800,7100,"Sub-basin 9"
757,100,4,1700,1800,"Sub-basin 9"
758,2100,873,3900,6000,"Sub-basin 9"
759,1000,172,1500,2500,"Sub-basin 9"
760,200,7,9600,9800,"Sub-basin 9"
761,100,1,2800,2900,"Sub-basin 9"
762,1500,255,6300,7800,"Sub-basin 9"
763,400,36,1700,2100,"Sub-basin 9"
764,1600,197,5700,7300,"Sub-basin 9"
765,1500,373,7900,9400,"Sub-basin 9"
766,1300,245,3500,4800,"Sub-basin 9"
767,1000,104,5400,6400,"Sub-basin 9"
768,5000,1232,7600,12600,"Sub-basin 9"
769,100,2,4800,4900,"Sub-basin 9"
770,600,116,1900,2500,"Sub-basin 9"
771,100,3,3300,3400,"Sub-basin 9"
772,1600,100,52500,54100,"Sub-basin 9"
773,300,13,1600,1900,"Sub-basin 9"
774,200,6,6900,7100,"Sub-basin 9"
775,100,2,5400,5500,"Sub-basin 9"
776,200,12,8300,8500,"Sub-basin 9"
777,400,33,5200,5600,"Sub-basin 9"
778,300,15,2500,2800,"Sub-basin 9"
779,1100,157,4200,5300,"Sub-basin 9"
780,200,15,1100,1300,"Sub-basin 9"
781,1600,553,700,2300,"Sub-basin 9"
782,300,19,13600,13900,"Sub-basin 9"
783,100,3,700,800,"Sub-basin 9"
784,200,10,2300,2500,"Sub-basin 9"
785,4600,773,14300,18900,"Sub-basin 9"
786,400,42,13300,13700,"Sub-basin 9"
787,400,31,1700,2100,"Sub-basin 9"
788,10300,3784,10800,21100,"Sub-basin 9"
789,2600,195,64900,67500,"Sub-basin 9"
790,600,113,4800,5400,"Sub-basin 9"
791,2100,239,4100,6200,"Sub-basin 9"
792,200,3,1300,1500,"Sub-basin 9"
793,300,19,2100,2400,"Sub-basin 9"
794,800,220,3500,4300,"Sub-basin 9"
795,1800,363,2400,4200,"Sub-basin 9"
796,200,3,1800,2000,"Sub-basin 9"
797,1000,59,5800,6800,"Sub-basin 9"
798,100,2,1100,1200,"Sub-basin 9"
799,1200,40,5400,6600,"Sub-basin 9"
800,400,57,2200,2600,"Sub-basin 9"
801,500,47,2300,2800,"Sub-basin 9"
802,100,2,900,1000,"Sub-basin 9"
803,100,1,1400,1500,"Sub-basin 9"
804,2600,365,10800,13400,"Sub-basin 9"
805,1600,337,6400,8000,"Sub-basin 9"
806,3300,652,15200,18500,"Sub-basin 9"
807,4200,1537,5600,9800,"Sub-basin 9"
808,400,40,4300,4700,"Sub-basin 9"
809,600,46,3200,3800,"Sub-basin 9"
810,2000,174,5900,7900,"Sub-basin 9"
811,200,14,800,1000,"Sub-basin 9"
812,1300,481,2700,4000,"Sub-basin 9"
813,4800,1054,5300,10100,"Sub-basin 9"
814,600,89,2500,3100,"Sub-basin 9"
815,600,58,1800,2400,"Sub-basin 9"
816,200,15,3600,3800,"Sub-basin 9"
817,5800,1925,6700,12500,"Sub-basin 9"
818,1000,56,5000,6000,"Sub-basin 9"
819,200,8,3300,3500,"Sub-basin 9"
820,2200,320.83,5900,8100,"Sub-basin 9"
821,3800,662,7700,11500,"Sub-basin 9"
822,500,24,6300,6800,"Sub-basin 9"
823,6000,1686,5800,11800,"Sub-basin 9"
824,600,49,4900,5500,"Sub-basin 9"
825,100,2,1600,1700,"Sub-basin 9"
826,800,58,2900,3700,"Sub-basin 9"
827,100,1,1000,1100,"Sub-basin 9"
828,800,82,14400,15200,"Sub-basin 9"
829,2200,556,8300,10500,"Sub-basin 9"
830,400,31,4300,4700,"Sub-basin 9"
831,400,38,4200,4600,"Sub-basin 9"
832,200,8,1000,1200,"Sub-basin 9"
833,200,3,700,900,"Sub-basin 9"
834,1400,228,2500,3900,"Sub-basin 9"
835,1000,72,6200,7200,"Sub-basin 9"
836,1500,158,4900,6400,"Sub-basin 9"
837,100,2,500,600,"Sub-basin 9"
838,400,29,1100,1500,"Sub-basin 9"
839,600,122,1400,2000,"Sub-basin 9"
840,1100,187,4300,5400,"Sub-basin 9"
841,4500,689,10500,15000,"Sub-basin 9"
842,1300,176,3700,5000,"Sub-basin 9"
843,400,25.67,1600,2000,"Sub-basin 9"
844,2100,288,5900,8000,"Sub-basin 9"
845,6200,1552,8900,15100,"Sub-basin 9"
846,400,9,3300,3700,"Sub-basin 9"
847,600,36,4800,5400,"Sub-basin 9"
848,200,12,1600,1800,"Sub-basin 9"
849,3100,429,14500,17600,"Sub-basin 9"
850,1100,830,10800,11900,"Sub-basin 9"
851,100,3,1100,1200,"Sub-basin 9"
852,1300,130,5100,6400,"Sub-basin 9"
853,100,1,3100,3200,"Sub-basin 9"
854,2300,293,7300,9600,"Sub-basin 9"
855,400,35,4000,4400,"Sub-basin 9"
856,1400,362,4200,5600,"Sub-basin 9"
857,300,3,3700,4000,"Sub-basin 9"
858,2100,486,4400,6500,"Sub-basin 9"
859,300,30,2300,2600,"Sub-basin 9"
860,100,1.5,900,1000,"Sub-basin 9"
861,100,1,700,800,"Sub-basin 9"
862,600,69.67,2500,3100,"Sub-basin 9"
863,800,253,1700,2500,"Sub-basin 9"
864,2200,454,3500,5700,"Sub-basin 9"
865,15000,4378,10900,25900,"Sub-basin 9"
866,500,8,17000,17500,"Sub-basin 9"
867,2100,253,10400,12500,"Sub-basin 9"
868,2400,540,8300,10700,"Sub-basin 9"
869,2800,635,6400,9200,"Sub-basin 9"
870,600,99,900,1500,"Sub-basin 9"
871,700,126,3000,3700,"Sub-basin 9"
872,500,35,3400,3900,"Sub-basin 9"
873,300,9,3100,3400,"Sub-basin 9"
874,300,8,3200,3500,"Sub-basin 9"
875,1800,377,2600,4400,"Sub-basin 9"
876,300,17,3800,4100,"Sub-basin 9"
877,200,13,3000,3200,"Sub-basin 9"
878,8300,2321,10400,18700,"Sub-basin 9"
879,100,2,400,500,"Sub-basin 9"
880,500,105,2200,2700,"Sub-basin 9"
881,900,134,4500,5400,"Sub-basin 9"
882,700,31,3400,4100,"Sub-basin 9"
883,600,31,2100,2700,"Sub-basin 9"
884,1100,114,5100,6200,"Sub-basin 9"
885,600,139.33,1400,2000,"Sub-basin 9"
886,900,293,2600,3500,"Sub-basin 9"
887,100,2,400,500,"Sub-basin 9"
888,3000,617,7200,10200,"Sub-basin 9"
889,200,2,7900,8100,"Sub-basin 9"
890,1400,140,6900,8300,"Sub-basin 9"
891,200,8,1800,2000,"Sub-basin 9"
892,1100,160,5700,6800,"Sub-basin 9"
893,1200,134,4800,6000,"Sub-basin 9"
894,800,354,1200,2000,"Sub-basin 9"
895,100,1,900,1000,"Sub-basin 9"
896,300,35,800,1100,"Sub-basin 9"
897,4900,447,17000,21900,"Sub-basin 9"
898,500,90,3000,3500,"Sub-basin 9"
899,200,5,2400,2600,"Sub-basin 9"
900,900,116,2300,3200,"Sub-basin 9"
901,11600,2102,19500,31100,"Sub-basin 9"
902,100,3,3800,3900,"Sub-basin 9"
903,1200,333,3600,4800,"Sub-basin 9"
904,200,23,3800,4000,"Sub-basin 9"
905,300,22,1800,2100,"Sub-basin 9"
906,2300,658,3200,5500,"Sub-basin 9"
907,900,31,34700,35600,"Sub-basin 9"
908,100,5,800,900,"Sub-basin 9"
909,800,59,4600,5400,"Sub-basin 9"
910,200,6,2000,2200,"Sub-basin 9"
911,1300,272,4000,5300,"Sub-basin 9"
912,100,1,1900,2000,"Sub-basin 9"
913,300,22,1400,1700,"Sub-basin 9"
914,400,66,3300,3700,"Sub-basin 9"
915,800,132,2200,3000,"Sub-basin 9"
916,1900,354,6400,8300,"Sub-basin 9"
917,1000,229,3100,4100,"Sub-basin 9"
918,400,35,2400,2800,"Sub-basin 9"
919,800,131,2600,3400,"Sub-basin 9"
920,400,22,3400,3800,"Sub-basin 9"
921,1900,127,13200,15100,"Sub-basin 9"
922,500,74,2800,3300,"Sub-basin 9"
923,100,2,1400,1500,"Sub-basin 9"
924,4600,725,15100,19700,"Sub-basin 9"
925,2100,256,5600,7700,"Sub-basin 9"
926,1000,46,4800,5800,"Sub-basin 9"
927,2200,316,2800,5000,"Sub-basin 9"
928,100,4,1300,1400,"Sub-basin 9"
929,900,45,4700,5600,"Sub-basin 9"
930,800,75,6300,7100,"Sub-basin 9"
931,100,1,600,700,"Sub-basin 9"
932,600,69,3900,4500,"Sub-basin 9"
933,400,10,3900,4300,"Sub-basin 9"
934,100,1,1400,1500,"Sub-basin 9"
935,1200,107,5200,6400,"Sub-basin 9"
936,2400,160,17000,19400,"Sub-basin 9"
937,100,8,1000,1100,"Sub-basin 9"
938,100,1,1100,1200,"Sub-basin 9"
939,400,17,2000,2400,"Sub-basin 9"
940,3900,645,6900,10800,"Sub-basin 9"
941,500,24,14500,15000,"Sub-basin 9"
942,1100,153,9600,10700,"Sub-basin 9"
943,200,6,3300,3500,"Sub-basin 9"
944,300,28,1900,2200,"Sub-basin 9"
945,200,3,1500,1700,"Sub-basin 9"
946,200,7,1300,1500,"Sub-basin 9"
947,200,8,1700,1900,"Sub-basin 9"
948,3000,635,4200,7200,"Sub-basin 9"
949,2200,567,3300,5500,"Sub-basin 9"
950,100,9,700,800,"Sub-basin 9"
951,500,21,4700,5200,"Sub-basin 9"
952,300,23,2900,3200,"Sub-basin 9"
953,1000,32,5100,6100,"Sub-basin 9"
954,900,151,1700,2600,"Sub-basin 9"
955,700,37,5900,6600,"Sub-basin 9"
956,400,15,2000,2400,"Sub-basin 9"
957,1600,108,5500,7100,"Sub-basin 9"
958,3900,794,7600,11500,"Sub-basin 9"
959,100,2,800,900,"Sub-basin 9"
960,300,5,6300,6600,"Sub-basin 9"
961,300,15,3600,3900,"Sub-basin 9"
962,200,3,7000,7200,"Sub-basin 9"
963,800,152,3200,4000,"Sub-basin 9"
964,2100,198,10800,12900,"Sub-basin 9"
965,100,2,500,600,"Sub-basin 9"
966,200,5,2400,2600,"Sub-basin 9"
967,500,22,5000,5500,"Sub-basin 9"
968,1100,104,3300,4400,"Sub-basin 9"
969,2900,108,82000,84900,"Sub-basin 9"
970,9700,1548,34300,44000,"Sub-basin 9"
971,1400,156,6300,7700,"Sub-basin 9"
972,400,21,2900,3300,"Sub-basin 9"
973,800,175,6300,7100,"Sub-basin 9"
974,1300,86.67,5400,6700,"Sub-basin 9"
975,700,59,6300,7000,"Sub-basin 9"
976,4700,643,29300,34000,"Sub-basin 9"
977,600,38,2900,3500,"Sub-basin 9"
978,100,6,1100,1200,"Sub-basin 9"
979,900,98,5400,6300,"Sub-basin 9"
980,600,34,4700,5300,"Sub-basin 9"
981,600,94,2300,2900,"Sub-basin 9"
982,3100,640,4900,8000,"Sub-basin 9"
983,900,88,600,1500,"Sub-basin 9"
984,1200,118,7500,8700,"Sub-basin 9"
985,300,9,3100,3400,"Sub-basin 9"
986,800,43,4000,4800,"Sub-basin 9"
987,300,12,2300,2600,"Sub-basin 9"
988,200,6,1600,1800,"Sub-basin 9"
989,100,2,600,700,"Sub-basin 9"
990,500,17,3200,3700,"Sub-basin 9"
991,100,5,1600,1700,"Sub-basin 9"
992,400,26,4600,5000,"Sub-basin 9"
993,400,95,1200,1600,"Sub-basin 9"
994,1500,79,6900,8400,"Sub-basin 9"
995,100,1,900,1000,"Sub-basin 9"
996,1300,118,4500,5800,"Sub-basin 9"
997,1200,143,2800,4000,"Sub-basin 9"
998,200,13,1000,1200,"Sub-basin 9"
999,1700,96,3000,4700,"Sub-basin 9"
1000,1400,293,4000,5400,"Sub-basin 9"
1001,1000,75,2700,3700,"Sub-basin 9"
1002,100,1,1600,1700,"Sub-basin 9"
1003,600,19,18100,18700,"Sub-basin 9"
1004,100,3,1000,1100,"Sub-basin 9"
1005,100,4,3100,3200,"Sub-basin 9"
1006,200,5,1700,1900,"Sub-basin 9"
1007,600,106,1300,1900,"Sub-basin 9"
1008,100,12,4400,4500,"Sub-basin 9"
1009,600,24,3000,3600,"Sub-basin 9"
1010,200,13,1100,1300,"Sub-basin 9"
1011,900,104,1500,2400,"Sub-basin 9"
1012,100,3.17,300,400,"Sub-basin 9"
1013,100,3,1500,1600,"Sub-basin 9"
1014,500,40,10900,11400,"Sub-basin 9"
1015,100,8,2500,2600,"Sub-basin 9"
1016,300,11,2100,2400,"Sub-basin 9"
1017,1000,98,4000,5000,"Sub-basin 9"
1018,200,12,900,1100,"Sub-basin 9"
1019,100,1,1400,1500,"Sub-basin 9"
1020,600,33,2100,2700,"Sub-basin 9"
1021,300,34,3000,3300,"Sub-basin 9"
1022,1700,220,8600,10300,"Sub-basin 9"
1023,1700,215,6300,8000,"Sub-basin 9"
1024,900,57,24400,25300,"Sub-basin 9"
1025,100,6,1100,1200,"Sub-basin 9"
1026,1900,394,4700,6600,"Sub-basin 9"
1027,3200,559,19500,22700,"Sub-basin 9"
1028,300,12,900,1200,"Sub-basin 9"
1029,300,40,1200,1500,"Sub-basin 9"
1030,100,4,800,900,"Sub-basin 9"
1031,600,170,2100,2700,"Sub-basin 9"
1032,1800,407,6500,8300,"Sub-basin 9"
1033,2400,331,9600,12000,"Sub-basin 9"
1034,100,3,1100,1200,"Sub-basin 9"
1035,500,35,1400,1900,"Sub-basin 9"
1036,300,23,500,800,"Sub-basin 9"
1037,200,5,1000,1200,"Sub-basin 9"
1038,200,4,1800,2000,"Sub-basin 9"
1039,900,75,1800,2700,"Sub-basin 9"
1040,800,68,3300,4100,"Sub-basin 9"
1041,2200,188,9300,11500,"Sub-basin 9"
1042,2800,596,11600,14400,"Sub-basin 9"
1043,100,4,800,900,"Sub-basin 9"
1044,900,40,2700,3600,"Sub-basin 9"
1045,700,25,2100,2800,"Sub-basin 9"
1046,2500,446,4500,7000,"Sub-basin 9"
1047,800,79,2700,3500,"Sub-basin 9"
1048,300,13,1000,1300,"Sub-basin 9"
1049,100,5,2300,2400,"Sub-basin 9"
1050,100,1,600,700,"Sub-basin 9"
1051,200,8,6400,6600,"Sub-basin 9"
1052,100,2,700,800,"Sub-basin 9"
1053,1500,99,5300,6800,"Sub-basin 9"
1054,400,34,500,900,"Sub-basin 9"
1055,1000,234,1500,2500,"Sub-basin 9"
1056,1000,190,4400,5400,"Sub-basin 9"
1057,600,86,7700,8300,"Sub-basin 9"
1058,200,16,700,900,"Sub-basin 9"
1059,400,73,3300,3700,"Sub-basin 9"
1060,400,30,900,1300,"Sub-basin 9"
1061,100,1,4300,4400,"Sub-basin 9"
1062,1400,114,9100,10500,"Sub-basin 9"
1063,600,82,3200,3800,"Sub-basin 9"
1064,800,125,700,1500,"Sub-basin 9"
1065,1000,277,4100,5100,"Sub-basin 9"
1066,100,4,4200,4300,"Sub-basin 9"
1067,200,6,1200,1400,"Sub-basin 9"
1068,100,5,1300,1400,"Sub-basin 9"
1069,100,4,2600,2700,"Sub-basin 9"
1070,100,3,1700,1800,"Sub-basin 9"
1071,600,101,10400,11000,"Sub-basin 9"
1072,200,15,2400,2600,"Sub-basin 9"
1073,200,4,6500,6700,"Sub-basin 9"
1074,700,37,6700,7400,"Sub-basin 9"
1075,600,88,2400,3000,"Sub-basin 9"
1076,1600,256,300,1900,"Sub-basin 9"
1077,1900,191,6500,8400,"Sub-basin 9"
1078,400,13,3600,4000,"Sub-basin 9"
1079,500,52,7200,7700,"Sub-basin 9"
1080,700,21,16600,17300,"Sub-basin 9"
1081,800,86,10200,11000,"Sub-basin 9"
1082,100,3,2300,2400,"Sub-basin 9"
1083,100,1,1500,1600,"Sub-basin 9"
1084,100,3,2200,2300,"Sub-basin 9"
1085,400,16,3900,4300,"Sub-basin 9"
1086,700,19,13100,13800,"Sub-basin 9"
1087,1200,83,12700,13900,"Sub-basin 9"
1088,500,19,2100,2600,"Sub-basin 9"
1089,200,6,300,500,"Sub-basin 9"
1090,200,9,3200,3400,"Sub-basin 9"
1091,600,48,4700,5300,"Sub-basin 9"
1092,1500,184.51,9000,10500,"Sub-basin 9"
1093,400,27,3700,4100,"Sub-basin 9"
1094,400,35,7100,7500,"Sub-basin 9"
1095,400,6,11600,12000,"Sub-basin 9"
1096,200,3,1600,1800,"Sub-basin 9"
1097,600,37,3800,4400,"Sub-basin 9"
1098,200,17,800,1000,"Sub-basin 9"
1099,200,2,3700,3900,"Sub-basin 9"
1100,400,32,3500,3900,"Sub-basin 9"
1101,500,13,5800,6300,"Sub-basin 9"
1102,200,4,5900,6100,"Sub-basin 9"
1103,100,2,1500,1600,"Sub-basin 9"
1104,1100,109,8500,9600,"Sub-basin 9"
1105,200,6,2300,2500,"Sub-basin 9"
1106,600,52,4400,5000,"Sub-basin 9"
1107,400,16,3800,4200,"Sub-basin 9"
1108,500,32,500,1000,"Sub-basin 9"
1109,200,2,6800,7000,"Sub-basin 9"
1110,300,12,2900,3200,"Sub-basin 9"
1111,300,5,9600,9900,"Sub-basin 9"
1112,700,112,7400,8100,"Sub-basin 9"
1113,700,44,5700,6400,"Sub-basin 9"
1114,100,1,2700,2800,"Sub-basin 9"
1115,200,2,3400,3600,"Sub-basin 9"
1116,2500,823,9900,12400,"Sub-basin 9"
1117,300,8,2600,2900,"Sub-basin 9"
1118,100,1,900,1000,"Sub-basin 9"
1119,1000,36,21200,22200,"Sub-basin 9"
1120,300,18,1900,2200,"Sub-basin 9"
1121,300,4,3900,4200,"Sub-basin 9"
1122,400,33,3900,4300,"Sub-basin 9"
1123,1500,255,5300,6800,"Sub-basin 9"
1124,400,12,5100,5500,"Sub-basin 9"
1125,100,6,3600,3700,"Sub-basin 9"
1126,2900,488,8800,11700,"Sub-basin 9"
1127,500,49,2500,3000,"Sub-basin 9"
1128,300,8,4200,4500,"Sub-basin 9"
1129,100,4,1400,1500,"Sub-basin 9"
1130,100,3,2600,2700,"Sub-basin 9"
1131,700,61,2300,3000,"Sub-basin 9"
1132,400,9,11200,11600,"Sub-basin 9"
1133,100,1,1500,1600,"Sub-basin 9"
1134,4000,1246,30600,34600,"Sub-basin 9"
1135,1600,146,7800,9400,"Sub-basin 9"
1136,800,75,1700,2500,"Sub-basin 9"
1137,300,6,3000,3300,"Sub-basin 9"
1138,4100,385,25300,29400,"Sub-basin 9"
1139,600,52,4900,5500,"Sub-basin 9"
1140,200,3,2000,2200,"Sub-basin 9"
1141,800,116,10100,10900,"Sub-basin 9"
1142,100,3,4400,4500,"Sub-basin 9"
1143,3900,268,25000,28900,"Sub-basin 9"
1144,100,1,4400,4500,"Sub-basin 9"
1145,200,8,2600,2800,"Sub-basin 9"
1146,4800,718,23100,27900,"Sub-basin 9"
1147,100,2,3900,4000,"Sub-basin 9"
1148,200,9,2400,2600,"Sub-basin 9"
1149,300,5,2600,2900,"Sub-basin 9"
1150,100,2,1900,2000,"Sub-basin 9"
1151,600,68,7000,7600,"Sub-basin 9"
1152,700,47,4800,5500,"Sub-basin 9"
1153,600,37,1900,2500,"Sub-basin 9"
1154,100,2,1000,1100,"Sub-basin 9"
1155,1100,152,8100,9200,"Sub-basin 9"
1156,100,1,4200,4300,"Sub-basin 9"
1157,200,2,4100,4300,"Sub-basin 9"
1158,2300,222,11300,13600,"Sub-basin 9"
1159,100,2,1000,1100,"Sub-basin 9"
1160,800,15,29100,29900,"Sub-basin 9"
1161,200,27,3600,3800,"Sub-basin 9"
1162,300,19,2900,3200,"Sub-basin 9"
1163,200,6,5200,5400,"Sub-basin 9"
1164,100,1,1200,1300,"Sub-basin 9"
1165,400,11,3900,4300,"Sub-basin 9"
1166,100,2,900,1000,"Sub-basin 9"
1167,100,3,2300,2400,"Sub-basin 9"
1168,1000,79,12700,13700,"Sub-basin 9"
1169,1700,216,7300,9000,"Sub-basin 9"
1170,400,31,12700,13100,"Sub-basin 9"
1171,100,1,2100,2200,"Sub-basin 9"
1172,100,1,1800,1900,"Sub-basin 9"
1173,200,12,1800,2000,"Sub-basin 9"
1174,100,3,4300,4400,"Sub-basin 9"
1175,600,33,7800,8400,"Sub-basin 9"
1176,500,41,5400,5900,"Sub-basin 9"
1177,2200,272,12900,15100,"Sub-basin 9"
1178,100,1,600,700,"Sub-basin 9"
1179,100,1,3600,3700,"Sub-basin 9"
1180,200,10,5000,5200,"Sub-basin 9"
1181,800,61,2000,2800,"Sub-basin 9"
1182,400,14,10900,11300,"Sub-basin 9"
1183,100,1,2500,2600,"Sub-basin 9"
1184,200,9,1600,1800,"Sub-basin 9"
1185,500,31,3900,4400,"Sub-basin 9"
1186,1000,149,2600,3600,"Sub-basin 9"
1187,2000,221,10500,12500,"Sub-basin 9"
1188,100,2,2400,2500,"Sub-basin 9"
1189,1400,182,6500,7900,"Sub-basin 9"
1190,100,2,3100,3200,"Sub-basin 9"
1191,4000,466,15900,19900,"Sub-basin 9"
1192,200,5,2300,2500,"Sub-basin 9"
1193,1200,155,11500,12700,"Sub-basin 9"
1194,500,79,1500,2000,"Sub-basin 9"
1195,600,18,18100,18700,"Sub-basin 9"
1196,2100,247,9300,11400,"Sub-basin 9"
1197,200,6,1000,1200,"Sub-basin 9"
1198,100,1,800,900,"Sub-basin 9"
1199,600,116,2600,3200,"Sub-basin 9"
1200,6100,1022,20900,27000,"Sub-basin 9"
1201,700,79,4500,5200,"Sub-basin 9"
1202,100,3,4300,4400,"Sub-basin 9"
1203,100,4,1900,2000,"Sub-basin 9"
1204,900,149,4400,5300,"Sub-basin 9"
1205,600,89,2500,3100,"Sub-basin 9"
1206,1200,162,6000,7200,"Sub-basin 9"
1207,3100,466,8200,11300,"Sub-basin 9"
1208,100,1,2400,2500,"Sub-basin 9"
1209,400,10,2900,3300,"Sub-basin 9"
1210,200,25.17,2400,2600,"Sub-basin 9"
1211,200,2,7600,7800,"Sub-basin 9"
1212,100,1,2300,2400,"Sub-basin 9"
1213,100,1,2400,2500,"Sub-basin 9"
1214,600,25,2000,2600,"Sub-basin 9"
1215,7400,1211,21000,28400,"Sub-basin 9"
1216,1000,156,2300,3300,"Sub-basin 9"
1217,100,1,1900,2000,"Sub-basin 9"
1218,200,3,8100,8300,"Sub-basin 9"
1219,300,15,3000,3300,"Sub-basin 9"
1220,300,18,3800,4100,"Sub-basin 9"
1221,700,53,1600,2300,"Sub-basin 9"
1222,100,1,4100,4200,"Sub-basin 9"
1223,300,48,3300,3600,"Sub-basin 9"
1224,300,7,3700,4000,"Sub-basin 9"
1225,100,2,4400,4500,"Sub-basin 9"
1226,3700,927,21100,24800,"Sub-basin 9"
1227,100,1,1200,1300,"Sub-basin 9"
1228,200,8,3200,3400,"Sub-basin 9"
1229,700,21,22300,23000,"Sub-basin 9"
1230,100,27,1600,1700,"Sub-basin 9"
1231,400,38,7300,7700,"Sub-basin 9"
1232,100,1,3600,3700,"Sub-basin 9"
1233,200,120,1500,1700,"Sub-basin 9"
1234,900,224,3300,4200,"Sub-basin 9"
1235,1000,30,27500,28500,"Sub-basin 9"
1236,1000,66,3600,4600,"Sub-basin 9"
1237,200,4,1100,1300,"Sub-basin 9"
1238,500,17,8000,8500,"Sub-basin 9"
1239,4800,211.0152,65400,70200,"Sub-basin 9"
1240,200,4,1600,1800,"Sub-basin 9"
1241,500,28,5700,6200,"Sub-basin 9"
1242,600,28,4000,4600,"Sub-basin 9"
1243,200,4,3700,3900,"Sub-basin 9"
1244,200,2,2800,3000,"Sub-basin 9"
1245,100,1.0001,2300,2400,"Sub-basin 9"
1246,100,1,0,100,"Sub-basin 9"
1247,200,4,500,700,"Sub-basin 9"
1248,200,6,700,900,"Sub-basin 9"
1249,400,69,0,400,"Sub-basin 9"
